نماد,نام,تعداد,حجم,ارزش,دیروز,اولین,آخرین معامله - مقدار,آخرین معامله - تغییر,آخرین معامله - درصد,قیمت پایانی - مقدار,قیمت پایانی - تغییر,قیمت پایانی - درصد,کمترین,بیشترین
شستا,سرمايه گذاري تامين اجتماعي,17073,861148558,872653012732,1013,1010,1021,8,0.79,1013,0,0,1001,1033
بهير,س. توسعه تجارت هيرمند,15194,34216344,270309117600,7670,7900,7900,230,3,7900,230,3,7900,7900
ددانا,داروسازي دانا,11923,1580930,58889642500,35150,37250,37250,2100,5.97,37250,2100,5.97,37250,37250
خودرو,ايران‌ خودرو,10848,409717996,924711093040,2258,2260,2245,-13,-0.58,2257,-1,-0.04,2237,2288
پالايش,صندوق پالايشي يكم-سهام,10835,10908545,836838468160,76930,76930,76390,-540,-0.7,76710,-220,-0.29,76160,77460
كرمان,س. توسعه و عمران استان كرمان,10417,525643694,528112620610,963,959,1020,57,5.92,1005,42,4.36,944,1020
حكشتي,كشتيراني جمهوري اسلامي ايران,9228,88808571,1960349763710,21080,21450,22130,1050,4.98,22070,990,4.7,21450,22130
خگستر,گسترش‌سرمايه‌گذاري‌ايران‌خودرو,8772,273044604,1038787507313,3807,3830,3780,-27,-0.71,3804,-3,-0.08,3740,3890
تسه1401,امتيازتسهيلات مسكن سال1401,8328,328561,384562337606,1191262,1131699,1140022,-51240,-4.3,1170444,-20818,-1.75,1131699,1250825
شپنا,پالايش نفت اصفهان,8303,122099509,790201772210,6440,6460,6500,60,0.93,6470,30,0.47,6390,6550
خساپا,سايپا,7934,288406762,590992770802,2042,2059,2045,3,0.15,2049,7,0.34,2025,2082
وسپهر,سرمايه گذاري مالي سپهرصادرات,6852,40250734,338097309090,8030,8180,8510,480,5.98,8400,370,4.61,8100,8510
فولاد,فولاد مباركه اصفهان,6780,81883317,1004115118710,12400,12390,12290,-110,-0.89,12260,-140,-1.13,12180,12390
سآبيك,سيمان آبيك,6710,1714634,25496607580,14170,14870,14870,700,4.94,14870,700,4.94,14870,14870
دارا يكم,صندوق واسطه گري مالي يكم-سهام,6595,3883242,447718599630,116070,115030,115200,-870,-0.75,115300,-770,-0.66,114500,116070
تفارس,تامين سرمايه خليج فارس,6481,32286295,103316144000,1000,3200,3200,2200,220,3200,2200,220,3200,3200
مديريت,س. و خدمات مديريت صند. ب كشوري,6323,43640292,395124622840,9470,9250,8920,-550,-5.81,9050,-420,-4.44,8910,9610
اسياتك,انتقال داده هاي آسياتك,6202,6061131,85886226270,13500,14170,14170,670,4.96,14170,670,4.96,14170,14170
سپيد,سپيد ماكيان,5394,13378374,294444406280,22630,22100,22370,-260,-1.15,22010,-620,-2.74,21760,22860
شتران,پالايش نفت تهران,5387,87578334,471698914460,5410,5440,5360,-50,-0.92,5390,-20,-0.37,5330,5440
شبندر,پالايش نفت بندرعباس,5292,80165532,702918310690,8780,8780,8760,-20,-0.23,8770,-10,-0.11,8680,8810
تپكو,توليدتجهيزات‌سنگين‌هپكو,5228,175892967,295667837670,1721,1670,1719,-2,-0.12,1681,-40,-2.32,1670,1739
فملي,ملي‌ صنايع‌ مس‌ ايران‌,5159,82695197,616350722340,7480,7470,7460,-20,-0.27,7450,-30,-0.4,7370,7500
كمند,صندوق س. با درآمد ثابت كمند,5055,229526631,2319966827976,10102,10107,10108,6,0.06,10108,6,0.06,10107,10108
كدما,معدني‌ دماوند,4980,3234573,296823743790,92520,92800,90170,-2350,-2.54,91770,-750,-0.81,88550,94500
خاور,ايران خودرو ديزل,4705,162941878,265669541091,1675,1670,1626,-49,-2.93,1630,-45,-2.69,1625,1689
وبملت,بانك ملت,4592,140558626,542694398003,3862,3889,3890,28,0.73,3861,-1,-0.03,3810,3900
تليسه,دامداري تليسه نمونه,4542,77437426,333985440848,4534,4300,4370,-164,-3.62,4313,-221,-4.87,4262,4450
غزر,صنعتي زر ماكارون,4446,17488501,174024426560,10390,10000,9880,-510,-4.91,9950,-440,-4.23,9880,10230
ذوب,ذوب آهن اصفهان,4368,89723697,251653403625,2846,2826,2780,-66,-2.32,2805,-41,-1.44,2760,2868
حگهر,حمل و نقل گهرترابر سيرجان,4230,26846916,238210961640,8850,8700,8840,-10,-0.11,8870,20,0.23,8420,9130
شلرد,كود شيميايي اوره لردگان,4223,41544537,530871649250,12440,12810,12670,230,1.85,12780,340,2.73,12590,12810
انرژي,بورس انرژي ايران,4183,4348146,259707400230,60550,60480,59190,-1360,-2.25,59730,-820,-1.35,58900,61600
وتجارت,بانك تجارت,4069,116717471,248585116205,2125,2140,2137,12,0.56,2130,5,0.24,2102,2155
وتوصا,گروه س توسعه صنعتي ايران,4055,31037272,301066441190,10250,9890,9850,-400,-3.9,9700,-550,-5.37,9640,10110
خبنيان,بنيان ديزل,4029,82067786,341680005674,4134,4105,4241,107,2.59,4163,29,0.7,4010,4258
وبصادر,بانك صادرات ايران,4004,125982671,269932254556,2151,2121,2138,-13,-0.6,2143,-8,-0.37,2121,2176
بركت,گروه دارويي بركت,3963,13827564,248647530690,17560,17900,17580,20,0.11,17980,420,2.39,17560,18300
پترول,گ.س.وت.ص.پتروشيمي خليج فارس,3681,67891989,157155387929,2337,2291,2300,-37,-1.58,2315,-22,-0.94,2280,2380
سمگا,گروه سرمايه گذاري ميراث فرهنگي,3661,25160387,224307204060,9200,9000,8920,-280,-3.04,8920,-280,-3.04,8760,9150
خپارس,پارس‌ خودرو,3598,134272103,157504192371,1178,1177,1173,-5,-0.42,1173,-5,-0.42,1153,1199
قثابت,قند ثابت‌ خراسان‌,3595,99358994,323078013004,3101,3140,3256,155,5,3252,151,4.87,3140,3256
كاما,باما,3593,26738264,168256881510,6510,6380,6260,-250,-3.84,6290,-220,-3.38,6160,6510
فروسيل,فروسيليسيم خمين,3586,10016448,364409566950,35500,36000,37250,1750,4.93,36400,900,2.54,35750,37250
كالا,بورس كالاي ايران,3540,9657058,252264063980,26010,25750,25920,-90,-0.35,26120,110,0.42,25540,26870
آريا,پليمر آريا ساسول,3515,2046370,161837528600,79150,79000,79250,100,0.13,79100,-50,-0.06,78200,79500
اعتماد,صندوق س.اعتماد آفرين پارسيان-د,3486,72944190,3244254254810,44446,44476,44477,31,0.07,44476,30,0.07,44475,44478
بترانس,ايران‌ ترانسفو,3474,104618121,263016811565,2531,2460,2527,-4,-0.16,2514,-17,-0.67,2429,2588
وكبهمن,مديريت سرمايه گذاري كوثربهمن,3438,9366866,56805527940,6020,6150,6130,110,1.83,6060,40,0.66,5750,6270
سيمرغ,سيمرغ,3428,10901100,285712641590,26930,26010,26500,-430,-1.6,26210,-720,-2.67,25540,26760
ورنا,سرمايه‌گذاري‌ رنا(هلدينگ‌,3400,67380515,385956067080,5830,5800,5630,-200,-3.43,5730,-100,-1.72,5550,5960
فلوله,لوله‌وماشين‌سازي‌ايران‌,3378,130149929,253373985574,2043,1942,1941,-102,-4.99,1947,-96,-4.7,1941,1998
ثاميد,توسعه و عمران اميد,3335,47259177,74633402568,1570,1521,1620,50,3.18,1579,9,0.57,1505,1628
فرابورس,فرابورس ايران,3286,15973181,224983986080,14230,14000,14030,-200,-1.41,14090,-140,-0.98,13710,14600
هماي,صندوق س هماي آگاه-ثابت,3263,103856299,1040453036662,10013,10018,10020,7,0.07,10018,5,0.05,10016,10020
خموتور,موتورسازان‌تراكتورسازي‌ايران‌,3207,45554517,209930040535,4691,4774,4457,-234,-4.99,4608,-83,-1.77,4457,4774
فخوز,فولاد  خوزستان,3188,73729712,438950801350,6060,6050,5900,-160,-2.64,5950,-110,-1.82,5860,6080
كيان,صندوق س. با درآمد ثابت كيان,3122,27761959,970898019985,34952,34971,34973,21,0.06,34972,20,0.06,34970,34974
شپاكسا,پاكسان‌,3112,76476599,220303210481,2776,2800,2854,78,2.81,2881,105,3.78,2692,2942
سبزوا,سيمان لار سبزوار,3102,46409675,197242085544,4030,4040,4271,241,5.98,4250,220,5.46,3920,4271
فنفت,صنايع تجهيزات نفت,3078,13024337,412704563350,32450,31700,32550,100,0.31,31700,-750,-2.31,31500,32950
غدام,خوراك‌  دام‌ پارس‌,3045,2198461,130217865150,59800,58420,57760,-2040,-3.41,59230,-570,-0.95,57390,61500
غگل,گلوكوزان‌,3037,41903096,222279380300,5160,5000,5350,190,3.68,5300,140,2.71,5000,5400
سدبير,س. تدبيرگران فارس وخوزستان,2979,5751135,166161829800,30500,28750,28750,-1750,-5.74,28900,-1600,-5.25,28700,30750
بپيوند,برق و انرژي پيوندگستر پارس,2967,8051725,102024839000,12190,12190,12920,730,5.99,12670,480,3.94,11900,12920
پارس,پتروشيمي پارس,2898,61152748,166665951566,2722,2778,2730,8,0.29,2725,3,0.11,2700,2778
هاي وب,داده گسترعصرنوين-هاي وب,2845,18157613,173652073230,9640,9600,9540,-100,-1.04,9560,-80,-0.83,9300,9810
لپارس,پارس‌ الكتريك‌,2826,1246661,137807797200,109540,106000,112040,2500,2.28,110540,1000,0.91,106000,113600
سصفها,سيمان‌اصفهان‌,2799,3665177,205831221570,54330,56700,56290,1960,3.61,56160,1830,3.37,54010,56700
خبهمن,گروه‌بهمن‌,2790,74478850,137838216468,1842,1844,1860,18,0.98,1851,9,0.49,1826,1890
فارس,صنايع پتروشيمي خليج فارس,2777,13591668,114939588260,8440,8440,8460,20,0.24,8460,20,0.24,8410,8510
ثبات,صندوق س. ثبات ويستا -د,2744,135864875,1576141642859,11593,11599,11601,8,0.07,11601,8,0.07,11599,11601
غنوش,نوش‌ مازندران‌,2727,21196857,240748143080,11000,11220,11550,550,5,11360,360,3.27,10960,11550
خريخت,صنايع‌ريخته‌گري‌ايران‌,2724,57593556,198570088104,3377,3500,3340,-37,-1.1,3448,71,2.1,3308,3545
غكورش,صنعت غذايي كورش,2717,5402792,238575104050,45260,44490,44370,-890,-1.97,44160,-1100,-2.43,43290,45140
زقيام,كشت و دام قيام اصفهان,2701,51872894,134675437791,2519,2579,2645,126,5,2596,77,3.06,2473,2658
ثبهساز,بهساز كاشانه تهران,2693,30104303,48456731025,1556,1526,1633,77,4.95,1610,54,3.47,1525,1633
چخزر,صنايع چوب خزر كاسپين,2628,2159455,62608521500,30300,29000,29100,-1200,-3.96,29000,-1300,-4.29,28800,30400
ضهرم6003,اختيارخ اهرم-13000-1401/06/30,2598,140627,2954920960,2559,2000,2110,-449,-17.55,2101,-458,-17.9,2000,2150
گدنا,تهيه توزيع غذاي دنا آفرين فدك,2565,2806799,38669393810,14210,13720,13650,-560,-3.94,13780,-430,-3.03,13500,14290
خنصير,مهندسي‌نصيرماشين‌,2564,10008547,154916876760,16190,15450,15390,-800,-4.94,15480,-710,-4.39,15390,16100
فردا,صندوق س آواي فرداي زاگرس-ثابت,2533,122146935,1601948852921,13108,13114,13115,7,0.05,13115,7,0.05,13114,13116
حفاري,حفاري شمال,2525,33108898,148146278460,4713,4500,4475,-238,-5.05,4475,-238,-5.05,4431,4687
غمارگ,مارگارين‌,2497,52515634,167220504380,3293,3110,3278,-15,-0.46,3184,-109,-3.31,3101,3350
نوري,پتروشيمي نوري,2487,1663993,196410748390,117810,119000,117790,-20,-0.02,118040,230,0.2,117010,119000
وساپا,سرمايه‌گذاري‌ سايپا,2480,52456706,253483131800,4920,4920,4790,-130,-2.64,4830,-90,-1.83,4700,5070
فجهانح,ح. مجتمع جهان فولاد سيرجان,2476,4848406,8688404996,1830,1805,1786,-44,-2.4,1792,-38,-2.08,1780,1816
اعتلا,شركت سرمايه گذاري اعتلاء البرز,2415,32349872,151878023404,4470,4730,4559,89,1.99,4695,225,5.03,4470,4738
آپ,آسان پرداخت پرشين,2404,19436867,132346243110,7140,6800,6840,-300,-4.2,6810,-330,-4.62,6790,6940
آبادا,توليد نيروي برق آبادان,2385,5363288,67963258740,12290,11800,12900,610,4.96,12670,380,3.09,11800,12900
كماسه,تامين‌ ماسه‌ ريخته‌گري‌,2384,48776283,196946824326,3862,3913,4037,175,4.53,4038,176,4.56,3890,4055
فجهان,مجتمع جهان فولاد سيرجان,2310,6792264,23073859686,3474,3420,3385,-89,-2.56,3454,-20,-0.58,3350,3473
سرو,صندوق س سروسودمند مدبران-سهام,2290,10143911,804203857470,77900,78500,81450,3550,4.56,79280,1380,1.77,77900,81900
تجلي,تجلي توسعه معادن و فلزات,2276,58677821,88943022732,1510,1500,1515,5,0.33,1516,6,0.4,1500,1547
فتوسا,توليد و توسعه سرب روي ايرانيان,2275,18044268,142934508080,7620,7620,8000,380,4.99,7920,300,3.94,7500,8000
غبشهر,صنعتي‌ بهشهر,2221,60477315,249559478434,4043,3950,4285,242,5.99,4126,83,2.05,3903,4285
امين يكم,صندوق درآمد ثابت امين يكم فردا,2215,63386364,634729679696,10007,10016,10016,9,0.09,10014,7,0.07,10012,10016
فوكا,فولاد كاويان,2206,15897276,241795304980,15110,15200,15560,450,2.98,15210,100,0.66,15000,15560
غصينو,صنعتي مينو,2198,10178931,153633294900,15810,15100,15290,-520,-3.29,15090,-720,-4.55,15020,15500
بگيلان,توسعه مسير برق گيلان,2153,2353139,34590444650,14260,13800,14970,710,4.98,14700,440,3.09,13750,14970
گشان,توسعه بين المللي پديده شانديز,2147,6925311,138484919000,20550,20300,20100,-450,-2.19,20000,-550,-2.68,19950,20500
فاراك,ماشين‌ سازي‌ اراك‌,2137,72632244,116083365447,1607,1560,1611,4,0.25,1598,-9,-0.56,1551,1640
شبريز,پالايش نفت تبريز,2122,14192720,317060412050,22340,22500,22280,-60,-0.27,22340,0,0,22270,22650
فسبزوار,پارس فولاد سبزوار,2098,1917936,52714463340,27440,27330,27490,50,0.18,27480,40,0.15,27310,27750
شوينده,مديريت صنعت شوينده ت.ص.بهشهر,2082,4710251,109067444640,23020,23580,22480,-540,-2.35,23160,140,0.61,22310,23990
زكشت,كشاورزي مكانيزه اصفهان كشت,2080,8118286,194949878850,23450,22100,24850,1400,5.97,24000,550,2.35,22050,24850
خزاميا,زامياد,2074,19971105,186829354860,9330,9500,9350,20,0.21,9350,20,0.21,9240,9550
چكاپا,گروه صنايع كاغذ پارس,2045,33136542,105848427840,3300,3170,3140,-160,-4.85,3194,-106,-3.21,3135,3299
وآذر,سرمايه‌گذاري‌توسعه‌آذربايجان‌,2031,2574877,288078006760,106810,111000,112150,5340,5,111880,5070,4.75,108000,112150
شاروم,پتروشيمي اروميه,2020,1411403,21853738760,15500,15500,15330,-170,-1.1,15480,-20,-0.13,15150,15850
فاذر,صنايع‌ آذرآب‌,2004,217456142,235057618152,1032,1030,1083,51,4.94,1081,49,4.75,1029,1083
كيسون,شركت كيسون,1997,101109367,174421612643,1676,1684,1720,44,2.63,1725,49,2.92,1667,1726
بوعلي,پتروشيمي بوعلي سينا,1992,543877,47793410930,87510,86200,88150,640,0.73,87690,180,0.21,86200,88530
وخارزم,سرمايه گذاري خوارزمي,1992,38707094,192940105020,4760,4650,5040,280,5.88,4980,220,4.62,4650,5040
غويتا,ويتانا,1991,15565690,84440515960,5470,5460,5470,0,0,5420,-50,-0.91,5230,5650
غگيلا,شيرپاستوريزه پگاه گيلان,1981,3456096,51437303480,15470,14920,14980,-490,-3.17,14880,-590,-3.81,14700,15430
بورس,بورس اوراق بهادار تهران,1979,16670464,145293102060,8760,8760,8730,-30,-0.34,8720,-40,-0.46,8530,8900
ورازي,بيمه رازي,1955,59869221,119921358369,2031,1972,2068,37,1.82,2003,-28,-1.38,1971,2080
شگويا,پتروشيمي تندگويان,1913,9533701,115577964920,12130,12100,12150,20,0.16,12120,-10,-0.08,12050,12350
بكاب,صنايع‌جوشكاب‌يزد,1906,1655265,106799256750,67830,64440,64440,-3390,-5,64520,-3310,-4.88,64440,67360
صباح,ح . گروه مالي صبا تامين,1890,14572235,34099301060,2338,2301,2350,12,0.51,2340,2,0.09,2300,2370
غشهداب,كشت و صنعت شهداب ناب خراسان,1877,27396772,73534834270,2805,2663,2690,-115,-4.1,2684,-121,-4.31,2637,2780
كيمياتك,آريان كيميا تك,1868,1519432,40273854940,26930,26120,26400,-530,-1.97,26510,-420,-1.56,26020,26990
افران,صندوق س افرا نماد پايدار-ثابت,1859,33896405,555992441517,16392,16403,16403,11,0.07,16403,11,0.07,16402,16405
توسن,توسعه سامانه ي نرم افزاري نگين,1828,1547279,32419804650,21150,20300,20950,-200,-0.95,20950,-200,-0.95,20300,22000
پتاير,ايران‌ تاير,1818,32622663,51864687253,1599,1598,1590,-9,-0.56,1590,-9,-0.56,1553,1630
وپارس,بانك‌پارسيان‌,1814,47973168,94605357936,1986,1978,1967,-19,-0.96,1974,-12,-0.6,1911,2000
وپويا,سرمايه گذاري پويا,1802,16643197,40043506193,2380,2339,2488,108,4.54,2406,26,1.09,2300,2510
ثشاهد,سرمايه‌ گذاري‌ شاهد,1792,14374277,132230368580,9100,8790,9280,180,1.98,9200,100,1.1,8790,9440
ثنوسا,نوسازي‌وساختمان‌تهران‌,1790,25590185,122980204640,5020,4800,4790,-230,-4.58,4810,-210,-4.18,4770,5000
زماهان,مجتمع توليد گوشت مرغ ماهان,1788,10635753,92717119320,9070,8550,8770,-300,-3.31,8720,-350,-3.86,8530,9010
قچار,فراوردههاي غذايي وقند چهارمحال,1778,10674463,113275461280,10920,11000,10580,-340,-3.11,10610,-310,-2.84,10460,11030
قرن,پديده شيمي قرن,1768,5445227,132827331430,24860,24990,24110,-750,-3.02,24390,-470,-1.89,23970,25750
ختوقا,قطعات‌ اتومبيل‌ ايران‌,1766,28767116,93293360393,3221,3196,3275,54,1.68,3243,22,0.68,3130,3329
خزر,فنرسازي‌زر,1763,46516612,152007300263,2790,3320,3215,425,15.23,3268,478,17.13,3151,3350
بجهرم,توسعه مولد نيروگاهي جهرم,1750,45064672,107682763432,2313,2299,2428,115,4.97,2390,77,3.33,2251,2428
وتوكا,سرمايه‌گذاري‌توكافولاد(هلدينگ,1735,7941154,81237017650,10210,10050,10300,90,0.88,10230,20,0.2,10050,10350
خمحركه,نيرو محركه‌,1719,20308898,79254061116,4068,3944,3860,-208,-5.11,3902,-166,-4.08,3824,4050
بشهاب,لامپ‌  پارس‌ شهاب‌,1716,716377,66920468120,91390,91390,94200,2810,3.07,93420,2030,2.22,86830,95700
صبا,گروه مالي صبا تامين,1712,18095749,88520449320,4880,4800,4910,30,0.61,4890,10,0.2,4750,4980
وثنوح,ح. سرمايه گذاري ساختماني نوين,1711,34294853,44488753891,1306,1267,1345,39,2.99,1297,-9,-0.69,1267,1345
كارا,صندوق س. كارا -د,1707,107100846,1220228026545,11386,11393,11394,8,0.07,11393,7,0.06,11393,11395
فباهنر,مس‌ شهيدباهنر,1702,3845636,122763255670,32190,31560,31990,-200,-0.62,31920,-270,-0.84,31020,32600
تسه9903,امتياز تسهيلات مسكن خرداد99,1695,18073,20861345151,1205075,1144822,1150022,-55053,-4.57,1154282,-50793,-4.21,1144822,1205075
كبافق,معادن‌ بافق‌,1692,2753088,100400859730,38140,36260,36240,-1900,-4.98,36470,-1670,-4.38,36240,37800
سامان,بانك سامان,1688,86963704,317634891792,3551,3657,3657,106,2.99,3652,101,2.84,3446,3657
حآسا,آسيا سير ارس,1675,8672080,116118690290,14190,13390,13340,-850,-5.99,13390,-800,-5.64,13340,13980
طلا,صندوق س.پشتوانه طلاي لوتوس,1637,2393193,245166075356,100675,102004,102204,1529,1.52,102443,1768,1.76,102000,102648
وغدير,سرمايه‌گذاري‌غدير(هلدينگ‌,1636,10603373,155046807760,14600,14320,14760,160,1.1,14620,20,0.14,14320,14780
وبرق,س.کارکنان صنعت برق زنجان وقزوي,1627,1755481,145673279650,85350,83400,82800,-2550,-2.99,83000,-2350,-2.75,82800,84800
خودكفا,اقتصادي و خودكفايي آزادگان,1613,17443302,129462554150,7630,7410,7410,-220,-2.88,7420,-210,-2.75,7410,7650
ثاخت,بين‌المللي‌توسعه‌ساختمان,1597,43073025,99195539328,2318,2251,2304,-14,-0.6,2303,-15,-0.65,2227,2395
كفپارس,فرآورده‌هاي‌ نسوز پارس‌,1592,31912196,153011632772,4615,4720,4694,79,1.71,4795,180,3.9,4650,4845
زگلدشت,كشت و دام گلدشت نمونه اصفهان,1585,7963704,86347547740,10940,10310,11190,250,2.29,10840,-100,-0.91,10310,11230
وشمال,س. چشم انداز توسعه شمال,1568,6152334,144336777500,23900,23450,23550,-350,-1.46,23450,-450,-1.88,23450,23850
رمپنا,گروه مپنا (سهامي عام),1549,29254676,515320861220,16800,16130,17800,1000,5.95,17610,810,4.82,16130,17800
ديران,ايران‌دارو,1538,4501540,92138924030,21270,21450,20250,-1020,-4.8,20470,-800,-3.76,20210,21450
خكاوه,سايپا ديزل,1524,19229437,171309452660,8890,9000,8790,-100,-1.12,8910,20,0.22,8630,9150
كزغال,زغال سنگ پروده طبس,1524,1881976,37748722200,19700,19700,20300,600,3.05,20050,350,1.78,19450,20800
سيتا,سرمايه گذاري سيمان تامين,1505,2409279,27010063530,11280,11320,11140,-140,-1.24,11240,-40,-0.35,11060,11490
سپيدما,صندوق س. سپيد دماوند-د,1485,64034210,808677385346,12613,12629,12629,16,0.13,12629,16,0.13,12628,12633
شصدف,صنعتي دوده فام,1483,1923154,64319281600,34400,33600,33450,-950,-2.76,33450,-950,-2.76,32900,34100
ضخود3057,اختيارخ خودرو-2000-1401/03/04,1480,71463,16405776000,254,206,218,-36,-14.17,230,-24,-9.45,206,256
پارند,صندوق س. پارند پايدار سپهر,1467,44984311,454682562630,10102,10108,10108,6,0.06,10108,6,0.06,10107,10108
خصدرا,صنعتي‌ دريايي‌ ايران‌,1443,44951152,86862562620,1988,1931,1929,-59,-2.97,1932,-56,-2.82,1929,1968
بنو,بيمه تجارت نو,1430,12912443,74536545560,6060,5760,5760,-300,-4.95,5770,-290,-4.79,5760,5950
افق,فروشگاههاي زنجيره اي افق كوروش,1421,1929802,87846724330,47310,46000,44990,-2320,-4.9,45520,-1790,-3.78,44950,46990
قشرين,قند شيرين خراسان,1417,15803765,83631975970,5420,5300,5340,-80,-1.48,5290,-130,-2.4,5260,5450
ومدير,گ.مديريت ارزش سرمايه ص ب كشوري,1406,7171217,31584271831,4408,4346,4390,-18,-0.41,4404,-4,-0.09,4337,4469
غالبر,لبنيات‌ كالبر,1404,7074437,78298778040,11320,10800,11180,-140,-1.24,11070,-250,-2.21,10760,11480
تاصيكو,سرمايه گذاري صدرتامين,1403,13374609,144086690820,10800,10620,10810,10,0.09,10770,-30,-0.28,10530,10840
سكرد,سيمان كردستان,1397,20211929,202713123740,9600,10000,10080,480,5,10030,430,4.48,9640,10080
ولساپا,ليزينگ رايان‌ سايپا,1394,31262308,49899177755,1626,1624,1577,-49,-3.01,1596,-30,-1.85,1570,1648
آرام,صندوق س شاخصي آرام مفيد,1390,10107775,111630607420,11060,11060,11050,-10,-0.09,11040,-20,-0.18,11010,11100
حسير,ريل سير كوثر,1387,3776562,71206229700,19600,18500,18800,-800,-4.08,18850,-750,-3.83,18450,19700
فروي,ذوب روي اصفهان,1379,2961028,48809167550,17010,16780,16210,-800,-4.7,16480,-530,-3.12,16110,17020
پيزد,مجتمع صنايع لاستيك يزد,1364,2120360,26871005160,12820,12730,12500,-320,-2.5,12670,-150,-1.17,12410,13040
پارند2,صندوق س. پارند پايدار سپهر,1364,136400000,136400000,10102,1,1,-10101,-99.99,1,-10101,-99.99,1,1
كچاد,معدني‌وصنعتي‌چادرملو,1359,5029466,82638208580,16460,16320,16410,-50,-0.3,16440,-20,-0.12,16130,16560
امين,تامين سرمايه امين,1357,698781,7526498090,10770,10770,10770,0,0,10770,0,0,10770,10780
لطيف,محصولات كاغذي لطيف,1352,586734,25925860900,44950,43900,44550,-400,-0.89,44200,-750,-1.67,42800,45350
اهرم,صندوق س سهامي كاريزما- اهرمي,1337,25878089,348455084720,14100,13930,13440,-660,-4.68,13470,-630,-4.47,13370,13930
فگستر,گسترش صنايع روي ايرانيان,1336,1537236,11801817820,7640,7370,7730,90,1.18,7670,30,0.39,7360,7960
كلر,كلر پارس,1320,886013,81187310300,90900,89150,91300,400,0.44,91650,750,0.83,89150,92800
فزرين,زرين معدن آسيا,1317,9369473,65787134250,7090,7030,7020,-70,-0.99,7020,-70,-0.99,6870,7290
وگستر,گسترش سرمايه گذاري ايرانيان,1314,9943119,72675579080,7240,7000,7070,-170,-2.35,7310,70,0.97,6860,7640
رافزا,رايان هم افزا,1313,118243,6391780500,54600,54200,53900,-700,-1.28,54350,-250,-0.46,52100,55150
ختور,رادياتور ايران‌,1313,5176286,67473975650,13420,13700,12870,-550,-4.1,13040,-380,-2.83,12750,13700
حگردش,ريل گردش ايرانيان,1308,19397683,50323474137,2670,2593,2590,-80,-3,2594,-76,-2.85,2590,2650
لكما,كارخانجات‌مخابراتي‌ايران‌,1296,35190658,31269109269,915,890,888,-27,-2.95,889,-26,-2.84,888,900
سخواف,سيمان مجد خواف,1292,12604507,110651482390,8570,8800,8820,250,2.92,8780,210,2.45,8570,8820
وملي,گروه‌ صنعتي‌ ملي‌ (هلدينگ‌,1284,499691,71888997310,148130,141300,143870,-4260,-2.88,143870,-4260,-2.88,141300,149190
قلرست,قند لرستان‌,1282,3037116,70620793650,24250,23250,23550,-700,-2.89,23250,-1000,-4.12,23040,24200
غچين,كشت‌ و صنعت‌ چين‌ چين,1280,5853350,77756555210,12890,12960,12970,80,0.62,13280,390,3.03,12910,13530
چكارن,كارتن‌ ايران‌,1274,30191490,86067853086,2986,2880,2837,-149,-4.99,2851,-135,-4.52,2837,2921
شسينا,صنايع‌شيميايي‌سينا,1274,22253056,44169323451,2028,1929,1985,-43,-2.12,1985,-43,-2.12,1929,2028
ونوين,بانك‌اقتصادنوين‌,1258,25750746,98032827172,3839,3889,3795,-44,-1.15,3807,-32,-0.83,3770,3889
ضخود4011,اختيارخ خودرو-2000-1401/04/08,1254,49646,15521156000,335,340,299,-36,-10.75,313,-22,-6.57,295,350
اخابر,مخابرات ايران,1250,13243908,102649377260,7760,7480,7910,150,1.93,7750,-10,-0.13,7480,8000
ثمسكن,سرمايه‌گذاري‌ مسكن‌,1233,17812692,74363619323,4054,4000,4220,166,4.09,4175,121,2.98,3943,4278
ولشرق,ليزينگ ايران و شرق,1220,26049197,65807887757,2406,2459,2474,68,2.83,2526,120,4.99,2409,2550
دسانكو,داروسازي سبحان انكولوژي,1201,3655233,41527964420,11310,11070,11270,-40,-0.35,11360,50,0.44,11070,11710
تسه9904,امتياز تسهيلات مسكن تير99,1201,14678,18480609105,1209412,1166666,1269882,60470,5,1259069,49657,4.11,1166666,1269882
هامرز,صندوق س اعتماد هامرز-ثابت,1191,60805710,614618383112,10101,10108,10108,7,0.07,10108,7,0.07,10107,10108
فرآور,فرآوري‌موادمعدني‌ايران‌,1166,2371847,80954366540,33510,33400,34460,950,2.83,34130,620,1.85,31800,35200
شيران,س. صنايع‌شيميايي‌ايران,1163,4468488,89409106350,19990,19990,20200,210,1.05,20010,20,0.1,19500,20220
شسپا,نفت سپاهان,1157,28930161,98676739458,3350,3302,3450,100,2.99,3411,61,1.82,3302,3470
كپارس,كاشي‌ پارس‌,1145,7669544,78508930170,10720,10220,10190,-530,-4.94,10240,-480,-4.48,10190,10460
غپاك,لبنيات‌ پاك‌,1142,4576811,54344584340,12420,11810,11900,-520,-4.19,11870,-550,-4.43,11800,12180
البرز,بيمه البرز,1141,55818029,137578864018,2383,2350,2474,91,3.82,2465,82,3.44,2321,2500
دماوند,توليد نيروي برق دماوند,1138,5272565,109396372750,20250,19400,21250,1000,4.94,20750,500,2.47,19250,21250
شبريزح,ح. پالايش نفت تبريز,1127,3969182,59111314250,14970,14760,14870,-100,-0.67,14890,-80,-0.53,14760,15000
فگسترح,ح . گسترش صنايع روي ايرانيان,1117,485750,2327057493,4819,4949,4898,79,1.64,4791,-28,-0.58,4702,4949
ونيرو,سرمايه‌گذاري‌نيرو,1106,39264762,114522101235,2782,2800,2948,166,5.97,2917,135,4.85,2651,2948
وثنو,سرمايه گذاري ساختماني نوين,1101,14538748,34561993345,2353,2283,2423,70,2.97,2377,24,1.02,2283,2423
زكوثر,سرمايه گذاري كشاورزي كوثر,1101,3096635,50641964410,16650,15900,16200,-450,-2.7,16350,-300,-1.8,15900,16990
ولكار,ليزينگ كارآفرين,1085,1134283,7225298450,6460,6390,6420,-40,-0.62,6420,-40,-0.62,6350,6520
غسالم,سالمين‌,1082,10296119,36393410907,3655,3659,3490,-165,-4.51,3535,-120,-3.28,3460,3670
لسرما,سرما آفرين‌,1077,2413223,62555285220,27010,25810,25660,-1350,-5,25920,-1090,-4.04,25660,26990
وهور,مديريت انرژي اميد  تابان هور,1072,41870520,60624922357,1406,1368,1476,70,4.98,1448,42,2.99,1364,1476
شلعاب,لعابيران‌,1065,9075502,54728784100,6320,6020,6010,-310,-4.91,6030,-290,-4.59,6010,6220
خرينگ,رينگ‌سازي‌مشهد,1063,2577167,59712916710,23760,23760,23150,-610,-2.57,23170,-590,-2.48,22630,24500
تملت,تامين سرمايه بانك ملت,1062,10740670,40576486096,3726,3653,3778,52,1.4,3778,52,1.4,3600,3860
اپال,فرآوري معدني اپال كاني پارس,1061,1379619,28182623820,20620,20010,20590,-30,-0.15,20570,-50,-0.24,20000,20650
شكلر,نيروكلر,1058,2612357,128118099940,46490,46900,49170,2680,5.76,49040,2550,5.49,46900,49270
خمهر,مهركام‌پارس‌,1052,32672402,68243146974,2158,2090,2092,-66,-3.06,2089,-69,-3.2,2051,2153
زشگزا,شير و گوشت زاگرس شهركرد,1042,12023127,79719043720,6910,6500,6680,-230,-3.33,6630,-280,-4.05,6500,6810
لخانه,لوازم‌ خانگي‌ پارس‌,1025,5163136,97375108960,18760,19320,18880,120,0.64,18860,100,0.53,18200,19320
ثتران,سرمايه گذاري مسكن تهران,1016,24287400,83694528360,3310,3193,3475,165,4.98,3446,136,4.11,3193,3475
سدشت,صنايع سيمان دشتستان,1012,1809163,63422086720,33630,33650,34650,1020,3.03,35060,1430,4.25,32220,35310
وامير,گروه صنعتي و معدني امير,1003,50935,19485882050,379200,368300,383000,3800,1,382550,3350,0.88,368300,389900
جم پيلن,پتروشيمي جم پيلن,999,1037234,139646482580,135000,133600,134950,-50,-0.04,134630,-370,-0.27,129520,135400
فسرب,ملي‌ سرب‌وروي‌ ايران‌,997,16771221,28640836908,1755,1705,1710,-45,-2.56,1708,-47,-2.68,1685,1745
كمرجان,بازرگاني و توليدي مرجان كار,995,7999635,46808660700,6170,6190,5910,-260,-4.21,5850,-320,-5.19,5800,6190
ساينا,صنايع بهداشتي ساينا,992,697536,63130022850,88750,87500,90450,1700,1.92,90500,1750,1.97,87500,93300
شفارس,صنايع‌ شيميايي‌ فارس‌,990,25962066,35412981620,1395,1370,1348,-47,-3.37,1364,-31,-2.22,1332,1428
چدن,توليدي چدن سازان,987,18691774,45310558331,2501,2417,2370,-131,-5.24,2424,-77,-3.08,2361,2505
تسه1400,امتيازتسهيلات مسكن سال1400,986,14108,16523054788,1188822,1129383,1162000,-26822,-2.26,1171183,-17639,-1.48,1129383,1230000
ثفارس,عمران‌وتوسعه‌فارس‌,982,7191266,48502962740,6710,6570,6670,-40,-0.6,6740,30,0.45,6570,6910
خاهن,آهنگري‌ تراكتورسازي‌ ايران‌,980,11581090,67224431950,6080,5930,5800,-280,-4.61,5800,-280,-4.61,5720,6150
نطرين,عطرين نخ قم,974,6202368,34696187260,5890,5550,5620,-270,-4.58,5590,-300,-5.09,5540,5900
شغدير,پتروشيمي غدير,967,849696,79854774010,93270,93200,94210,940,1.01,93980,710,0.76,93050,94830
ميهن,بيمه ميهن,967,18400069,67101182342,3541,3450,3670,129,3.64,3647,106,2.99,3380,3710
كاوه,فولاد كاوه جنوب كيش,966,4917477,63329350690,12990,12600,12890,-100,-0.77,12900,-90,-0.69,12560,13040
وبانك,سرمايه گذاري گروه توسعه ملي,965,14028293,143486085020,10240,10240,10290,50,0.49,10230,-10,-0.1,10060,10340
زشريف,كشت وصنعت شريف آباد,958,10229675,42428927178,4286,4234,4119,-167,-3.9,4148,-138,-3.22,4050,4319
بكهنوج,توليد برق ماهتاب كهنوج,950,47244488,57648399450,1175,1185,1233,58,4.94,1220,45,3.83,1147,1233
شپترو,پتروشيمي آبادان,947,18420648,40626452222,2269,2201,2201,-68,-3,2205,-64,-2.82,2201,2250
زبينا,كشاورزي و دامپروري بينالود,942,12967442,41417731196,3286,3130,3185,-101,-3.07,3194,-92,-2.8,3120,3298
زفكا,كشت و دامداري فكا,940,6373077,65439444090,10550,10080,10350,-200,-1.9,10270,-280,-2.65,9980,10500
وسينا,بانك سينا,934,25982269,61795092810,2448,2401,2378,-70,-2.86,2378,-70,-2.86,2335,2474
فاسمين,كالسيمين‌,915,3679476,76402198230,20720,20520,20800,80,0.39,20760,40,0.19,20520,20990
آگاس,صندوق س.هستي بخش آگاه-س,913,1221822,105559075771,86846,85966,86600,-246,-0.28,86395,-451,-0.52,85900,86799
غگرجي,بيسكويت‌  گرجي‌,911,20689961,38712524319,1956,1903,1871,-85,-4.35,1871,-85,-4.35,1859,1930
غمينو,شركت صنايع غذايي مينو شرق,909,8949070,53706342780,6070,5900,5900,-170,-2.8,6000,-70,-1.15,5900,6230
پدرخش,درخشان‌ تهران‌,907,6412840,47318973950,7740,7380,7360,-380,-4.91,7380,-360,-4.65,7360,7680
ملت,بيمه ملت,904,28568624,35693692093,1273,1285,1246,-27,-2.12,1249,-24,-1.89,1224,1285
خفنر,فنرسازي‌خاور,903,12379526,78400517120,6640,6410,6310,-330,-4.97,6330,-310,-4.67,6310,6650
ثنور,سرمايه گذاري كوه نور,900,6863537,55641017220,7910,7810,8140,230,2.91,8110,200,2.53,7730,8140
خاذين,سايپاآذين‌,893,19953379,40771273663,2014,1982,2040,26,1.29,2043,29,1.44,1982,2090
آكورد,صندوق س. آرمان آتي كوثر-د,878,6053931,235308335083,38845,38868,38868,23,0.06,38869,24,0.06,38868,38871
شكربن,كربن‌ ايران‌,877,11754322,45898887238,3962,3850,3906,-56,-1.41,3905,-57,-1.44,3800,3990
نتوس,پشم‌ بافي‌ توس,868,7255715,76907413910,10310,10610,10580,270,2.62,10600,290,2.81,10450,10610
تبرك,گروه كارخانجات صنعتي تبرك,867,3487787,32111794270,9610,9540,9190,-420,-4.37,9210,-400,-4.16,9130,9540
وآوا,سرمايه گذاري آوا نوين,864,6411625,22552184714,3622,3432,3558,-64,-1.77,3517,-105,-2.9,3423,3600
شپلي,پلي اكريل ايران,859,12216982,93604184200,7890,7700,7660,-230,-2.92,7660,-230,-2.92,7660,7800
ولغدر,ليزينگ‌خودروغدير,854,6678569,76284255740,10860,10850,11500,640,5.89,11420,560,5.16,10580,11510
شپديس,پتروشيمي پرديس,846,969304,171977800520,177400,175500,177400,0,0,177420,20,0.01,175400,178000
خكرمان,سرمايه گذاري آرمان گستر پاريز,836,20935042,71565266036,3413,3320,3515,102,2.99,3418,5,0.15,3311,3515
كرازي,كارخانجات‌توليدي‌شيشه‌رازي‌,826,21691071,34792565388,1637,1581,1590,-47,-2.87,1604,-33,-2.02,1571,1637
غشصفا,شيرپاستوريزه‌پگاه‌اصفهان‌,824,1345342,26813132930,20680,19940,19720,-960,-4.64,19930,-750,-3.63,19500,20460
هرمز,فولاد هرمزگان جنوب,823,2925770,48237445100,16680,16300,16520,-160,-0.96,16600,-80,-0.48,16000,16700
تابا,تابان نيرو سپاهان,819,1872073,43102032650,23350,24050,22750,-600,-2.57,23000,-350,-1.5,22650,24050
كوير,توليدي فولاد سپيد فراب كوير,816,9755006,40944089051,4231,4231,4181,-50,-1.18,4198,-33,-0.78,4075,4290
زدشت,كشت و صنعت دشت خرم دره,811,3040357,83115495900,25950,26100,27500,1550,5.97,27350,1400,5.39,26000,27500
پاكشو,گروه صنعتي پاكشو,811,5584129,37597993800,6740,6880,6760,20,0.3,6740,0,0,6560,6880
كگل,معدني و صنعتي گل گهر,808,5145750,69972123430,13620,13310,13660,40,0.29,13610,-10,-0.07,13310,13760
واحصا,احياء صنايع خراسان,807,807473,84648446000,102200,101900,105250,3050,2.98,104850,2650,2.59,100050,105250
كيميا,معدني كيمياي زنجان گستران,807,4158492,28335327900,6840,6690,6750,-90,-1.32,6810,-30,-0.44,6600,6980
والبر,سرمايه‌ گذاري‌ البرز(هلدينگ‌,806,6966870,49179626440,7120,6910,7230,110,1.54,7060,-60,-0.84,6900,7270
اتكام,بيمه اتكايي امين,804,11247809,49944811943,4238,4380,4449,211,4.98,4440,202,4.77,4350,4449
شجم,صنايع پتروشيمي تخت جمشيد,801,4448757,52532504690,11810,11350,11840,30,0.25,11810,0,0,11350,12200
قشكر,شكرشاهرود,793,26018027,62624533884,2307,2260,2422,115,4.98,2407,100,4.33,2260,2422
سپيدار,سپيدار سيستم آسيا,793,855870,18917796200,22050,20950,21850,-200,-0.91,22100,50,0.23,20950,23150
سحرخيز,صندوق س. گروه زعفران سحرخيز,789,1572160,30861719673,18920,18920,19945,1025,5.42,19630,710,3.75,18920,19990
كامياب,صندوق س. كامياب آشنا-د,784,20444961,247780692649,12113,12120,12119,6,0.05,12119,6,0.05,12119,12120
ختراك,ريخته‌گري‌ تراكتورسازي‌ ايران‌,783,7326993,47286686140,6730,6600,6400,-330,-4.9,6450,-280,-4.16,6400,6680
بمپنا,توليد برق عسلويه  مپنا,781,32824457,239263414390,7170,7000,7520,350,4.88,7290,120,1.67,6820,7520
سرچشمه,سرمايه گذاري مس سرچشمه,772,10465993,47108357517,4379,4450,4597,218,4.98,4501,122,2.79,4350,4597
وسنا,سرمايه گذاري نيروگاهي ايران,771,8207524,84460110780,10100,10140,10400,300,2.97,10290,190,1.88,9800,10400
كسرا,سراميك‌هاي‌صنعتي‌اردكان‌,767,5208025,37935988080,7470,7460,7220,-250,-3.35,7280,-190,-2.54,7130,7470
رنيك,جنرال مكانيك,767,2296266,32516419910,14150,13760,14120,-30,-0.21,14160,10,0.07,13760,14600
غاذر,كشت‌وصنعت‌پياذر,766,1951155,115624835840,56630,59000,59460,2830,5,59260,2630,4.64,56120,59460
سفار,سيمان‌فارس‌,763,1637257,147617450570,86910,86000,91250,4340,4.99,90160,3250,3.74,86000,91250
بالبر,كابل‌ البرز,759,4707681,158691240270,32700,32710,34330,1630,4.98,33710,1010,3.09,32020,34330
وليز,ليزينگ‌ايران‌,754,11736252,21825668862,1928,1840,1859,-69,-3.58,1860,-68,-3.53,1832,1991
وسپه,سرمايه‌گذاري‌ سپه‌,752,4350132,38958254150,8980,8860,8970,-10,-0.11,8960,-20,-0.22,8850,9040
درهآور,دارويي ره آورد تامين,749,1567487,55945441050,36100,36100,35900,-200,-0.55,35700,-400,-1.11,34800,37450
شاراك,پتروشيمي شازند,749,1170787,54569914550,46500,46500,46590,90,0.19,46560,60,0.13,46010,46900
شفن,پتروشيمي فناوران,743,3472198,42421631120,12220,11730,12330,110,0.9,12220,0,0,11730,12330
ميدكو,توسعه معادن وص.معدني خاورميانه,742,5512706,251274703980,45570,45580,45580,10,0.02,45580,10,0.02,45550,46000
خكمك,كمك‌فنرايندامين‌,740,2712930,58704520070,22450,22000,21610,-840,-3.74,21640,-810,-3.61,21330,22690
فافزا,فولاد افزا سپاهان,737,788474,43960280300,54200,55700,55800,1600,2.95,55750,1550,2.86,54350,55800
ساوه,سيمان ساوه,736,351237,17631951850,51700,51300,50000,-1700,-3.29,50200,-1500,-2.9,49150,52000
ماديرا,صنايع ماديران,736,6936127,22977456603,3354,3290,3312,-42,-1.25,3313,-41,-1.22,3251,3466
خشرق,الكتريك‌ خودرو شرق‌,735,3251803,47962988490,15160,14960,14570,-590,-3.89,14750,-410,-2.7,14410,15550
بالاس,مهندسي ساختمان تاسيسات راه آهن,729,978887,29575922150,30150,29100,30250,100,0.33,30200,50,0.17,29100,30850
زنگان,صنعت روي زنگان,728,559857,31058143300,54800,54900,55500,700,1.28,55500,700,1.28,52150,57450
مفاخر,توسعه فناوري اطلاعات خوارزمي,726,1341882,69391714250,50900,48200,51300,400,0.79,51700,800,1.57,48200,52950
وايران,ليزينگ ايرانيان,717,8049260,21134336761,2749,2706,2620,-129,-4.69,2626,-123,-4.47,2585,2706
سپاها,سيمان‌سپاهان‌,717,5077947,51101585790,10230,10000,10000,-230,-2.25,10060,-170,-1.66,9910,10270
كرماشا,صنايع پتروشيمي كرمانشاه,712,1233288,81091068880,65560,65050,65830,270,0.41,65730,170,0.26,64820,66600
سشرق,سيمان‌ شرق‌,710,5454881,48925963300,8970,8750,8980,10,0.11,8970,0,0,8740,9290
همراه,شركت ارتباطات سيار ايران,708,4557751,45115961690,9960,9960,9990,30,0.3,9940,-20,-0.2,9700,10000
دروز,داروسازي‌ روزدارو,708,1599070,41475890460,27260,25930,25900,-1360,-4.99,25940,-1320,-4.84,25900,26740
پسهند,صنايع‌ لاستيكي‌  سهند,703,1852343,69139833470,36130,36260,36700,570,1.58,37330,1200,3.32,36000,37930
وپست,پست بانك ايران,696,11609097,46888278633,4082,4010,4020,-62,-1.52,4039,-43,-1.05,3991,4120
كحافظ,كاشي‌ وسراميك‌ حافظ‌,696,9024426,45299824987,4963,5026,5040,77,1.55,5020,57,1.15,4850,5110
ونفت,سرمايه‌گذاري‌ صنعت‌ نفت‌,694,10625155,45889848821,4355,4160,4350,-5,-0.11,4319,-36,-0.83,4160,4429
فسپا,گروه‌صنعتي‌سپاهان‌,693,2687595,42121681830,15900,15530,15700,-200,-1.26,15670,-230,-1.45,15520,15980
فسازان,غلتك سازان سپاهان,690,6067013,33675403040,5810,5700,5520,-290,-4.99,5550,-260,-4.48,5520,5790
ولقمان,سرمايه گذاري لقمان,689,3233999,16296120961,4893,5039,5039,146,2.98,5039,146,2.98,5039,5039
ستران,سيمان‌ تهران‌,688,1695900,45302524450,27000,26880,26320,-680,-2.52,26710,-290,-1.07,25400,27430
غدشت,دشت‌ مرغاب‌,688,2506573,43483423300,16830,17570,17490,660,3.92,17350,520,3.09,16950,17570
كهمدا,شيشه‌ همدان‌,686,6763258,86314722460,12780,12780,12570,-210,-1.64,12760,-20,-0.16,12550,12990
پلاسك,پلاسكوكار,685,9386416,28730422879,3182,3200,3030,-152,-4.78,3061,-121,-3.8,3023,3274
ركيش,كارت اعتباري ايران كيش,677,4667459,23703510370,5230,5100,5030,-200,-3.82,5080,-150,-2.87,4970,5270
كارين,صندوق س نگين سامان-ثابت,676,25715296,257676506533,10014,10019,10025,11,0.11,10020,6,0.06,10017,10025
بخاور,بيمه زندگي خاورميانه,671,8244212,21136595574,2648,2615,2584,-64,-2.42,2564,-84,-3.17,2520,2632
دامين,داروسازي‌ امين‌,669,14462565,48883803657,3587,3802,3372,-215,-5.99,3380,-207,-5.77,3372,3802
خكار,ايركا پارت صنعت,668,9880277,26791743995,2694,2699,2722,28,1.04,2712,18,0.67,2613,2806
ساذري,آذريت‌,667,5127771,29628156720,5870,5760,5860,-10,-0.17,5780,-90,-1.53,5700,6000
وپسا,س. پتروشيمي ساختمان  خليج فارس,666,29999499,68891184644,2280,2348,2212,-68,-2.98,2296,16,0.7,2212,2348
كنور,توسعه معدني و صنعتي صبانور,665,1457972,28725984350,19880,19410,19680,-200,-1.01,19830,-50,-0.25,19400,19900
ماديراح,ح صنايع ماديران,664,12757129,21194948841,1691,1642,1694,3,0.18,1661,-30,-1.77,1641,1720
زپارس,ملي كشت و صنعت و دامپروري پارس,663,1514284,56110473240,36540,37000,36750,210,0.57,37050,510,1.4,36500,38000
وصنا,گروه‌صنايع‌بهشهرايران‌,660,8102515,27177465332,3458,3420,3380,-78,-2.26,3354,-104,-3.01,3300,3490
غگلستا,شير پاستوريزه پگاه گلستان,657,2475962,29797848800,11620,11300,12310,690,5.94,12030,410,3.53,11220,12310
ثالوند,سرمايه گذاري مسكن الوند,655,5844995,47352715990,7760,8070,8220,460,5.93,8100,340,4.38,7800,8220
فلامي,لاميران‌,652,1547365,28989116680,19630,18800,18650,-980,-4.99,18730,-900,-4.58,18650,19400
آباد,توريستي ورفاهي آبادگران ايران,648,776335,26015098760,33360,33500,33070,-290,-0.87,33510,150,0.45,32410,34500
ونيكي,سرمايه‌گذاري‌ ملي‌ايران‌,646,3177310,31210714670,9900,9820,9920,20,0.2,9870,-30,-0.3,9620,9940
تمحركه,ماشين سازي نيرو محركه,645,2623151,31849079380,12370,12290,12130,-240,-1.94,12140,-230,-1.86,12130,12290
سشمال,سيمان‌ شمال‌,644,3358542,39916626710,12430,12430,11690,-740,-5.95,11890,-540,-4.34,11690,12500
سكه0312پ01,تمام سكه طرح جديد0312 رفاه,642,330200,481648774800,1451972,1469000,1456000,4028,0.28,1458658,6686,0.46,1453000,1469000
تاپيكو,س. نفت و گاز و پتروشيمي تأمين,638,6076099,100169701350,16490,16470,16490,0,0,16490,0,0,16450,16550
تسه0011,امتيازتسهيلات مسكن بهمن 1400,637,8570,10048871528,1196204,1136394,1173000,-23204,-1.94,1172564,-23640,-1.98,1136394,1256014
شبصير,توليدات پتروشيمي قائد بصير,630,360238,41666854700,116150,117500,116400,250,0.22,115650,-500,-0.43,114450,117500
فولاي,صنايع فولاد آلياژي يزد,628,2838677,27009731180,9410,9280,9500,90,0.96,9510,100,1.06,9270,9840
حفارس,حمل و نقل بين المللي خليج فارس,625,5038421,45141728270,8940,8940,9100,160,1.79,8960,20,0.22,8760,9190
عيار,صندوق طلاي عيار مفيد,625,1532832,56215695753,36320,36993,36322,2,0.01,36674,354,0.97,36320,37000
دكوثر,داروسازي‌ كوثر,622,8961449,31361404011,3630,3730,3481,-149,-4.1,3500,-130,-3.58,3413,3755
شتوكا,توكا رنگ فولاد سپاهان,621,1752586,30608199280,16900,16950,17910,1010,5.98,17460,560,3.31,16360,17910
غديس,پاكديس,620,2328063,28532842880,12140,12060,12330,190,1.57,12260,120,0.99,11900,12510
دتوليد,داروسازي توليد دارو,620,3932617,37327747280,9610,9110,9580,-30,-0.31,9490,-120,-1.25,9110,9740
فروس,فروسيليس‌ ايران‌,618,5811460,41489429210,7390,7390,7230,-160,-2.17,7140,-250,-3.38,6950,7390
دلقما,دارويي‌ لقمان‌,612,11430180,23762981938,2077,2145,2094,17,0.82,2079,2,0.1,2004,2145
وصنعت,سرمايه گذاري توسعه صنعت وتجارت,611,9977805,22959437448,2313,2240,2272,-41,-1.77,2301,-12,-0.52,2240,2365
كفرآور,فرآورده هاي سيمان شرق,606,3556765,66770485850,19250,18700,18700,-550,-2.86,18750,-500,-2.6,18700,19400
وسبحان,سرمايه گذاري سبحان,605,8196992,32002071190,3845,3990,3920,75,1.95,3904,59,1.53,3757,3990
ثزاگرس,سرمايه گذاري توسعه عمران زاگرس,602,897941,29916071050,32450,33350,33250,800,2.47,33300,850,2.62,32800,33400
شزنگ,تجهيزنيروي‌زنگان‌,602,265314,22267766950,86200,83650,85350,-850,-0.99,83950,-2250,-2.61,83650,85800
غفارس,شير پاستوريزه پگاه فارس,601,6044822,36105046150,6210,5900,6060,-150,-2.42,5970,-240,-3.86,5900,6130
بكام,كارخانجات توليدي شهيد قندي,596,10914430,20543096530,1902,1850,1889,-13,-0.68,1882,-20,-1.05,1810,1950
سنير,سيمان‌ سفيد ني‌ريز,596,1613971,64979935670,38460,40300,40380,1920,4.99,40260,1800,4.68,39320,40380
خلنت,لنت‌ ترمزايران‌,591,808354,28207293600,34720,34720,35000,280,0.81,34890,170,0.49,33220,35750
دجابر,داروسازي‌ جابرابن‌حيان‌,586,8143893,99776371400,13030,12250,12250,-780,-5.99,12250,-780,-5.99,12250,12600
تاپكيش,تجارت الكترونيك پارسيان كيش,585,2054232,28594688100,13700,14020,13890,190,1.39,13920,220,1.61,13450,14250
مدير,ص.س.مديريت ثروت ص.بازنشستگي-س,584,4037915,45380254523,11241,11199,11187,-54,-0.48,11239,-2,-0.02,11000,11300
فپنتا,سپنتا,583,56562,37681242840,679740,655100,679730,-10,0,666190,-13550,-1.99,645770,679740
تپمپي,پمپ‌ سازي‌ ايران‌,582,3438398,61905987570,18750,18050,17860,-890,-4.75,18000,-750,-4,17820,18750
قجام,فرآوردههاي غذايي وقندتربت‌جام‌,581,13750657,85501976560,6320,6200,6250,-70,-1.11,6220,-100,-1.58,6200,6300
فولاژ,فولاد آلياژي ايران,580,2584649,23689007810,9220,9220,9180,-40,-0.43,9210,-10,-0.11,8910,9250
زر,صندوق س.پشتوانه سكه طلاي زر,578,532745,33210395222,62130,62900,62197,67,0.11,62338,208,0.33,62000,63000
شفا,سرمايه گذاري شفادارو,572,5945925,91611844240,16170,15370,15600,-570,-3.53,15410,-760,-4.7,15370,15780
حريل,ريل پردازسير,571,12934041,36260982335,2799,2830,2810,11,0.39,2804,5,0.18,2745,2840
اميد,تامين سرمايه اميد,570,1435773,8291243990,5860,5880,5840,-20,-0.34,5840,-20,-0.34,5600,5880
اطلس,صندوق س.توسعه اطلس مفيد-س,567,788984,217392750033,276467,276467,276479,12,0,275535,-932,-0.34,275003,277030
دبالك,مواد اوليه دارويي البرز بالك,565,2083008,21056903910,10500,9920,9990,-510,-4.86,10110,-390,-3.71,9920,10570
ثجوان,تامين مسكن جوانان,565,3625250,15917166176,4432,4430,4306,-126,-2.84,4391,-41,-0.93,4300,4500
چفيبر,فيبر ايران‌,562,3274052,20144546540,6110,5920,6100,-10,-0.16,6150,40,0.65,5920,6340
پارسيان,بيمه پارسيان,562,10232612,36723412056,3579,3450,3599,20,0.56,3589,10,0.28,3430,3730
تيپيكو,سرمايه گذاري دارويي تامين,561,3868901,83973277480,21780,22170,21710,-70,-0.32,21710,-70,-0.32,20900,22170
شبهرن,نفت‌ بهران‌,557,3140340,45709993240,14440,13860,14460,20,0.14,14520,80,0.55,13860,14700
لابسا,آبسال‌,555,4744522,34954150080,7130,7180,7480,350,4.91,7370,240,3.37,7020,7480
سدور,سيمان‌ دورود,553,3568289,25784030860,7470,7250,7360,-110,-1.47,7230,-240,-3.21,7100,7470
بزاگرس,نيروگاه زاگرس كوثر,551,8971474,44039827176,4719,4758,4954,235,4.98,4909,190,4.03,4711,4954
كسعدي,كاشي‌ سعدي‌,549,4761430,42832871100,9130,8710,8900,-230,-2.52,9000,-130,-1.42,8690,9210
حآفرين,ريل پرداز نو آفرين,547,7625328,28406425397,3692,3642,3697,5,0.14,3725,33,0.89,3620,3778
وملل,اعتباري ملل,544,3744587,28871730080,7920,7910,7610,-310,-3.91,7720,-200,-2.53,7530,8090
پاداش,صندوق س. ارزش پاداش-د,541,25508985,260122546332,10191,10198,10198,7,0.07,10197,6,0.06,10197,10198
حتايد,تايدواترخاورميانه,537,6237319,36226706620,5850,5850,5820,-30,-0.51,5810,-40,-0.68,5700,5940
واحيا,م .صنايع و معادن احياء سپاهان,536,6691897,131016947050,19850,19900,19590,-260,-1.31,19580,-270,-1.36,19430,20270
باران,بيمه زندگي باران,534,14222892,49214869491,3529,3625,3424,-105,-2.98,3460,-69,-1.96,3424,3625
ثباغ,شهر سازي و خانه سازي باغميشه,532,2666320,22251622800,8220,8260,8330,110,1.34,8350,130,1.58,8030,8500
قزوين,كارخانجات‌ قند قزوين‌,530,5792472,30319606250,5390,5270,5260,-130,-2.41,5230,-160,-2.97,5130,5570
ضسپا3015,اختيارخ خساپا-2000-1401/03/25,528,25263,3665672000,151,152,140,-11,-7.28,145,-6,-3.97,135,154
دسبحا,گروه دارويي سبحان,526,1229943,23501177560,19150,19900,19030,-120,-0.63,19110,-40,-0.21,18350,19900
پلاست,كارخانجات توليدي پلاستيران,524,1667538,27881036000,16300,16780,16780,480,2.94,16720,420,2.58,16260,16780
زنجان,صنايع كشاورزي وكود زنجان,522,5073787,20648014290,4186,4097,4061,-125,-2.99,4070,-116,-2.77,4061,4152
قيستو,شركت قند بيستون,522,1774767,43161139950,24550,25000,23850,-700,-2.85,24300,-250,-1.02,23850,25250
وبوعلي,سرمايه‌گذاري‌بوعلي‌,522,4206693,21920501580,5150,5060,5200,50,0.97,5210,60,1.17,5060,5250
تكنار,مجتمع معادن مس تكنار,521,371058,22156493950,58650,57650,60400,1750,2.98,59700,1050,1.79,57500,60400
ولصنم,ليزينگ‌صنعت‌ومعدن‌,518,2917255,7896655879,2698,2669,2728,30,1.11,2703,5,0.19,2619,2749
شكام,صنايع شيميايي كيمياگران امروز,517,1625401,54919353750,34300,34250,33300,-1000,-2.92,33800,-500,-1.46,33300,35000
ضسپا3016,اختيارخ خساپا-2500-1401/03/25,516,30180,479598000,12,20,14,2,16.67,16,4,33.33,12,23
نوين,بيمه نوين,513,8709811,17930906460,2073,2149,2026,-47,-2.27,2059,-14,-0.68,1986,2149
گپارس,امور رفاهي كارگزاران پارس,512,106001,12242902500,112150,115000,115500,3350,2.99,115500,3350,2.99,115000,115500
كشرق,صنعتي و معدني شمال شرق شاهرود,509,213787,21071697050,98050,102200,98800,750,0.76,98550,500,0.51,97400,102200
شگل,گلتاش‌,507,3446817,21383727400,6150,6000,6050,-100,-1.63,6200,50,0.81,5950,6430
گكوثر,هتل پارسيان كوثر اصفهان,506,11385714,18688529126,1675,1641,1650,-25,-1.49,1641,-34,-2.03,1610,1690
زمگسا,كشاورزي‌ ودامپروي‌ مگسال‌,505,1106256,28564119800,26060,26000,25980,-80,-0.31,25820,-240,-0.92,25040,26300
ماني,صندوق س. با درآمد ثابت ماني,504,14164546,166260915856,11731,11737,11738,7,0.06,11738,7,0.06,11737,11739
هامرز2,صندوق س اعتماد هامرز-ثابت,500,50000000,50000000,10101,1,1,-10100,-99.99,1,-10100,-99.99,1,1
فالوم,آلومتك‌,500,2408565,34417847170,14710,14270,14400,-310,-2.11,14290,-420,-2.86,14270,14700
وبيمه,سرمايه‌ گذاري‌ صنعت‌ بيمه‌,499,9078040,15558812800,1747,1695,1697,-50,-2.86,1714,-33,-1.89,1680,1770
سهرمز,سيمان‌هرمزگان‌,497,1385276,31116669200,21590,22050,22660,1070,4.96,22460,870,4.03,21300,22660
مداران,داده‌پردازي‌ايران‌,497,1648275,32729455050,19330,20280,19810,480,2.48,19860,530,2.74,19400,20280
ومهان,گروه توسعه مالي مهر آيندگان,497,5316940,29965670380,5600,5520,5730,130,2.32,5620,20,0.36,5520,5750
غبهنوش,بهنوش‌ ايران‌,496,505978,28894203790,58130,56990,57300,-830,-1.43,57110,-1020,-1.75,55420,59380
چكاوه,صنايع‌كاغذسازي‌كاوه‌,490,3821899,28445440670,7620,7270,7530,-90,-1.18,7440,-180,-2.36,7270,7720
شپتروح,ح . پتروشيمي آبادان,489,18267438,19058200115,1075,1065,1043,-32,-2.98,1043,-32,-2.98,1043,1065
سكرما,سيمان‌ كرمان‌,489,1621334,21881114550,13340,13590,13410,70,0.52,13500,160,1.2,13290,13640
كپشير,پشم‌شيشه‌ايران‌,489,1578304,17902427740,11840,11790,11300,-540,-4.56,11340,-500,-4.22,11210,11790
وسديد,گروه ‌صنعتي‌سديد,489,9390410,13578532860,1404,1446,1446,42,2.99,1437,33,2.35,1446,1446
كپرور,فرآوري زغال سنگ پروده طبس,488,2139995,23155859140,10810,10800,10880,70,0.65,10820,10,0.09,10350,11200
آ س پ,آ.س.پ,485,3010516,16259581350,5550,5250,5460,-90,-1.62,5400,-150,-2.7,5230,5520
كساوه,صنايع‌ كاشي‌ و سراميك‌ سينا,484,834849,41470589270,49130,49000,49670,540,1.1,49670,540,1.1,48000,50500
پرداخت,به پرداخت ملت,481,1590926,36204753920,22710,22990,23500,790,3.48,22760,50,0.22,21580,23790
كاذر,فرآورده‌هاي‌نسوزآذر,480,2883670,41290181230,14540,14540,14250,-290,-1.99,14320,-220,-1.51,14100,14890
قشير,قند شيروان قوچان و بجنورد,480,2801552,19335595150,6870,6970,6820,-50,-0.73,6900,30,0.44,6580,7130
فنوال,نورد آلومينيوم‌,477,832351,26681152170,32210,30380,32250,40,0.12,32060,-150,-0.47,30380,33200
سغرب,سيمان‌غرب‌,476,1466980,28126716810,19820,19250,18800,-1020,-5.15,19170,-650,-3.28,18670,20170
خوساز,محورسازان‌ايران‌خودرو,471,4078157,31721788660,8130,7890,7730,-400,-4.92,7780,-350,-4.31,7730,8070
ولراز,ليزينگ رازي,467,894691,25282646900,27500,28100,28300,800,2.91,28250,750,2.73,28000,28300
دزهراوي,داروسازي‌زهراوي‌,467,2892354,14563400240,5090,5010,5040,-50,-0.98,5040,-50,-0.98,4960,5150
اپرداز,آتيه داده پرداز,460,1504364,20610246420,14370,14350,13800,-570,-3.97,13700,-670,-4.66,13660,14350
آساميد,صندوق س.مشترك آسمان اميد -د,458,9576165,142517878538,14875,14882,14882,7,0.05,14883,8,0.05,14882,14883
وبشهر,توسعه‌ صنايع‌ بهشهر(هلدينگ,458,4317500,36749740230,8520,8510,8670,150,1.76,8510,-10,-0.12,8400,8750
واميد,گروه مديريت سرمايه گذاري اميد,451,4743067,70068194090,14750,14170,14820,70,0.47,14760,10,0.07,14170,14990
ثغرب,شركت سرمايه گذاري مسكن شمالغرب,449,10314308,52166675372,4792,4855,5079,287,5.99,5058,266,5.55,4850,5079
خراسان,پتروشيمي خراسان,448,500209,66055122730,132250,129400,132000,-250,-0.19,132110,-140,-0.11,129400,132970
توريل,توكاريل,447,1989029,17904796710,9000,8620,9050,50,0.56,9000,0,0,8620,9370
تماوند,تامين سرمايه دماوند,447,5864827,30896206490,5460,5260,5210,-250,-4.58,5270,-190,-3.48,5200,5430
ولانا,شركت ليزينگ آريا دانا,444,2464115,35554619440,14100,13800,14520,420,2.98,14430,330,2.34,13800,14520
شدوص,دوده‌ صنعتي‌ پارس‌,442,1924510,23787767280,12280,12540,12470,190,1.55,12360,80,0.65,12200,12670
نهال,صندوق س. طلاي سرخ نوويرا,441,1496831,31204816895,20296,20194,21047,751,3.7,20847,551,2.71,20194,21269
ومعلم,بيمه معلم,438,4599639,10613454786,2252,2260,2289,37,1.64,2291,39,1.73,2260,2350
ولبهمن,شركت بهمن ليزينگ,434,4257971,15244424756,3680,3700,3589,-91,-2.47,3580,-100,-2.72,3533,3700
دفرا,فرآورده‌هاي‌ تزريقي‌ ايران‌,432,2008129,36660161090,17480,18190,18350,870,4.98,18260,780,4.46,17210,18350
كترام,توليدي‌ كاشي‌ تكسرام‌,431,718402,20848038820,30110,28650,28610,-1500,-4.98,29020,-1090,-3.62,28610,29800
سلام,صندوق س سلام فارابي-سهام,430,6964112,69644492690,10010,9970,10000,-10,-0.1,10000,-10,-0.1,9970,10030
فنرژي,گسترش صنايع انرژي آذرآب,430,3190816,25491067350,7960,8000,8110,150,1.88,7990,30,0.38,7810,8110
خمحور,توليدمحورخودرو,427,7282521,19027712605,2704,2569,2630,-74,-2.74,2613,-91,-3.37,2569,2728
بهپاك,صنعتي بهپاك,427,6015324,46480196070,7710,7700,7750,40,0.52,7730,20,0.26,7600,7930
شصفها,پتروشيمي‌ اصفهان‌,427,2110046,213086082200,100800,98800,102800,2000,1.98,101000,200,0.2,98800,102800
شرنگي,شيميايي رنگين,426,68530,23219288500,346700,341150,336300,-10400,-3,338800,-7900,-2.28,336300,348000
هجرت,پخش هجرت,424,769695,24359390050,31350,30000,31700,350,1.12,31650,300,0.96,30000,32400
ثنام,س ساختماني ب نام آوران مهندسي,423,2730471,16301756120,6140,6000,5960,-180,-2.93,5970,-170,-2.77,5960,6160
فكمند,گسترش قطعه سازي كمند,422,903909,20869293100,23400,22750,23050,-350,-1.5,23100,-300,-1.28,22700,24100
دفارا,داروسازي‌ فارابي‌,420,999114,13271690400,13410,13320,13260,-150,-1.12,13300,-110,-0.82,12970,14000
تكشا,گسترش‌صنايع‌وخدمات‌كشاورزي‌,419,461898,17381999990,36420,38240,37330,910,2.5,37630,1210,3.32,36730,38240
فخاس,فولاد خراسان,419,4400814,96910515690,23170,22020,22020,-1150,-4.96,22020,-1150,-4.96,22020,22930
فايرا,آلومينيوم‌ايران‌,418,1719730,34118046930,19790,19200,19900,110,0.56,19810,20,0.1,19200,20090
شيراز,پتروشيمي‌شيراز,417,1037274,80770718890,77950,77950,77770,-180,-0.23,77880,-70,-0.09,76850,78300
وهنر,گروه توسعه هنر ايران,415,3769136,9024434969,2437,2436,2380,-57,-2.34,2397,-40,-1.64,2365,2450
بپاس,بيمه پاسارگاد,414,1690297,84020937300,49700,49700,49750,50,0.1,49700,0,0,49700,49750
كروي,توسعه‌ معادن‌ روي‌ ايران‌,413,1468621,37973785400,25670,25500,26000,330,1.29,25860,190,0.74,25330,26200
كقزوي,شيشه‌ قزوين‌,411,4532435,70370907010,15150,15300,15600,450,2.97,15530,380,2.51,15150,15600
غشهد,شهد ايران ‌,410,2967266,16990712850,5780,5590,5850,70,1.21,5730,-50,-0.87,5590,5940
بنيرو,نيروترانس‌,407,6016482,14898611519,2436,2500,2485,49,2.01,2475,39,1.6,2405,2549
ضخود3058,اختيارخ خودرو-2500-1401/03/04,406,21881,21881000,2,1,1,-1,-50,1,-1,-50,1,1
تسه0010,امتيازتسهيلات مسكن دي1400,403,5294,6294201382,1191642,1132060,1170056,-21586,-1.81,1188931,-2711,-0.23,1132060,1240000
آسيا,بيمه آسيا,403,7110292,13161634495,1837,1866,1867,30,1.63,1847,10,0.54,1813,1889
داراب,پتروشيمي داراب,403,10320972,9661785755,959,940,937,-22,-2.29,936,-23,-2.4,931,960
وكادو,تكادو,403,3191698,58677472980,18940,18380,18380,-560,-2.96,18380,-560,-2.96,18380,18920
دالبر,البرزدارو,400,2271850,22190659050,9970,9410,9930,-40,-0.4,9770,-200,-2.01,9410,10130
سمايه,بانك سرمايه,396,5457014,20561302386,3882,3766,3766,-116,-2.99,3768,-114,-2.94,3766,3840
دلر,داروسازي‌ اكسير,395,803486,36399723170,45310,45310,45280,-30,-0.07,45300,-10,-0.02,44500,46210
وتعاون,بيمه تعاون,395,7557796,11032386993,1525,1481,1449,-76,-4.98,1472,-53,-3.48,1449,1520
نيرو,نيرو سرمايه,390,1985691,51985002800,25450,26100,26200,750,2.95,26200,750,2.95,25100,26200
دسبحان,سبحان دارو,389,2893333,27531979900,9400,9050,9550,150,1.6,9520,120,1.28,9050,9780
سصوفي,سيمان‌ صوفيان‌,388,1246469,23566004040,18590,18910,18750,160,0.86,18910,320,1.72,18030,19150
ما,بيمه  ما,388,3629307,17746657050,5150,5090,4930,-220,-4.27,4890,-260,-5.05,4850,5090
فجام,جام‌دارو,388,3683160,17407864454,4693,4801,4725,32,0.68,4726,33,0.7,4620,4870
كتوكا,توليدي و خدمات صنايع نسوز توكا,388,2436847,21137845990,8780,8810,8700,-80,-0.91,8670,-110,-1.25,8560,9000
تكمبا,كمباين‌ سازي‌ ايران‌,387,6067844,26648010805,4307,4440,4305,-2,-0.05,4392,85,1.97,4202,4488
تسه0009,امتيازتسهيلات مسكن آذر 1400,387,5993,7062157933,1183354,1125000,1165000,-18354,-1.55,1178401,-4953,-0.42,1125000,1242521
آريان,سرمايه گذاري پارس آريان,383,5299252,37421701970,7100,6980,7100,0,0,7090,-10,-0.14,6970,7250
دتوزيع,توزيع دارو پخش,382,721667,25221786850,34650,33550,34700,50,0.14,34950,300,0.87,33150,35800
وتوسم,سرمايه‌گذاري‌توسعه‌ملي‌,381,3683309,16688833228,4515,4515,4500,-15,-0.33,4531,16,0.35,4472,4635
وشهر,بانك شهر,381,3917588,17803523651,4666,4539,4555,-111,-2.38,4590,-76,-1.63,4527,4649
رانفور,خدمات‌انفورماتيك‌,380,4786997,20656247803,4297,4380,4330,33,0.77,4303,6,0.14,4257,4380
پارسان,گسترش نفت و گاز پارسيان,378,2169492,65617482920,30180,30810,30180,0,0,30220,40,0.13,30160,30860
ثامان,سامان‌ گستراصفهان‌,376,2500243,37132340730,14520,14240,15000,480,3.31,14850,330,2.27,14240,15180
آبين,كشت و صنعت آبشيرين,371,11043001,53039815904,4665,4804,4804,139,2.98,4803,138,2.96,4670,4804
چافست,افست‌,368,4111715,19946047640,5080,4860,4830,-250,-4.92,4850,-230,-4.53,4830,4990
غشوكو,شوكو پارس,366,2603059,23253328290,8910,9150,8970,60,0.67,8930,20,0.22,8670,9170
حپترو,حمل و نقل پتروشيمي( سهامي عام,363,545228,13330891250,25480,25250,24210,-1270,-4.98,24490,-990,-3.89,24210,25250
جم,پتروشيمي جم,363,1082882,51171141270,47280,46500,47350,70,0.15,47270,-10,-0.02,46500,47950
آرمان,بيمه آرمان,360,7038090,30166662401,4176,4051,4301,125,2.99,4286,110,2.63,4051,4301
وحكمت,بيمه حكمت صبا,355,11398926,16942772405,1530,1490,1485,-45,-2.94,1486,-44,-2.88,1485,1530
حتوكا,حمل‌ونقل‌توكا,352,1396602,22358201340,16770,15980,15940,-830,-4.95,16010,-760,-4.53,15940,16380
ضستا7003,اختيارخ شستا-1000-1401/07/17,352,18860,3185828000,166,171,170,4,2.41,169,3,1.81,161,176
ثپرديس,سرمايه گذاري مسكن پرديس,351,7530600,35721043516,4491,4700,4760,269,5.99,4743,252,5.61,4510,4760
سفارود,كارخانه فارسيت درود,351,1705431,10969276330,6540,6440,6410,-130,-1.99,6430,-110,-1.68,6410,6600
سباقر,سيمان باقران,349,2113703,28938925770,13410,13300,13700,290,2.16,13690,280,2.09,13300,13810
وپاسار,بانك  پاسارگاد,348,8163430,73148573910,8960,8960,8970,10,0.11,8960,0,0,8960,8970
فن آوا,گروه فن آوا,348,2365742,19977242310,8700,8440,8510,-190,-2.18,8440,-260,-2.99,8440,8690
سبهان,سيمان‌ بهبهان‌,347,225933,10647255690,48090,46920,46820,-1270,-2.64,47310,-780,-1.62,46700,48750
خفناور,مهندسي صنعتي روان فن آور,344,1040493,36676503250,34250,35250,35250,1000,2.92,35250,1000,2.92,34900,35250
سكارون,سيمان كارون,343,292082,15040862200,52950,51400,51400,-1550,-2.93,51500,-1450,-2.74,51400,52800
واعتبار,سرمايه گذاري اعتبار ايران,343,3339158,10165994795,3197,3049,3038,-159,-4.97,3088,-109,-3.41,3038,3120
ياقوت,صندوق س ياقوت آگاه-ثابت,343,3092597,45928498453,14846,14856,14857,11,0.07,14851,5,0.03,14849,14857
وسكاب,س.ص.بازنشستگي كاركنان بانكها,342,5683240,16766047693,2981,3022,2947,-34,-1.14,2950,-31,-1.04,2935,3022
شخارك,پتروشيمي‌ خارك‌,337,443656,21307114510,47170,47000,47200,30,0.06,47360,190,0.4,47000,49000
سخاشح,ح . سيمان‌خاش‌,337,225952,11826429760,52600,52600,52310,-290,-0.55,52340,-260,-0.49,51800,53220
تايرا,تراكتورسازي‌ايران‌,336,869360,14977611530,17070,17650,17220,150,0.88,17180,110,0.64,16960,17650
پرديس,سرمايه گذاري پرديس,336,3505183,10819144169,3086,3120,3117,31,1,3086,0,0,3030,3130
قهكمت,قندهكمتان‌,335,2737570,19169177440,7250,7470,6890,-360,-4.97,7000,-250,-3.45,6890,7470
كگهر,سنگ آهن گهرزمين,334,1192479,59442184850,49950,49950,49900,-50,-0.1,49900,-50,-0.1,49000,50950
درسا,صندوق سرمايه گذاري درسا - سهام,332,10297731,102977310000,10000,10000,10000,0,0,10000,0,0,10000,10000
كلوند,كاشي‌ الوند,331,1141844,27692547240,24520,24000,24100,-420,-1.71,24250,-270,-1.1,23710,24880
جهرم,پتروشيمي جهرم,327,9724525,8355972338,881,857,855,-26,-2.95,862,-19,-2.16,855,880
شمواد,توليد مواداوليه الياف مصنوعي,327,361225,26522055000,74800,73350,73350,-1450,-1.94,73400,-1400,-1.87,73350,76000
غمهرا,توليدي‌مهرام‌,325,1595636,18974084530,12050,11970,12010,-40,-0.33,11890,-160,-1.33,11530,12140
ساروم,سيمان‌اروميه‌,324,627830,17567110660,27750,28000,28000,250,0.9,27980,230,0.83,27440,28490
كوثر,بيمه كوثر,322,3908815,15844679706,4112,4114,4024,-88,-2.14,4078,-34,-0.83,4010,4119
ولپارس,ليزينگ پارسيان,318,3861289,12417503302,3381,3220,3212,-169,-5,3227,-154,-4.55,3212,3350
ولملت,واسپاري ملت,317,4527608,17889835054,3829,3910,4058,229,5.98,3951,122,3.19,3850,4058
سخاش,سيمان‌خاش‌,314,218880,14349521840,65190,65120,65140,-50,-0.08,65550,360,0.55,64630,67310
تسه9905,امتياز تسهيلات مسكن مرداد99,314,3845,4945871427,1230549,1186000,1292076,61527,5,1286312,55763,4.53,1186000,1292076
گوهر,صندوق سكه طلاي كيان,311,162646,11776743718,71625,72000,72460,835,1.17,72407,782,1.09,72000,72600
نمرينو,ايران‌ مرينوس‌,310,123749,10472739410,87660,83850,84150,-3510,-4,85280,-2380,-2.72,83850,87540
رتاپ,تجارت الكترونيك  پارسيان,310,1206167,5986390210,5030,5020,4950,-80,-1.59,5000,-30,-0.6,4870,5110
وآرين,شركت توسعه اقتصادي آرين,309,10226997,12482607719,1192,1217,1227,35,2.94,1221,29,2.43,1160,1227
ريشمك,توليد و صادرات ريشمك,309,594058,15908310100,26850,26550,27000,150,0.56,26800,-50,-0.19,26550,27500
داوه,داروسازي آوه سينا,306,1520347,12016482020,7900,7840,7880,-20,-0.25,7900,0,0,7750,8050
دتماد,توليدمواداوليه‌داروپخش‌,305,579680,24091170820,41270,40500,41850,580,1.41,41560,290,0.7,40480,42530
وخاور,بانك خاورميانه,304,8166197,48795029450,5970,5840,5730,-240,-4.02,5970,0,0,5730,6010
غگلپا,شير پاستوريزه پگاه گلپايگان,301,446506,22419925700,51350,48900,50550,-800,-1.56,50200,-1150,-2.24,48900,51500
شرانل,نفت ايرانول,300,302023,16137757700,53800,52550,52950,-850,-1.58,53650,-150,-0.28,52550,54950
زيتون,صندوق س زيتون نماد پايا- مختلط,300,2895258,35894104530,12410,12350,12400,-10,-0.08,12400,-10,-0.08,12350,12500
شنفت,نفت‌ پارس‌,298,1476962,13101770760,8940,8580,8910,-30,-0.34,8920,-20,-0.22,8580,8960
تسه0006,امتيازتسهيلات مسكن شهريور1400,298,6505,7677599757,1196356,1136539,1162000,-34356,-2.87,1180261,-16095,-1.35,1136539,1256173
دارو,كارخانجات‌داروپخش‌,297,385967,11845575000,30380,29940,30870,490,1.61,30580,200,0.66,29450,31480
حسينا,توسعه خدمات دريايي وبندري سينا,293,338300,18379953200,55250,57500,54100,-1150,-2.08,54350,-900,-1.63,53400,57500
معيار ,سرمايه گذاري معيار صنعت پارس,290,395859,30176697950,74500,76700,72500,-2000,-2.68,76250,1750,2.35,72500,76700
وتوس,توسعه‌شهري‌توس‌گستر,290,1791008,14418039660,8190,8350,7930,-260,-3.17,8050,-140,-1.71,7760,8470
قصفها,قنداصفهان‌,289,189999,18324822070,96990,95010,95310,-1680,-1.73,96450,-540,-0.56,95010,99000
قشهد,شهد,288,1365571,19390900800,14730,14630,14330,-400,-2.72,14200,-530,-3.6,14000,14630
لخزر,پارس‌ خزر,288,99027,12753182840,126740,125000,128900,2160,1.7,128470,1730,1.36,125000,130580
ارزش,صندوق س ارزش آفرين بيدار-سهام,288,1165608,12965136140,11130,10950,11100,-30,-0.27,11120,-10,-0.09,10950,11250
اوان,مبين وان كيش,287,1089435,11969753420,11500,11220,10820,-680,-5.91,11020,-480,-4.17,10810,11380
پكوير,كوير تاير,285,1597349,8447373470,5380,5480,5300,-80,-1.49,5320,-60,-1.12,5210,5480
سپر,صندوق س سپر سرمايه بيدار- ثابت,282,7078641,102839236787,14519,14526,14529,10,0.07,14528,9,0.06,14526,14529
سيلام,سيمان‌ ايلام‌,281,1400590,10471235670,7720,7720,7590,-130,-1.68,7540,-180,-2.33,7340,7800
كسرام,پارس‌ سرام‌,280,2875747,17462061120,6140,6000,6100,-40,-0.65,6070,-70,-1.14,6000,6170
تپولا,مهندسي مرآت پولاد,280,1503225,22142216960,15130,15270,14680,-450,-2.97,14730,-400,-2.64,14680,15300
ضخود4014,اختيارخ خودرو-2600-1401/04/08,277,15634,654690000,52,49,37,-15,-28.85,42,-10,-19.23,34,58
وپترو,سرمايه‌گذاري صنايع پتروشيمي‌,277,1367730,15057347110,11030,10960,11000,-30,-0.27,11010,-20,-0.18,10900,11180
ثعمرا,عمران و توسعه شاهد,274,1178451,8817507940,7420,7000,7680,260,3.5,7460,40,0.54,7000,7680
ضخود4013,اختيارخ خودرو-2400-1401/04/08,273,16430,1394419000,98,80,79,-19,-19.39,85,-13,-13.27,78,94
حپارسا,توسعه حمل و نقل ريلي پارسيان,271,225643,8627134150,38650,38250,38100,-550,-1.42,38400,-250,-0.65,37550,39200
شفارا,پتروشيمي فارابي,267,1249733,7060709850,5780,5840,5610,-170,-2.94,5680,-100,-1.73,5610,5850
تنوين,تامين سرمايه نوين,267,2749997,12289328601,4507,4510,4501,-6,-0.13,4494,-13,-0.29,4356,4510
قمرو,قند مرودشت‌,267,552685,14631565670,27550,26190,26200,-1350,-4.9,26470,-1080,-3.92,26180,28500
تسه9908,امتياز تسهيلات مسكن آبان99,266,4400,5129176897,1193195,1133536,1142505,-50690,-4.25,1165722,-27473,-2.3,1133536,1250000
ضهرم6002,اختيارخ اهرم-12000-1401/06/30,264,21175,619334500,3431,3002,2880,-551,-16.06,2925,-506,-14.75,2876,3002
سمازن,سيمان‌مازندران‌,263,1619106,18543333650,11420,11620,11460,40,0.35,11450,30,0.26,11400,11680
خديزل,بهمن  ديزل,262,2134613,22589404180,10710,11240,10550,-160,-1.49,10580,-130,-1.21,10310,11240
سقاين,سيمان‌ قائن‌,262,210175,9649016730,46220,45800,44820,-1400,-3.03,46020,-200,-0.43,44180,47000
كمنگنز,معادن‌منگنزايران‌,260,461496,7620501880,16570,16450,16590,20,0.12,16540,-30,-0.18,16270,16760
تسه0008,امتيازتسهيلات مسكن آبان1400,258,4481,5268414648,1201678,1141595,1180000,-21678,-1.8,1175723,-25955,-2.16,1141595,1200000
گوهران,سرمايه گذاري توسعه گوهران اميد,256,1900152,10832498250,5650,5790,5710,60,1.06,5690,40,0.71,5530,5790
دحاوي,الحاوي,254,1191107,7098424220,6040,5910,5860,-180,-2.98,5980,-60,-0.99,5860,6090
تسه9906,امتياز تسهيلات مسكن شهريور99,251,1813,2358291917,1241962,1181069,1304060,62098,5,1300768,58806,4.73,1181069,1304060
تسه0007,امتيازتسهيلات مسكن مهر1400,251,4719,5520462739,1190855,1131313,1170100,-20755,-1.74,1169837,-21018,-1.76,1131313,1250397
لوتوس,تامين سرمايه لوتوس پارسيان,250,1620830,11393064760,7150,7050,7080,-70,-0.98,7120,-30,-0.42,6870,7150
بساما,بيمه سامان,248,2073299,24783904210,11940,11940,12060,120,1.01,11950,10,0.08,11690,12130
سخزر,سيمان‌ خزر,246,536382,13015082970,23730,24400,23930,200,0.84,24210,480,2.02,23510,24880
مرقام,ايران‌ارقام‌,246,1650540,18624209490,11670,11240,11190,-480,-4.11,11280,-390,-3.34,11150,11490
فراز,صندوق س.سهام فراز داريك-س,243,1133868,17401387916,15313,15315,15350,37,0.24,15347,34,0.22,15315,15350
كساپا,سايپاشيشه‌,243,695165,11037853720,16240,16300,16190,-50,-0.31,15950,-290,-1.79,15500,16300
دشيمي,شيمي‌ داروئي‌ داروپخش‌,243,847815,22819319090,26870,27350,26500,-370,-1.38,26920,50,0.19,26310,27380
ثنظام,س. ساختماني نظام مهندسي ايران,238,759606,13139795250,17430,17400,17500,70,0.4,17300,-130,-0.75,16910,17950
وصندوق,سرمايه‌گذاري‌صندوق‌بازنشستگي‌,230,2754719,40270854850,14640,14850,14800,160,1.09,14630,-10,-0.07,14500,14850
حشكوه,دليجان طلايي شكوه پارس,229,10187287,25933154885,2542,2500,2523,-19,-0.75,2546,4,0.16,2500,2589
كاريس,صندوق س.سپند كاريزما-س,229,2155488,32690944236,15222,14942,15350,128,0.84,15166,-56,-0.37,14942,15350
ثتوسا,س.توسعه و عمران استان اردبيل,228,673848,9935302500,15190,14740,14740,-450,-2.96,14740,-450,-2.96,14740,15200
كطبس,ذغال‌سنگ‌ نگين‌ ط‌بس‌,228,295726,5845934060,19820,19800,19620,-200,-1.01,19800,-20,-0.1,19600,20360
وثوق,سرمايه گذاري وثوق امين,227,1717011,14748430580,8360,8420,8610,250,2.99,8590,230,2.75,8420,8610
فيروزا,صندوق ارمغان فيروزه آسيا-ثابت,227,4809169,135387020779,28136,28151,28151,15,0.05,28152,16,0.06,28151,28152
غپونه,نوش پونه مشهد,226,901837,13619535100,15080,14640,15530,450,2.98,15100,20,0.13,14630,15530
هم وزن,صندوق س. شاخصي كيان-س,225,1497586,14975860000,10000,10000,10000,0,0,10000,0,0,10000,10000
اتكاي,بيمه اتكايي ايرانيان,225,2446260,33612988920,13740,13740,13740,0,0,13740,0,0,13740,13850
پكرمان,گروه‌ صنعتي‌ بارز,225,1168711,19918298440,17320,17000,16850,-470,-2.71,17040,-280,-1.62,16800,17410
ساراب,سيمان‌ داراب‌,221,310339,5004997900,16580,17000,16130,-450,-2.71,16410,-170,-1.03,15750,17130
دكپسول,توليد ژلاتين كپسول ايران,217,263035,10203510450,39000,38050,38650,-350,-0.9,38850,-150,-0.38,38050,39350
خفولا,خدمات فني فولاد يزد,216,3062549,55983395720,17750,18280,18280,530,2.99,18280,530,2.99,18280,18280
كي بي سي,شركت كي بي سي,216,703005,8778093420,12530,11950,12580,50,0.4,12490,-40,-0.32,11950,12990
پارتا,مجتمع‌صنعتي‌آرتاويل‌تاير,214,429196,7678265160,18260,18010,17740,-520,-2.85,18080,-180,-0.99,17720,18260
پلوله,گازلوله‌,212,892379,22620850800,24800,24950,25500,700,2.82,25350,550,2.22,24250,25500
داسوه,داروسازي‌ اسوه‌,212,300628,14343235990,46810,45080,48000,1190,2.54,47600,790,1.69,45080,48250
سيدكو,سرمايه گذاري توسعه صنايع سيمان,210,4025051,32028674950,7930,7930,7980,50,0.63,7960,30,0.38,7910,8010
تسه0002,امتيازتسهيلاتمسكن ارديبهشت1400,209,3106,3793182884,1283798,1219609,1219609,-64189,-5,1221244,-62554,-4.87,1219609,1280000
ثشرق,سرمايه گذاري مسكن شمال شرق,206,2849753,10836848171,3851,3889,3844,-7,-0.18,3815,-36,-0.93,3703,3900
ضخود4012,اختيارخ خودرو-2200-1401/04/08,204,9539,1645924000,186,150,165,-21,-11.29,173,-13,-6.99,150,200
ضستا7001,اختيارخ شستا-800-1401/07/17,203,15972,4953556000,311,328,311,0,0,310,-1,-0.32,310,328
كاردان,صندوق س تجارت شاخصي كاردان,201,63172,14109271930,224620,229950,222900,-1720,-0.77,223350,-1270,-0.57,221550,229950
كمينا,شيشه سازي مينا,200,2994591,31786894620,10320,10200,10620,300,2.91,10610,290,2.81,10100,10620
تسه0005,امتيازتسهيلات مسكن مرداد 1400,199,4065,4770531288,1191964,1155000,1160100,-31864,-2.67,1173562,-18402,-1.54,1150001,1251562
زعف0110پ11,زعفران0110نگين سحرخيز(پ),196,185195,72085525399,381444,385171,390150,8706,2.28,389241,7797,2.04,385171,395000
پاسا,ايران‌ياساتايرورابر,195,576794,7403838480,12590,13000,12780,190,1.51,12720,130,1.03,12290,13100
تسه0003,امتيازتسهيلات مسكن خرداد1400,194,3005,3550602214,1195127,1135372,1168200,-26927,-2.25,1181565,-13562,-1.13,1135371,1254883
مثقال,صندوق س.پشتوانه طلاي زرين آگاه,193,416383,4714375909,11223,11302,11326,103,0.92,11322,99,0.88,11300,11364
ساربيل,سيمان آرتا اردبيل,191,299997,8918371470,29550,28090,30000,450,1.52,29660,110,0.37,28090,30290
تسه9910,امتياز تسهيلات مسكن دي99,190,4246,4875112682,1183166,1190000,1135000,-48166,-4.07,1148166,-35000,-2.96,1124008,1242324
كگاز,شيشه‌ و گاز,190,560506,9115084230,16250,15800,16350,100,0.62,16260,10,0.06,15510,16740
سنوين,سرمايه گذاري اقتصاد نوين,188,1281980,7914518250,6360,6170,6170,-190,-2.99,6220,-140,-2.2,6170,6350
دقاضي,داروسازي شهيد قاضي,188,296993,9325521500,31600,32000,31750,150,0.47,31450,-150,-0.47,30950,32200
وگردش,بانك گردشگري,188,2790798,30664648430,11310,11000,10980,-330,-2.92,11160,-150,-1.33,10980,11110
آساس,صندوق س.آسمان آرماني سهام-س,183,41486,8691739170,213841,212000,209498,-4343,-2.03,209510,-4331,-2.03,208440,212988
حخزر,كشتيراني درياي خزر,183,370061,6415065060,17570,17050,17450,-120,-0.68,17460,-110,-0.63,16740,18100
دكيمي,كيميدارو,182,314485,6428182190,20710,19530,20920,210,1.01,20580,-130,-0.63,19530,20970
وارس,سرمايه گذاري ارس صبا,182,659022,11218659030,17060,17530,16980,-80,-0.47,17020,-40,-0.23,16600,17530
فزر,پويا زركان آق دره,181,1578752,47362560000,29350,30000,30000,650,2.21,30000,650,2.21,30000,30000
تسه9912,امتياز تسهيلات مسكن اسفند99,180,2203,2574281725,1193677,1133994,1160000,-33677,-2.82,1168535,-25142,-2.11,1133994,1250000
خبازرس,بازرسي مهندسي و صنعتي ايران,180,275654,4612620980,17050,16560,16880,-170,-1,16900,-150,-0.88,16560,17140
سهگمت,سيمان‌هگمتان‌,178,381051,9457249780,25110,25000,24530,-580,-2.31,24890,-220,-0.88,24210,25600
تسه9907,امتياز تسهيلات مسكن مهر99,177,1292,1630904868,1218335,1160000,1225623,7288,0.6,1262310,43975,3.61,1160000,1279251
فاما,صنعتي‌ آما,176,658367,5995604550,9200,8770,9080,-120,-1.3,9160,-40,-0.43,8770,9280
تصميم,صندوق س با درآمد ثابت تصميم,175,1972438,39143771655,19828,19841,19870,42,0.21,19845,17,0.09,19841,19899
تسه0004,امتيازتسهيلات مسكن تير1400,174,2083,2433778661,1193635,1140010,1172000,-21635,-1.81,1168401,-25234,-2.11,1133955,1220000
سپ,پرداخت الكترونيك سامان كيش,171,206970,4710889050,22270,23000,22750,480,2.16,22300,30,0.13,22520,23190
تشتاد,صنايع توليدي اشتاد ايران‌,171,1672282,9814909510,5700,5870,5870,170,2.98,5850,150,2.63,5780,5870
تسه9909,امتياز تسهيلات مسكن آذر99,170,3463,4071961002,1179746,1125100,1157000,-22746,-1.93,1175848,-3898,-0.33,1120760,1238733
تسه0001,امتيازتسهيلات مسكن فروردين1400,170,2492,3033993582,1239449,1177477,1290000,50551,4.08,1217493,-21956,-1.77,1177477,1301421
دابور,داروسازي‌ ابوريحان‌,167,307837,7452284450,24380,24700,24000,-380,-1.56,24290,-90,-0.37,24000,24750
شليا,شركت مواد ويژه ليا,166,655855,19439461300,28800,29600,29650,850,2.95,29650,850,2.95,29000,29650
ومشان,س. فني و مهندسي مشانير,164,86816,5251952350,62000,60250,60150,-1850,-2.98,60700,-1300,-2.1,60150,62750
وبهمن,سرمايه‌گذاري‌بهمن‌,158,283134,4455319120,15900,16230,15800,-100,-0.63,15860,-40,-0.25,15490,16230
تسه9911,امتياز تسهيلات مسكن بهمن99,157,1078,1282553675,1181958,1125000,1142892,-39066,-3.31,1189753,7795,0.66,1125000,1239000
وپخش,داروپخش‌ (هلدينگ‌,157,430726,14568836150,34080,33030,34140,60,0.18,34000,-80,-0.23,32560,34300
ثرود,سرمايه‌گذاري مسكن زاينده رود,157,1081360,12641098400,12430,11690,11690,-740,-5.95,11690,-740,-5.95,11690,11690
دشيري,شيرين دارو,153,52029,5122907650,100200,97650,98850,-1350,-1.35,99250,-950,-0.95,97650,101000
ويسا,سرمايه گذاري ايساتيس پويا,152,697528,4549492630,6580,6700,6520,-60,-0.91,6550,-30,-0.46,6400,6700
فسا,پتروشيمي فسا,149,3463388,3145441715,930,907,903,-27,-2.9,923,-7,-0.75,903,937
وتوشه,سرمايه‌ گذاري‌ پارس‌ توشه‌,149,1334690,8742945760,6740,6590,6410,-330,-4.9,6630,-110,-1.63,6410,6740
فاهواز,نورد و لوله اهواز,148,2864765,15720141280,5590,5480,5480,-110,-1.97,5490,-100,-1.79,5480,5590
بايكا,كارخانجات كابلسازي ‌ايران‌,147,362896,5599758010,15880,15800,15410,-470,-2.96,15610,-270,-1.7,15410,15980
ضستا7005,اختيارخ شستا-1200-1401/07/17,142,8805,616462000,71,72,70,-1,-1.41,70,-1,-1.41,68,74
سجام,مجتمع سيمان غرب آسيا,141,1980788,4989296179,2552,2480,2527,-25,-0.98,2535,-17,-0.67,2478,2555
وملت,سرمايه گذاري ملت,141,1806205,4228321904,2317,2290,2340,23,0.99,2338,21,0.91,2275,2363
زعف0110پ18,زعفران0110نگين بهرامن(پ),137,125849,49057794977,381180,385171,390100,8920,2.34,389815,8635,2.27,385171,395900
دارا,صندوق س. دارا الگوريتم-د,137,5990862,60009910814,10011,10017,10017,6,0.06,10017,6,0.06,10016,10017
سرود,سيمان‌شاهرود,132,438165,9217547730,21170,20550,21150,-20,-0.09,21090,-80,-0.38,20550,21430
شپاس,نفت پاسارگاد,132,265905,4831131150,18480,18500,18440,-40,-0.22,18390,-90,-0.49,18100,18500
سبجنو,سيمان‌ بجنورد,131,268270,11280200360,41290,42220,42000,710,1.72,41870,580,1.4,41080,43000
ساروج,بين المللي ساروج بوشهر,131,409380,6842835090,17030,16910,17030,0,0,16880,-150,-0.88,16320,17030
دعبيد,لابراتوارداروسازي‌  دكترعبيدي‌,130,273010,6518940210,24260,24590,24070,-190,-0.78,24200,-60,-0.25,23400,24600
اوصتا,صندوق انديشه ورزان صباتامين -د,129,4216362,95804766950,22708,22723,22723,15,0.07,22722,14,0.06,22722,22723
سارومح,ح . سيمان‌اروميه‌,127,184166,4606698700,25430,24800,24970,-460,-1.81,25010,-420,-1.65,24800,25450
يارا,صندوق س. آريا-د,127,5543262,59545623518,10735,10742,10741,6,0.06,10742,7,0.07,10741,10742
شساخت,مهندسي و ساختمان صنايع نفت,125,133612,5819358800,44800,43550,43500,-1300,-2.9,44650,-150,-0.33,43500,43800
بميلا,توسعه سرمايه گذاري ميلاد پارس,123,1696674,19478363670,11170,11270,11500,330,2.95,11480,310,2.78,11270,11500
فبيرا,بسته‌ بندي‌ ايران‌,122,3359410,5502712317,1670,1637,1637,-33,-1.98,1638,-32,-1.92,1637,1670
اخزا002,اسنادخزانه-م2بودجه00-031024,120,128100,74144004000,578990,579090,579500,510,0.09,578800,-190,-0.03,578060,580000
حاريا,كشتيراني آريا,120,741610,4175264300,5740,5630,5630,-110,-1.92,5640,-100,-1.74,5630,5630
آكورد2,صندوق س. آرمان آتي كوثر-د,118,11800000,11800000,38845,1,1,-38844,-100,1,-38844,-100,1,1
برن0104پ01,برنج طارم0104تجارت مازندران(پ),118,3749,3178436551,811951,819572,852548,40597,5,847809,35858,4.42,793000,852548
كاسپين,داروسازي كاسپين تامين,117,219942,4913744550,22700,21800,22150,-550,-2.42,22600,-100,-0.44,21800,22850
آوا,صندوق س.سهام آواي معيار-س,116,415897,3580537546,8623,8564,8590,-33,-0.38,8609,-14,-0.16,8564,8694
وجامي,سرمايه گذاري جامي,115,1588772,6822186968,4426,4294,4294,-132,-2.98,4326,-100,-2.26,4294,4294
زرين,صندوق س. سهام زرين كوروش-س,114,294823,4019273236,13553,13520,13655,102,0.75,13633,80,0.59,13510,13849
غبهار,كشت وصنعت بهاران گلبهار خراسان,113,307709,4757181140,15930,15460,15460,-470,-2.95,15690,-240,-1.51,15460,15460
انار,صندوق س.انارنماد ارزش-درسهام,113,513837,5739994650,11240,11200,11120,-120,-1.07,11170,-70,-0.62,11100,11320
فمراد,آلومراد,111,321882,8723002200,25810,27100,27100,1290,5,26450,640,2.48,27100,27100
افرا,افرانت,111,176877,6217226550,36950,35150,35150,-1800,-4.87,35150,-1800,-4.87,35150,35150
شكبير,پتروشيمي اميركبير,110,1223048,114966512000,96900,94000,94000,-2900,-2.99,94000,-2900,-2.99,94000,94000
قپيرا,فرآورده‌هاي‌غدايي‌وقندپيرانشهر,109,549418,4770678720,8520,8840,8640,120,1.41,8570,50,0.59,8610,8840
دپارس,پارس‌ دارو,109,191046,5970258480,31420,32500,30910,-510,-1.62,31350,-70,-0.22,30910,32500
سفاسي,شركت فارسيت اهواز,108,1347626,4284342326,3272,3184,3174,-98,-3,3231,-41,-1.25,3174,3360
فيروزه,صندوق شاخص30 شركت فيروزه- سهام,108,23878,4673879520,194520,194530,196200,1680,0.86,195740,1220,0.63,194520,196200
فردا2,صندوق س آواي فرداي زاگرس-ثابت,108,108000000,108000000,13108,1,1,-13107,-99.99,1,-13107,-99.99,1,1
سفانو,سيمان فارس نو,107,316697,10719499540,34060,33220,33500,-560,-1.64,33900,-160,-0.47,33220,34720
ثعتما,س. ساختماني اعتماد گستر,107,419451,6509879520,15990,15520,15520,-470,-2.94,15670,-320,-2,15520,15520
اراد104,مرابحه عام دولت104-ش.خ020303,106,20041300,19616424440000,1000000,978800,978800,-21200,-2.12,978800,-21200,-2.12,978800,978800
عيار2,صندوق طلاي عيار مفيد,106,1060000,1060000,36320,1,1,-36319,-100,1,-36319,-100,1,1
خاتم,صندوق س خاتم ايساتيس پويا-ثابت,106,1490723,20183986871,13530,13539,13540,10,0.07,13540,10,0.07,13538,13540
درازك,دارويي‌ رازك‌,106,355132,5769306530,16360,16470,16450,90,0.55,16310,-50,-0.31,15780,16480
مارون,پتروشيمي مارون,106,70735,13479943150,190850,190950,191100,250,0.13,190800,-50,-0.03,187150,191200
ماني2,صندوق س. با درآمد ثابت ماني,105,10500000,10500000,11731,1,1,-11730,-99.99,1,-11730,-99.99,1,1
رتكو,كنترل‌خوردگي‌تكين‌كو,102,506314,4234163300,8610,8220,8350,-260,-3.02,8540,-70,-0.81,8220,8680
لپيام,گسترش صنايع پيام,101,342737,8362782800,23700,24400,24400,700,2.95,24250,550,2.32,24400,24400
بسويچ,پارس‌سويچ‌,101,372528,5890581890,16200,16000,15840,-360,-2.22,16040,-160,-0.99,15640,16000
كيان2,صندوق س. با درآمد ثابت كيان,100,10000000,10000000,34952,1,1,-34951,-100,1,-34951,-100,1,1
فيروزا2,صندوق ارمغان فيروزه آسيا-ثابت,100,10000000,10000000,28136,1,1,-28135,-100,1,-28135,-100,1,1
وآتوس,توسعه س. كشاورزي آرين توسكا,100,305072,7733554050,24650,25350,25350,700,2.84,25350,700,2.84,25300,25350
دسينا,داروسازي‌ سينا,97,407298,10248702390,25670,25000,25470,-200,-0.78,25300,-370,-1.44,24710,25700
وثخوز,سرمايه گذاري و توسعه خوزستان,97,136054,4542176350,34150,33250,33150,-1000,-2.93,33800,-350,-1.02,33150,34000
وآفر,سرمايه گذاري ارزش آفرينان,97,387410,12261526500,32600,31650,31650,-950,-2.91,31650,-950,-2.91,31650,31650
ثقزوي,شركت عمران و سازندگي قزوين,94,545262,7355584380,13100,13490,13490,390,2.98,13380,280,2.14,13490,13490
حرهشا,رهشاد سپاهان (سهامي عام,94,52674,4905776250,95700,97550,92900,-2800,-2.93,93900,-1800,-1.88,92850,97550
وكار,بانك‌ كارآفرين‌,91,5104749,16998921978,3341,3341,3300,-41,-1.23,3337,-4,-0.12,3300,3345
حبندر,دريايي و کشتيراني خط دريابندر,90,653704,23598714400,35050,36100,36100,1050,3,36100,1050,3,36100,36100
سغدير,توسعه سرمايه و صنعت غدير,88,223593,2944787460,13140,13140,13240,100,0.76,13150,10,0.08,12900,13350
صنم,ص.س.صندوق در صندوق صنم,85,1002839,11454067841,11456,11457,11450,-6,-0.05,11422,-34,-0.3,11380,11494
سيستم,همكاران سيستم,85,564546,3542984270,6210,6050,6300,90,1.45,6220,10,0.16,6050,6430
غناب,روغن‌ نباتي‌ ناب,85,20335,3723609450,186800,183100,183100,-3700,-1.98,183950,-2850,-1.53,183100,185000
سكه0111پ05,تمام سكه طرح جديد0111آينده,84,47600,69395926800,1452834,1465000,1455006,2172,0.15,1457898,5064,0.35,1450000,1465000
اخزا005,اسنادخزانه-م5بودجه00-030626,83,251900,156155663000,619290,618110,621000,1710,0.28,619910,620,0.1,618110,621000
سمتاز,سيمان ممتازان كرمان,82,248370,4937051430,19810,20300,19830,20,0.1,19840,30,0.15,19610,20300
اخزا001,اسنادخزانه-م1بودجه00-030821,80,133100,79926780000,599460,599500,601010,1550,0.26,600500,1040,0.17,599020,601980
كهربا,صندوق س.پشتوانه سكه طلا كهربا,79,599942,7440499048,12297,12441,12380,83,0.67,12402,105,0.85,12340,12496
سكه0112پ03,تمام سكه طرح جديد0112سامان,76,14000,20415006000,1446601,1460010,1455000,8399,0.58,1458215,11614,0.8,1455000,1464900
اراد1054,مرابحه عام دولت105-ش.خ030503,74,13690000,13071869120000,1000000,954848,954848,-45152,-4.52,954848,-45152,-4.52,954848,954848
وزمين,بانك ايران زمين,74,406392,3876811300,9700,9840,9510,-190,-1.96,9660,-40,-0.41,9510,9840
شستان,پتروشيمي گلستان,74,868475,3592242084,4059,4000,4140,81,2,4112,53,1.31,4000,4140
سكه0211پ02,تمام سكه طرح جديد0211ملت,73,12800,18674788600,1448455,1455000,1455100,6645,0.46,1458968,10513,0.73,1454998,1468990
خريختح,ح . صنايع‌ريخته‌گري‌ايران‌,73,2442965,4886830000,2104,2100,2000,-104,-4.94,2000,-104,-4.94,2000,2100
تداوم,صندوق تداوم اطمينان تمدن-ثابت,71,1425169,14399506588,10098,10103,10105,7,0.07,10104,6,0.06,10103,10105
ضخود4015,اختيارخ خودرو-2800-1401/04/08,66,2945,65298000,24,20,22,-2,-8.33,22,-2,-8.33,16,28
الماس,صندوق س.امين تدبيرگران فردا-س,65,17590,2163271014,124707,120416,123000,-1707,-1.37,122983,-1724,-1.38,120416,125000
گكيش,توريستي ورفاهي آبادگران كيش,64,89671,3026396250,34750,33750,33750,-1000,-2.88,34450,-300,-0.86,33750,33750
ضشنا8013,اختيارخ شپنا-5350-1401/08/29,63,1581,2094277000,1367,1493,1310,-57,-4.17,1325,-42,-3.07,1299,1493
اخزا006,اسنادخزانه-م6بودجه00-030723,62,157400,95982620000,609560,609110,610910,1350,0.22,609800,240,0.04,609110,610910
داريك,صندوق س.اعتماد داريك-د,60,964963,12231823343,12668,12675,12675,7,0.06,12676,8,0.06,12675,12677
وحافظ,بيمه حافظ,60,756430,8055979500,10340,10650,10650,310,3,10560,220,2.13,10650,10650
رماس,صندوق س.راهبرد ممتازابن سينا-س,60,163821,2058590446,12861,13398,12511,-350,-2.72,12566,-295,-2.29,12124,13398
ضستا7004,اختيارخ شستا-1100-1401/07/17,59,3601,375805000,107,112,105,-2,-1.87,104,-3,-2.8,99,112
اطلس2,صندوق س.توسعه اطلس مفيد-س,57,570000,570000,276467,1,1,-276466,-100,1,-276466,-100,1,1
ضخود4017,اختيارخ خودرو-3250-1401/04/08,54,1917,26174000,13,12,13,0,0,14,1,7.69,12,15
وبازار,صندوق س شاخصي بازارآشنا,53,327645,4385549660,13420,13360,13350,-70,-0.52,13390,-30,-0.22,13340,13560
مرواريد,صندوق س. مرواريد بها بازار-س,53,57863,580771008,10021,10020,10039,18,0.18,10037,16,0.16,10020,10060
كايتا,ايتالران‌,52,92907,3581564850,37450,38550,38550,1100,2.94,37800,350,0.93,38550,38550
وامين,س. امين توان آفرين ساز,52,174399,1994639090,11400,11450,11450,50,0.44,11400,0,0,11400,11500
سلام2,صندوق س سلام فارابي-سهام,51,5100000,5100000,10010,1,1,-10009,-99.99,1,-10009,-99.99,1,1
شپارس,بين‌ المللي‌ محصولات‌  پارس‌,49,317033,1807088100,5430,5700,5700,270,4.97,5460,30,0.55,5700,5700
ارمغان,ص سرمايه گذاري ارمغان ايرانيان,49,966153,9764742163,10096,10108,10103,7,0.07,10107,11,0.11,10098,10109
اخزا004,اسنادخزانه-م4بودجه00-030522,49,106500,67284673000,631720,630120,632400,680,0.11,631780,60,0.01,630120,633480
ضسپا3013,اختيارخ خساپا-1600-1401/03/25,45,2125,1018635000,465,480,480,15,3.23,479,14,3.01,411,480
سي تيپ2ن32,گواهي سيمان تيپ2هرمزگان(ن),44,1625000,8757125000,5389,5389,5389,0,0,5389,0,0,5389,5389
اخزا0022,اسنادخزانه-م2بودجه00-031024,44,1656,954738650,578990,570010,578710,-280,-0.05,576530,-2460,-0.42,570010,578900
پلاستح,ح.كارخانجات توليدي پلاستيران,43,137888,1729372120,13310,13600,12520,-790,-5.94,12540,-770,-5.79,12520,13600
سكه0110پ04,تمام سكه طرح جديد 0110 صادرات,43,12200,17802966900,1450686,1465999,1455253,4567,0.31,1459260,8574,0.59,1455101,1465999
فافق,صنايع مس افق كرمان,42,671376,3208859720,4800,4800,4840,40,0.83,4790,-10,-0.21,4690,4850
ضشنا8014,اختيارخ شپنا-5850-1401/08/29,41,829,951635000,1159,1170,1150,-9,-0.78,1148,-11,-0.95,1002,1279
اخزا003,اسنادخزانه-م3بودجه00-030418,40,147100,94950634000,644410,643300,645700,1290,0.2,645480,1070,0.17,643300,645990
وايرا,سرمايه گذاري صنايع ايران,40,1325266,2772456472,2156,2092,2092,-64,-2.97,2137,-19,-0.88,2092,2092
ضسپا8057,اختيارخ خساپا-3000-1401/08/25,39,1734,169920000,69,95,86,17,24.64,98,29,42.03,86,100
قنقش,قند نقش جهان,38,16082,1904847100,120700,118300,118500,-2200,-1.82,120050,-650,-0.54,118300,120000
اخزا0042,اسنادخزانه-م4بودجه00-030522,37,1092,687401590,631720,628910,631200,-520,-0.08,629490,-2230,-0.35,628910,631200
اخزا0052,اسنادخزانه-م5بودجه00-030626,33,1537,947178570,619290,600760,619010,-280,-0.05,616250,-3040,-0.49,600760,621000
زعف0110پ20,زعفران0110نگين وحدت جام(پ),32,19528,7610021421,383793,389999,390000,6207,1.62,389698,5905,1.54,385171,399998
ضذوب3001,اختيارخ ذوب-2500-1401/03/04,31,905,185954000,206,290,225,19,9.22,205,-1,-0.49,165,290
ضملت3013,اختيارخ وبملت-4000-1401/03/18,31,936,49188000,41,50,69,28,68.29,53,12,29.27,45,69
كصدف,كاشي صدف سرام استقلال آباده,30,85995,3267810000,36900,38000,38000,1100,2.98,37250,350,0.95,38000,38000
صايند,صندوق س. گنجينه آينده روشن-د,29,168230,1699076050,10089,10100,10105,16,0.16,10100,11,0.11,10090,10105
داريوش,صندوق س. ثروت داريوش -س,28,69444,781057260,11268,11444,11220,-48,-0.43,11247,-21,-0.19,11220,11444
سي تيپ2ن17,گواهي سيمان تيپ2ماهان كرمان(ن),27,733000,5272469000,6851,7193,7193,342,4.99,7193,342,4.99,7193,7193
آينده,بازرگاني آينده سازان بهشت پارس,26,59014,741805980,12950,12570,12570,-380,-2.93,12920,-30,-0.23,12570,12570
اخزا910,اسنادخزانه-م10بودجه99-020807,25,225600,169404330000,750160,750110,751000,840,0.11,750910,750,0.1,750110,751000
ضستر3007,اختيارخ خگستر-4000-1401/03/22,25,847,125355000,97,150,105,8,8.25,148,51,52.58,100,150
ثمين,صندوق س. ثروت افزون ثمين-س,25,51577,624885939,11940,12150,12099,159,1.33,12116,176,1.47,11901,12150
وآفري,بيمه كارآفرين,25,231502,876370538,3766,3766,3770,4,0.11,3767,1,0.03,3766,3863
سايرا,ايرانيت‌,25,33260,968424650,29200,28650,28800,-400,-1.37,29200,0,0,28650,29750
افق ملت,صندوق س در سهام افق ملت,24,4021,627309780,156750,156000,156000,-750,-0.48,156010,-740,-0.47,156000,156050
فلات,گروه صنايع معادن فلات ايرانيان,24,61078,637043540,10130,10430,10430,300,2.96,10150,20,0.2,10430,10430
كهرام,توليدي گرانيت بهسرام,24,5513,307901050,56950,55850,55850,-1100,-1.93,56900,-50,-0.09,55850,55850
آتيمس,صندوق س.آرمان آتيه درخشان مس-س,24,7870,1601632420,204630,202964,203100,-1530,-0.75,203511,-1119,-0.55,202964,204498
كباده,توليد خاك نسوزاستقلال آباده,24,256010,4772026400,18100,18640,18640,540,2.98,18640,540,2.98,18640,18640
ضذوب3002,اختيارخ ذوب-3000-1401/03/04,23,1095,3635000,5,4,1,-4,-80,3,-2,-40,1,6
وسرمد,بيمه  سرمد,23,1271182,3860579734,3130,3037,3037,-93,-2.97,3092,-38,-1.21,3037,3037
ضخود5005,اختيارخ خودرو-2400-1401/05/12,22,1527,225143000,163,160,150,-13,-7.98,147,-16,-9.82,135,160
پادا,صندوق س.پاداش سرمايه پارس-س,22,295738,35126801229,117317,118000,118100,783,0.67,118777,1460,1.24,117400,119000
ولتجار,واسپاري تجار ايرانيان,21,634455,1812637935,2774,2857,2857,83,2.99,2788,14,0.5,2857,2857
ضصاد3016,اختيارخ وبصادر-2500-1401/03/11,21,1039,1939000,1,1,1,0,0,2,1,100,1,2
ثبات2,صندوق س. ثبات ويستا -د,20,82800000,82800000,11593,1,1,-11592,-99.99,1,-11592,-99.99,1,1
اخزا010,اسناد خزانه-م10بودجه00-031115,20,31700,18171518300,571896,573990,574170,2274,0.4,573234,1338,0.23,572000,574170
ضستا7002,اختيارخ شستا-900-1401/07/17,20,750,173260000,234,240,233,-1,-0.43,231,-3,-1.28,210,240
تكنو,تكنوتار,19,341328,2515587360,7020,7370,7370,350,4.99,7080,60,0.85,7370,7370
اراد99,مرابحه عام دولت99-ش.خ050723,19,415800,415800000000,1000000,1000000,1000000,0,0,1000000,0,0,1000000,1000000
اخزا008,اسنادخزانه-م8بودجه00-030919,19,51900,30648445000,590110,590310,590900,790,0.13,590530,420,0.07,590310,591010
قتربت,قند تربت حيدريه,19,114525,2020221000,17130,17640,17640,510,2.98,17230,100,0.58,17640,17640
ضخود5003,اختيارخ خودرو-2000-1401/05/12,18,839,327720000,386,420,410,24,6.22,391,5,1.3,220,420
ويستا,صندوق س. ويستا -س,18,101086,1290700948,12746,12650,12800,54,0.42,12768,22,0.17,12650,12800
قاروم,قند اروميه,18,883,169933350,198400,192450,192450,-5950,-3,198300,-100,-0.05,192450,192450
ضستا7000,اختيارخ شستا-700-1401/07/17,17,1103,438245000,399,415,400,1,0.25,397,-2,-0.5,390,415
شكف,كف,17,42959,2021220950,46150,47050,47050,900,1.95,47050,900,1.95,47050,47050
اخزا0012,اسنادخزانه-م1بودجه00-030821,17,575,344095360,599460,595010,598920,-540,-0.09,598430,-1030,-0.17,595010,598920
ضخود5004,اختيارخ خودرو-2200-1401/05/12,17,372,94667000,261,245,245,-16,-6.13,254,-7,-2.68,245,261
اخزا0062,اسنادخزانه-م6بودجه00-030723,16,654,398157860,609560,608600,608710,-850,-0.14,608800,-760,-0.12,608600,609900
اخزا903,اسنادخزانه-م3بودجه99-011110,16,78700,68625684000,870680,870970,872000,1320,0.15,871990,1310,0.15,870970,872500
سلار,شركت سيمان لارستان,16,41046,1695199800,42550,41300,41300,-1250,-2.94,42350,-200,-0.47,41300,41300
اخزا901,اسنادخزانه-م1بودجه99-010621,16,4300,4045290000,939650,940740,940860,1210,0.13,940770,1120,0.12,940740,940980
وسين,بيمه سينا,15,235587,576245802,2521,2446,2446,-75,-2.98,2516,-5,-0.2,2446,2446
ثاصفا,شركت‌ ساختمان‌ اصفهان‌,15,45146,524145060,11960,11610,11610,-350,-2.93,11940,-20,-0.17,11610,11610
صنوين,صندوق سرمايه‌گذاري صنوين-مختلط,15,2301,286122720,125280,124400,124210,-1070,-0.85,124350,-930,-0.74,124200,124410
اراد50,مرابحه عام دولت5-ش.خ0302,15,115300,115300001000,1000000,1000000,1000000,0,0,1000000,0,0,1000000,1000010
سامان06,اجاره توسعه س. سامان14060303,15,1500000,1500000000000,1000000,1000000,1000000,0,0,1000000,0,0,1000000,1000000
ضسپا8052,اختيارخ خساپا-2000-1401/08/25,15,865,320390000,362,380,380,18,4.97,370,8,2.21,350,390
بذر,صندوق س بذر اميد آفرين-سهام,14,2330,265057250,116020,114500,113310,-2710,-2.34,113760,-2260,-1.95,113310,114500
طخود4012,اختيارف خودرو-2200-1401/04/08,14,523,31380000,61,60,60,-1,-1.64,60,-1,-1.64,60,60
سي تيپ2ن24,گواهي سيمان تيپ2هگمتان(ن),13,323000,1811061000,5607,5607,5607,0,0,5607,0,0,5607,5607
طخود3058,اختيارف خودرو-2500-1401/03/04,13,505,120680000,194,220,260,66,34.02,239,45,23.2,215,260
آسام,صندوق س.آرمان سپهر آشنا-م,13,118000,1716813500,14640,14600,14540,-100,-0.68,14549,-91,-0.62,14540,14600
سي تيپ2ن02,گواهي سيمان تيپ2صوفيان(ن),12,162000,1194912000,7025,7376,7376,351,5,7376,351,5,7376,7376
سي تيپ2ن30,گواهي سيمان تيپ2كرمان(ن),12,440000,3515160000,7609,7989,7989,380,4.99,7989,380,4.99,7989,7989
سي تيپ2ن34,گواهي سيمان تيپ2ممتازان(ن),12,300000,2409900000,7651,8033,8033,382,4.99,8033,382,4.99,8033,8033
اخزا815,اسنادخزانه-م15بودجه98-010406,12,9300,9119310000,980510,980500,980600,90,0.01,980570,60,0.01,980410,980990
ثروتم,صندوق س. ثروت آفرين پارسيان-س,12,2130,206294020,97204,96776,97150,-54,-0.06,96852,-352,-0.36,96476,97426
پكويرح,ح. كوير تاير,11,37294,149176000,4000,4000,4000,0,0,4000,0,0,4000,4000
ضفلا3013,اختيارخ فولاد-12000-1401/03/18,11,148,74000000,668,500,500,-168,-25.15,500,-168,-25.15,500,500
زعف0110پ05,زعفران0110نگين زرين(پ),11,4515,1810656500,395000,400000,401000,6000,1.52,401031,6031,1.53,400000,405000
خعمرا,توسعه و عمران شهرستان نائين,11,89573,876919670,9510,9790,9790,280,2.94,9530,20,0.21,9790,9790
اعتماد2,صندوق س.اعتماد آفرين پارسيان-د,11,103400000,103400000,44446,1,1,-44445,-100,1,-44445,-100,1,1
اخزا9022,اسنادخزانه-م2بودجه99-011019,10,250,219917700,880980,880980,879310,-1670,-0.19,879670,-1310,-0.15,879010,880980
اوج,صندوق س.اوج دماوند-س,10,30949,345176646,11458,11157,11153,-305,-2.66,11153,-305,-2.66,11153,11157
سي تيپ2ن07,گواهي سيمان تيپ 2تهران(ن),9,219000,1605489000,6982,7331,7331,349,5,7331,349,5,7331,7331
اخزا908,اسنادخزانه-م8بودجه99-020606,9,111700,86954813000,778000,778500,776330,-1670,-0.21,778470,470,0.06,776330,778500
ثاژن,سخت آژند,9,31786,139731256,4485,4396,4396,-89,-1.98,4483,-2,-0.04,4396,4396
اخزا0102,اسناد خزانه-م10بودجه00-031115,9,214,122354190,571896,571110,572500,604,0.11,571750,-146,-0.03,571100,572500
ضسپا8047,اختيارخ خساپا-1500-1401/08/25,9,520,376930000,745,760,720,-25,-3.36,725,-20,-2.68,700,760
ضجار7050,اختيارخ وتجارت-1980-1401/07/20,9,122,50720000,420,519,514,94,22.38,416,-4,-0.95,410,519
اخزا911,اسنادخزانه-م11بودجه99-020906,8,200000,148100000000,739960,740500,740500,540,0.07,740500,540,0.07,740500,740500
تملي703,تسهيلات مسكن ب. ملي-خرداد97,8,56,33291262,609514,579039,579039,-30475,-5,594487,-15027,-2.47,579039,639989
اخزا0082,اسنادخزانه-م8بودجه00-030919,8,372,219368800,590110,589410,590500,390,0.07,589700,-410,-0.07,589410,590500
سي تيپ2ن27,گواهي سيمان تيپ2آبيك(ن),8,188000,1268436000,6426,6747,6747,321,5,6747,321,5,6747,6747
سيناد,صندوق س.سپهرسودمند سينا-د,8,225902,2259924626,10002,10004,10004,2,0.02,10004,2,0.02,10004,10005
شيشه104ن,گواهي شيشه فلوت6بيرنگBدماوند,7,4950,4667355000,1037190,942900,942900,-94290,-9.09,942900,-94290,-9.09,942900,942900
بتك,كارخانجات كابل سازي‌ تك‌,7,6796,1052020800,151800,154800,154800,3000,1.98,154800,3000,1.98,154800,154800
كابگن,توليدي و صنعتي آبگينه‌,7,16193,139583660,8700,8620,8620,-80,-0.92,8700,0,0,8620,8620
شتولي,تولي‌پرس‌,7,6867,118799100,16970,17300,17300,330,1.94,17300,330,1.94,17300,17300
زعف0110پ10,زعفران0110نگين طلاي سرخ(پ),7,1257,503061813,400165,409500,402100,1935,0.48,400208,43,0.01,400007,409500
ضسپا3017,اختيارخ خساپا-3000-1401/03/25,7,460,1410000,4,6,3,-1,-25,3,-1,-25,3,6
ضجار7051,اختيارخ وتجارت-2180-1401/07/20,7,139,41807000,299,285,300,1,0.33,301,2,0.67,285,308
ضپلا4007,اختيارخ پالايش-90000-01/04/29,7,700,17500000,2335,2500,2500,165,7.07,2500,165,7.07,2500,2500
ضترا3015,اختيارخ شتران-5000-1401/03/08,7,100,30055000,288,281,260,-28,-9.72,301,13,4.51,260,350
اراد61,مرابحه عام دولت61-ش.خ0309,7,150000,150000000000,1000000,1000000,1000000,0,0,1000000,0,0,1000000,1000000
گنجينه,صندوق س. گنجينه داريوش-د,7,15864,160245264,10100,10101,10101,1,0.01,10101,1,0.01,10101,10102
اخزا9012,اسنادخزانه-م1بودجه99-010621,7,161,149416900,939650,892690,938210,-1440,-0.15,928060,-11590,-1.23,892690,940740
فبستم,صنايع ‌بسته‌بندي‌ مشهد,7,35437,682516620,18700,19260,19260,560,2.99,18740,40,0.21,19260,19260
اخزا9032,اسنادخزانه-م3بودجه99-011110,7,195,169590330,870680,869450,870000,-680,-0.08,869690,-990,-0.11,869450,870680
اخزا902,اسنادخزانه-م2بودجه99-011019,7,800,704880000,880980,881100,881100,120,0.01,881100,120,0.01,881100,881100
سخند,صندوق س.سپهرخبرگان نفت-د,7,5860,59094500,10068,10080,10079,11,0.11,10084,16,0.16,10079,10085
اخزا918,اسنادخزانه-م18بودجه99-010323,7,14400,14235972000,988500,988650,988520,20,0,988610,110,0.01,988520,989300
اخزا007,اسنادخزانه-م7بودجه00-030912,6,3500,2076399000,593180,593000,594500,1320,0.22,593260,80,0.01,593000,594500
ضخود5010,اختيارخ خودرو-3500-1401/05/12,6,100,1000000,50,10,10,-40,-80,10,-40,-80,10,10
ضملت3010,اختيارخ وبملت-2500-1401/03/18,6,100,132500000,1325,1300,1350,25,1.89,1325,0,0,1300,1350
سي تيپ2ن01,گواهي سيمان تيپ 2 فارس(ن),6,88000,697048000,7544,7921,7921,377,5,7921,377,5,7921,7921
اخزا914,اسنادخزانه-م14بودجه99-021025,6,100200,72095989000,718710,719500,739990,21280,2.96,719520,810,0.11,719500,739990
صبهمن052,صكوك مرابحه بهمن 052-3ماهه18%,6,55000,52250000000,950000,950000,950000,0,0,950000,0,0,950000,950000
سي تيپ2ن11,گواهي سيمان تيپ2دورود(ن),6,172000,1166848000,6461,6784,6784,323,5,6784,323,5,6784,6784
سي تيپ2ن03,گواهي سيمان تيپ2اروميه(ن),6,159000,996135000,5967,6265,6265,298,4.99,6265,298,4.99,6265,6265
اخزا8152,اسنادخزانه-م15بودجه98-010406,6,154,150737750,980510,980130,981000,490,0.05,978820,-1690,-0.17,977010,981000
اهرم2,صندوق س سهامي كاريزما- اهرمي,5,17700000,17700000,14100,1,1,-14099,-99.99,1,-14099,-99.99,1,1
اخزا009,اسناد خزانه-م9بودجه00-031101,5,16100,9276062000,576020,575530,576520,500,0.09,576150,130,0.02,575530,576520
تاراز,صندوق س آواي تاراز زاگرس-سهام,5,11848,142696320,11850,11890,12050,200,1.69,12040,190,1.6,11890,12050
ضخود5002,اختيارخ خودرو-1900-1401/05/12,5,24,12190000,468,509,500,32,6.84,508,40,8.55,500,510
ضخود3056,اختيارخ خودرو-1800-1401/03/04,5,51,20699000,600,460,400,-200,-33.33,406,-194,-32.33,400,460
ضهاي7005,اختيارخ هاي وب-2347-01/07/10,5,172,479600000,3260,2800,2600,-660,-20.25,2788,-472,-14.48,2600,2800
سي تيپ2ن31,گواهي سيمان تيپ2گيلان سبز(ن),5,154000,863478000,5607,5607,5607,0,0,5607,0,0,5607,5607
اگ010819,گام بانك صادرات 0108,5,40000,35988980000,895236,896000,899820,4584,0.51,899724,4488,0.5,896000,899820
فولاد2,فولاد مباركه اصفهان,5,47600000,581699000000,12400,12140,12200,-200,-1.61,12221,-179,-1.44,12140,12250
ثهام,صندوق س ثروت هامرز-سهام,5,6554,77274960,12020,11760,11760,-260,-2.16,11790,-230,-1.91,11760,12000
ضذوب3000,اختيارخ ذوب-2000-1401/03/04,5,58,39882000,726,701,700,-26,-3.58,688,-38,-5.23,670,701
سپرمي,پرميت‌,5,10190,270544500,26300,26550,26550,250,0.95,26550,250,0.95,26550,26550
زيتون2,صندوق س زيتون نماد پايا- مختلط,5,3610000,3610000,12410,1,1,-12409,-99.99,1,-12409,-99.99,1,1
اخزا0032,اسنادخزانه-م3بودجه00-030418,5,163,104874300,644410,643650,640010,-4400,-0.68,643400,-1010,-0.16,640010,643700
گوهر2,صندوق سكه طلاي كيان,5,50000,50000,71625,1,1,-71624,-100,1,-71624,-100,1,1
گنجين,صندوق س. گنجينه يكم آويد-د,5,3018,46926846,15545,15547,15547,2,0.01,15549,4,0.03,15547,15550
اخزا814,اسنادخزانه-م14بودجه98-010318,5,11200,11104804000,990700,991500,991500,800,0.08,991500,800,0.08,991500,991510
اخزا0092,اسناد خزانه-م9بودجه00-031101,5,91,52307600,576020,580120,572020,-4000,-0.69,574810,-1210,-0.21,549010,580120
فسديد,لوله‌وتجهيزات‌ سديد - ورشكسته,5,6019,296134800,48750,49200,49200,450,0.92,48800,50,0.1,49200,49200
سپيدما2,صندوق س. سپيد دماوند-د,4,22000000,22000000,12613,1,1,-12612,-99.99,1,-12612,-99.99,1,1
سي تيپ2ن35,گواهي سيمان تيپ2دشتستان(ن)	,4,200000,1143400000,5445,5717,5717,272,5,5717,272,5,5717,5717
پتروما,صندوق س.بخشي پتروشيمي دماوند-ب,4,6500,70110500,10889,10789,10786,-103,-0.95,10786,-103,-0.95,10786,10789
ضذوب3003,اختيارخ ذوب-3500-1401/03/04,4,40,40000,6,1,1,-5,-83.33,1,-5,-83.33,1,1
زير0103پ04,زيره سبز0103شركت مينوبذر(پ),4,45,56316075,1298560,1258000,1243739,-54821,-4.22,1251468,-47092,-3.63,1243739,1258000
اخزا821,اسنادخزانه-م21بودجه98-020906,4,2400,1773224000,737900,739000,738530,630,0.09,738840,940,0.13,738530,739000
هكشو208,اختيارف ت پاكشو9799-02/08/29,4,70000,35910000,534,513,513,-21,-3.93,513,-21,-3.93,513,513
نگين,ص.س. زمين و ساختمان نگين شهرري,4,53018,2830099040,53360,53350,53380,20,0.04,53380,20,0.04,53350,53380
پشاهن,توليدي پلاستيك‌ شاهين,4,8867,475714550,52100,53650,53650,1550,2.98,53650,1550,2.98,53650,53650
اخزا9052,اسنادخزانه-م5بودجه99-020218,4,74,61161000,826500,826500,826500,0,0,826500,0,0,826500,826500
شيشه90ن,گواهي شيشه فلوت6بيرنگAكاويان,4,4950,4755608550,960729,960729,960729,0,0,960729,0,0,960729,960729
اراد46,مرابحه عام دولت4-ش.خ 0302,4,57000,57000000000,1000000,1000000,1000000,0,0,1000000,0,0,1000000,1000000
ضفلا3012,اختيارخ فولاد-10000-1401/03/18,3,80,185200000,2382,2360,2300,-82,-3.44,2315,-67,-2.81,2300,2360
سي تيپ2ن12,گواهي سيمان تيپ2خزر(ن),3,50000,294350000,5607,5887,5887,280,4.99,5887,280,4.99,5887,5887
سي تيپ2ن05,گواهي سيمان تيپ 2خاش(ن),3,75000,587475000,7460,7833,7833,373,5,7833,373,5,7833,7833
سي تيپ2ن21,گواهي سيمان تيپ2زاوه تربت(ن),3,84000,470988000,5607,5607,5607,0,0,5607,0,0,5607,5607
ضملت3012,اختيارخ وبملت-3500-1401/03/18,3,102,38740000,304,320,381,77,25.33,380,76,25,320,381
ضسپا8050,اختيارخ خساپا-1800-1401/08/25,3,70,35660000,510,530,500,-10,-1.96,509,-1,-0.2,500,530
ضصاد3015,اختيارخ وبصادر-2000-1401/03/11,3,21,3150000,174,150,150,-24,-13.79,150,-24,-13.79,150,150
كمند2,صندوق س. با درآمد ثابت كمند,3,191500000,191500000,10102,1,1,-10101,-99.99,1,-10101,-99.99,1,1
سي تيپ2ن19,گواهي سيمان تيپ2غرب آسيا(ن),3,140000,738780000,5277,5277,5277,0,0,5277,0,0,5277,5277
اخزا0072,اسنادخزانه-م7بودجه00-030912,3,141,83511820,593180,592200,592360,-820,-0.14,592280,-900,-0.15,592200,592360
ضرنا4005,اختيارخ ورنا-4000-1401/04/22,3,7,13350000,2400,1900,1950,-450,-18.75,1907,-493,-20.54,1900,1950
ضصاد3014,اختيارخ وبصادر-1800-1401/03/11,3,103,34568000,293,335,336,43,14.68,336,43,14.68,335,336
ضسپا8051,اختيارخ خساپا-1900-1401/08/25,3,300,132000000,423,440,440,17,4.02,440,17,4.02,440,440
سي تيپ2ن22,گواهي سيمان تيپ2كردستان(ن),2,60000,365100000,5796,6085,6085,289,4.99,6085,289,4.99,6085,6085
كهربا2,صندوق س.پشتوانه سكه طلا كهربا,2,300000,300000,12297,1,1,-12296,-99.99,1,-12296,-99.99,1,1
وبصادر2,بانك صادرات ايران,2,26553350,55530255850,2151,2151,2086,-65,-3.02,2091,-60,-2.79,2086,2151
ضشنا8018,اختيارخ شپنا-8350-1401/08/29,2,34,10238000,268,302,301,33,12.31,301,33,12.31,301,302
ضملت3014,اختيارخ وبملت-4500-1401/03/18,2,104,1032000,16,8,10,-6,-37.5,10,-6,-37.5,8,10
ضخود5007,اختيارخ خودرو-2800-1401/05/12,2,200,10000000,89,50,50,-39,-43.82,50,-39,-43.82,50,50
ضفلا3009,اختيارخ فولاد-7000-1401/03/18,2,10,52010000,5043,5210,5200,157,3.11,5201,158,3.13,5200,5210
اخزا0084,اسنادخزانه-م8بودجه00-030919,2,884500,522253025000,590110,590450,590450,340,0.06,590450,340,0.06,590450,590450
هماي2,صندوق س هماي آگاه-ثابت,2,30951999,30951999,10013,1,1,-10012,-99.99,1,-10012,-99.99,1,1
ضهاي7000,اختيارخ هاي وب-1594-01/07/10,2,101,505000000,5156,5000,5000,-156,-3.03,5000,-156,-3.03,5000,5000
اخزا818,اسنادخزانه-م18بودجه98-010614,2,400,378800000,943600,947000,947000,3400,0.36,947000,3400,0.36,947000,947000
افران2,صندوق س افرا نماد پايدار-ثابت,2,14800000,14800000,16392,1,1,-16391,-99.99,1,-16391,-99.99,1,1
تملي801,تسهيلات مسكن ب. ملي-فروردين98,2,61,29977291,517295,491431,491431,-25864,-5,491431,-25864,-5,491431,491431
طلا2,صندوق س.پشتوانه طلاي لوتوس,2,200000,200000,100675,1,1,-100674,-100,1,-100674,-100,1,1
اخزا9102,اسنادخزانه-م10بودجه99-020807,2,143,106894660,750160,747500,747530,-2630,-0.35,747520,-2640,-0.35,747500,747530
اخزا817,اسنادخزانه-م17بودجه98-010512,2,200,192250000,960310,960750,961750,1440,0.15,961250,940,0.1,960750,961750
اخزا909,اسنادخزانه-م9بودجه99-020316,2,200,162789000,811850,813940,813950,2100,0.26,813940,2090,0.26,813940,813950
زعف0110پ19,زعفران0110نگين تروند قاينات(پ),2,87,35040053,410002,401001,409999,-3,0,402759,-7243,-1.77,401001,409999
ضستا7006,اختيارخ شستا-1300-1401/07/17,2,191,7549000,40,40,39,-1,-2.5,40,0,0,39,40
ضذوب8002,اختيارخ ذوب-2340-1401/08/04,2,101,73900000,1050,900,730,-320,-30.48,732,-318,-30.29,730,900
ضخود5006,اختيارخ خودرو-2600-1401/05/12,2,200,18000000,90,90,90,0,0,90,0,0,90,90
طسپا3015,اختيارف خساپا-2000-1401/03/25,2,200,10300000,58,50,53,-5,-8.62,51,-7,-12.07,50,53
ضهمن3000,اختيارخ خبهمن-1200-1401/03/11,2,6,3438000,712,511,635,-77,-10.81,573,-139,-19.52,511,635
اراد384,مرابحه عام دولت3-ش.خ 0105,2,290000,287187000000,987500,990300,990300,2800,0.28,990300,2800,0.28,990300,990300
كمند4,صندوق س. با درآمد ثابت كمند,2,236700000,2392446600000,10102,10105,10108,6,0.06,10108,6,0.06,10105,10108
كارا2,صندوق س. كارا -د,2,18000000,18000000,11386,1,1,-11385,-99.99,1,-11385,-99.99,1,1
ضخود5000,اختيارخ خودرو-1700-1401/05/12,2,200,136000000,574,680,680,106,18.47,680,106,18.47,680,680
ضپنا7053,اختيارخ رمپنا-16000-1401/07/12,2,12,54800000,3700,4500,4900,1200,32.43,4567,867,23.43,4500,4900
ضخود5001,اختيارخ خودرو-1800-1401/05/12,2,200,118000000,585,590,590,5,0.85,590,5,0.85,590,590
ضستر3006,اختيارخ خگستر-3750-1401/03/22,2,11,3850000,290,350,350,60,20.69,350,60,20.69,350,350
ضذوب3004,اختيارخ ذوب-4000-1401/03/04,2,21,21000,74,1,1,-73,-98.65,1,-73,-98.65,1,1
سي تيپ2ن25,گواهي سيمان تيپ2نهاوند(ن),2,48000,277248000,5607,5776,5776,169,3.01,5776,169,3.01,5776,5776
سي تيپ2ن04,گواهي سيمان تيپ2فارس نو(ن),2,40000,306960000,7309,7674,7674,365,4.99,7674,365,4.99,7674,7674
سي تيپ2ن08,گواهي سيمان تيپ 2زنجان(ن),2,64000,376768000,5607,5887,5887,280,4.99,5887,280,4.99,5887,5887
ضستر3009,اختيارخ خگستر-5000-1401/03/22,2,16,320000,15,20,20,5,33.33,20,5,33.33,20,20
ضپاس7037,اختيارخ وپارس-1800-1401/07/27,2,200,92000000,1,460,460,459,45900,460,459,45900,460,460
شيشه63ن,گواهي شيشه فلوت4بيرنگBكاوه,2,4800,3144753600,655157,655157,655157,0,0,655157,0,0,655157,655157
سي تيپ2ن14,گواهي سيمان تيپ2ساوه(ن),2,37000,245273000,6314,6629,6629,315,4.99,6629,315,4.99,6629,6629
سي تيپ2ن10,گواهي سيمان تيپ 2غرب(ن),2,25000,147175000,5607,5887,5887,280,4.99,5887,280,4.99,5887,5887
اراد314,مرابحه عام دولت3-ش.خ 0208,2,800000,777384000000,929180,971730,971730,42550,4.58,971730,42550,4.58,971730,971730
غزر2,صنعتي زر ماكارون,2,19600000,194040000000,10390,9900,9900,-490,-4.72,9900,-490,-4.72,9900,9900
سمتا024,سلف موازي متانول بوشهر 024,1,100,91192800,911504,911928,911928,424,0.05,911928,424,0.05,911928,911928
صبهمن0522,صكوك مرابحه بهمن 052-3ماهه18%,1,1500000,1425000000000,950000,950000,950000,0,0,950000,0,0,950000,950000
مشهد212,مشاركت ش مشهد212-3ماهه18%,1,100,98374700,975456,983747,983747,8291,0.85,983747,8291,0.85,983747,983747
افران4,صندوق س افرا نماد پايدار-ثابت,1,18000000,295236000000,16392,16402,16402,10,0.06,16402,10,0.06,16402,16402
سنفت021,سلف موازي نفت.س صادر اروند 021,1,100,211973700,2118752,2119737,2119737,985,0.05,2119737,985,0.05,2119737,2119737
اراد92,مرابحه عام دولت92-ش.خ020825,1,2000,1950000000,953700,975000,975000,21300,2.23,975000,21300,2.23,975000,975000
اراد72,مرابحه عام دولت72-ش.خ0311,1,100,95607000,977000,956070,956070,-20930,-2.14,956070,-20930,-2.14,956070,956070
سي تيپ2ن29,گواهي سيمان تيپ2فيروزكوه(ن),1,10000,58870000,5607,5887,5887,280,4.99,5887,280,4.99,5887,5887
سي تيپ2ن37,گواهي سيمان تيپ2شمال(ن),1,25000,192675000,7340,7707,7707,367,5,7707,367,5,7707,7707
سمتا025,سلف موازي متانول بوشهر 025,1,100,103699300,1036511,1036993,1036993,482,0.05,1036993,482,0.05,1036993,1036993
سرو4,صندوق س سروسودمند مدبران-سهام,1,400000,31464000000,77900,78660,78660,760,0.98,78660,760,0.98,78660,78660
كگل2,معدني و صنعتي گل گهر,1,30000000,410100000000,13620,13670,13670,50,0.37,13670,50,0.37,13670,13670
اراد13,مرابحه عام دولت1-ش.خ ساير0206,1,1000,1000000000,963950,1000000,1000000,36050,3.74,1000000,36050,3.74,1000000,1000000
ضجار7047,اختيارخ وتجارت-1680-1401/07/20,1,6,3960000,690,660,660,-30,-4.35,660,-30,-4.35,660,660
ضملت3011,اختيارخ وبملت-3000-1401/03/18,1,4,3680000,852,920,920,68,7.98,920,68,7.98,920,920
ضسپا3014,اختيارخ خساپا-1800-1401/03/25,1,100,30100000,308,301,301,-7,-2.27,301,-7,-2.27,301,301
ضجار7052,اختيارخ وتجارت-2380-1401/07/20,1,10,2700000,275,270,270,-5,-1.82,270,-5,-1.82,270,270
صپا ه 10,بار پايه هفته 10صنعتي,1,10000,6750000,545,675,675,130,23.85,675,130,23.85,675,675
اراد57,مرابحه عام دولت5-ش.خ 0309,1,2000,2000000000,970000,1000000,1000000,30000,3.09,1000000,30000,3.09,1000000,1000000
آكورد4,صندوق س. آرمان آتي كوثر-د,1,12800000,497523200000,38845,38869,38869,24,0.06,38869,24,0.06,38869,38869
ضسپا3012,اختيارخ خساپا-1400-1401/03/25,1,7,4900000,700,700,700,0,0,700,0,0,700,700
اگ010518,گام بانك تجارت0105,1,6,5700000,946000,950000,950000,4000,0.42,950000,4000,0.42,950000,950000
اراد76,مرابحه عام دولت76-ش.خ030406,1,1000,932000000,955000,932000,932000,-23000,-2.41,932000,-23000,-2.41,932000,932000
صمعاد407,صكوك اجاره معادن407-3ماهه18%,1,15,14925000,995000,995000,995000,0,0,995000,0,0,995000,995000
قم0312,مشاركت ش قم0312-سه ماهه18%,1,5,5050000,1010000,1010000,1010000,0,0,1010000,0,0,1010000,1010000
سمتا023,سلف موازي استاندارد سمتا023,1,100,93486900,934434,934869,934869,435,0.05,934869,435,0.05,934869,934869
سي تيپ2ن18,گواهي سيمان تيپ2مدلل(ن),1,75000,469575000,5963,6261,6261,298,5,6261,298,5,6261,6261
سمتا011,سلف موازي استاندارد سمتا011,1,10,90192460,9015526,9019246,9019246,3720,0.04,9019246,3720,0.04,9019246,9019246
ضفلا7014,اختيارخ فولاد-5694-1401/07/24,1,1,2300000,2499,2300,2300,-199,-7.96,2300,-199,-7.96,2300,2300
ضبدر3013,اختيارخ شبندر-7000-1401/03/29,1,1,1700000,2500,1700,1700,-800,-32,1700,-800,-32,1700,1700
زعف0110پ21,زعفران0110نگين ملل(پ),1,20,8020000,409633,401000,401000,-8633,-2.11,401000,-8633,-2.11,401000,401000
اراد31,مرابحه عام دولت3-ش.خ 0208,1,1000,970000000,929180,970000,970000,40820,4.39,970000,40820,4.39,970000,970000
متا0105,آتي متانول -1401/05/17,1,100,93800000,938000,938000,938000,0,0,938000,0,0,938000,938000
اراد84,مرابحه عام دولت84-ش.خ030624,1,1000,985000000,967000,985000,985000,18000,1.86,985000,18000,1.86,985000,985000
ضحافرين1203,اختيارخ حافرين-2500-14011214,1,1,1540000,1610,1540,1540,-70,-4.35,1540,-70,-4.35,1540,1540
نسب0106,آتي نفتاي سبك-1401/06/17,1,100,239800000,2398000,2398000,2398000,0,0,2398000,0,0,2398000,2398000
سحرا021,سلف موازي برق نيروي برق حرارتي,1,200,69236200,339088,346181,346181,7093,2.09,346181,7093,2.09,346181,346181
متا0106,آتي متانول -1401/06/17,1,100,94400000,944000,944000,944000,0,0,944000,0,0,944000,944000
طهرم6004,اختيارف اهرم-14000-1401/06/30,1,1,10000,1,1000,1000,999,99900,1000,999,99900,1000,1000
سمتا021,سلف موازي استاندارد سمتا021,1,100,92918800,928756,929188,929188,432,0.05,929188,432,0.05,929188,929188
پادا2,صندوق س.پاداش سرمايه پارس-س,1,250000,250000,117317,1,1,-117316,-100,1,-117316,-100,1,1
نسب0105,آتي نفتاي سبك-1401/05/17,1,100,239900000,2399000,2399000,2399000,0,0,2399000,0,0,2399000,2399000
كحافظ2,كاشي‌ وسراميك‌ حافظ‌,1,13000000,65299000000,4963,5023,5023,60,1.21,5023,60,1.21,5023,5023
ثفارس2,عمران‌وتوسعه‌فارس‌,1,3000000,20100000000,6710,6700,6700,-10,-0.15,6700,-10,-0.15,6700,6700
اخزا0024,اسنادخزانه-م2بودجه00-031024,1,100000,58060000000,578990,580600,580600,1610,0.28,580600,1610,0.28,580600,580600
اراد874,مرابحه عام دولت87-ش.خ030304,1,294000,275954280000,950000,938620,938620,-11380,-1.2,938620,-11380,-1.2,938620,938620
سي تيپ2ن09,گواهي سيمان تيپ 2خوزستان(ن),1,50000,359650000,6851,7193,7193,342,4.99,7193,342,4.99,7193,7193
ضترا3012,اختيارخ شتران-3500-1401/03/08,1,6,10800000,2167,1800,1800,-367,-16.94,1800,-367,-16.94,1800,1800
ضشنا8015,اختيارخ شپنا-6350-1401/08/29,1,2,1600000,800,800,800,0,0,800,0,0,800,800
ضهمن3005,اختيارخ خبهمن-2500-1401/03/11,1,20,100000,52,5,5,-47,-90.38,5,-47,-90.38,5,5
ضپنا7052,اختيارخ رمپنا-15000-1401/07/12,1,10,44000000,3680,4400,4400,720,19.57,4400,720,19.57,4400,4400
ضجار7049,اختيارخ وتجارت-1880-1401/07/20,1,2,960000,500,480,480,-20,-4,480,-20,-4,480,480
ضستر3004,اختيارخ خگستر-3250-1401/03/22,1,73,36500000,634,500,500,-134,-21.14,500,-134,-21.14,500,500
زعف0110پ08,زعفران0110نگين روستا(پ),1,100,40100000,390000,401000,401000,11000,2.82,401000,11000,2.82,401000,401000
زير0103پ01,زيره سبز0103كيميابذر(پ),1,5,6873285,1320900,1374657,1374657,53757,4.07,1374657,53757,4.07,1374657,1374657
ضشنا8011,اختيارخ شپنا-4350-1401/08/29,1,2,3700000,1005,1850,1850,845,84.08,1850,845,84.08,1850,1850
اراد82,مرابحه عام دولت82-ش.خ010912,1,7100,6604065000,930130,930150,930150,20,0,930150,20,0,930150,930150
سمتا022,سلف موازي استاندارد سمتا022,1,100,93131000,930877,931310,931310,433,0.05,931310,433,0.05,931310,931310
صبهمن404,صكوك مرابحه بهمن404-3ماهه 18%,1,10,9802200,970515,980220,980220,9705,1,980220,9705,1,980220,980220
اخزا8172,اسنادخزانه-م17بودجه98-010512,1,8,7664080,960310,958010,958010,-2300,-0.24,958010,-2300,-0.24,958010,958010
سمگا2,گروه سرمايه گذاري ميراث فرهنگي,1,11500000,102465000000,9200,8910,8910,-290,-3.15,8910,-290,-3.15,8910,8910
داريك2,صندوق س.اعتماد داريك-د,1,1000000,1000000,12668,1,1,-12667,-99.99,1,-12667,-99.99,1,1
آوا2,صندوق س.سهام آواي معيار-س,1,700000,700000,8623,1,1,-8622,-99.99,1,-8622,-99.99,1,1
آرام2,صندوق س شاخصي آرام مفيد,1,100000,100000,11060,1,1,-11059,-99.99,1,-11059,-99.99,1,1
تبريز304,مشاركت ش تبريز304-3ماهه18%,1,6000,6000000000,1000000,1000000,1000000,0,0,1000000,0,0,1000000,1000000
پكرمان2,گروه‌ صنعتي‌ بارز,1,2000000,34400000000,17320,17200,17200,-120,-0.69,17200,-120,-0.69,17200,17200
پاداش2,صندوق س. ارزش پاداش-د,1,100000,100000,10191,1,1,-10190,-99.99,1,-10190,-99.99,1,1
اخزا8162,اسنادخزانه-م16بودجه98-010503,1,65,62725000,966440,965000,965000,-1440,-0.15,965000,-1440,-0.15,965000,965000
ثروتم2,صندوق س. ثروت آفرين پارسيان-س,1,400000,400000,97204,1,1,-97203,-100,1,-97203,-100,1,1
غگرجي4,بيسكويت‌  گرجي‌,1,6000000,11226000000,1956,1871,1871,-85,-4.35,1871,-85,-4.35,1871,1871
ضملت8053,اختيارخ وبملت-3476-1401/08/18,1,100,25000000,1,250,250,249,24900,250,249,24900,250,250
نسب0104,آتي نفتاي سبك-1401/04/17,1,100,240000000,2400000,2400000,2400000,0,0,2400000,0,0,2400000,2400000
ضترا3011,اختيارخ شتران-3000-1401/03/08,1,2,4400000,2800,2200,2200,-600,-21.43,2200,-600,-21.43,2200,2200
كاريس4,صندوق س.سپند كاريزما-س,1,4335000,65588550000,15222,15130,15130,-92,-0.6,15130,-92,-0.6,15130,15130
مارون2,پتروشيمي مارون,1,150000,28500000000,190850,190000,190000,-850,-0.45,190000,-850,-0.45,190000,190000
تاراز2,صندوق س آواي تاراز زاگرس-سهام,1,20000,20000,11850,1,1,-11849,-99.99,1,-11849,-99.99,1,1
صنم4,ص.س.صندوق در صندوق صنم,1,9889276,113064092508,11456,11433,11433,-23,-0.2,11433,-23,-0.2,11433,11433
اراد96,مرابحه عام دولت96-ش.خ030414,1,2000,1890000000,960400,945000,945000,-15400,-1.6,945000,-15400,-1.6,945000,945000
اخزا0074,اسنادخزانه-م7بودجه00-030912,1,100000,59450000000,593180,594500,594500,1320,0.22,594500,1320,0.22,594500,594500
ضپنا7051,اختيارخ رمپنا-14000-1401/07/12,1,12,60000000,4450,5000,5000,550,12.36,5000,550,12.36,5000,5000
ضشنا8009,اختيارخ شپنا-3350-1401/08/29,1,10,33000000,3500,3300,3300,-200,-5.71,3300,-200,-5.71,3300,3300
سي تيپ2ن36,گواهي سيمان تيپ2منددشتي(ن),1,25000,143925000,5483,5757,5757,274,5,5757,274,5,5757,5757
ضسان8006,اختيارخ پارسان-34000-01/08/08,1,3,6300000,2800,2100,2100,-700,-25,2100,-700,-25,2100,2100
ضترا8067,اختيارخ شتران-5270-1401/08/08,1,10,10000000,1150,1000,1000,-150,-13.04,1000,-150,-13.04,1000,1000
ضستر3003,اختيارخ خگستر-3000-1401/03/22,1,3,2100000,1122,700,700,-422,-37.61,700,-422,-37.61,700,700
ضملت3009,اختيارخ وبملت-2000-1401/03/18,1,3,5550000,1889,1850,1850,-39,-2.06,1850,-39,-2.06,1850,1850
ضپنا7050,اختيارخ رمپنا-13000-1401/07/12,1,13,78000000,5130,6000,6000,870,16.96,6000,870,16.96,6000,6000
اگ010719,گام بانك صادرات 0107,1,1000,910000000,908000,910000,910000,2000,0.22,910000,2000,0.22,910000,910000
سميعا101,سلف موازي استاندارد سميعا101,1,100,131167400,1311153,1311674,1311674,521,0.04,1311674,521,0.04,1311674,1311674
ضصاد8040,اختيارخ وبصادر-1598-1401/08/11,1,10,8600000,830,860,860,30,3.61,860,30,3.61,860,860
افاد74,منفعت دولت7-ش.خاص ساير0204,1,1000,986000000,971520,986000,986000,14480,1.49,986000,14480,1.49,986000,986000
سميعا102,سلف موازي استاندارد سميعا102,1,100,142463800,1424069,1424638,1424638,569,0.04,1424638,569,0.04,1424638,1424638
خريخت2,صنايع‌ريخته‌گري‌ايران‌,1,50000000,170000000000,3377,3400,3400,23,0.68,3400,23,0.68,3400,3400
افاد744,منفعت دولت7-ش.خاص ساير0204,1,1003000,1003000000000,971520,1000000,1000000,28480,2.93,1000000,28480,2.93,1000000,1000000
صبا14044,اجاصبابدون ضامن بارتبه اعتباري,1,110000,110000000000,1000000,1000000,1000000,0,0,1000000,0,0,1000000,1000000
ساروج2,بين المللي ساروج بوشهر,1,1500000,25395000000,17030,16930,16930,-100,-0.59,16930,-100,-0.59,16930,16930
اراد86,مرابحه عام دولت86-ش.خ020404,1,100,98000000,965000,980000,980000,15000,1.55,980000,15000,1.55,980000,980000
اهرم4,صندوق س سهامي كاريزما- اهرمي,1,13200000,180708000000,14100,13690,13690,-410,-2.91,13690,-410,-2.91,13690,13690
متا0104,آتي متانول -1401/04/17,1,100,94300000,943000,943000,943000,0,0,943000,0,0,943000,943000
افاد61,منفعت دولت6-ش.خاص140109,1,2000,1999980000,975000,999990,999990,24990,2.56,999990,24990,2.56,999990,999990
