نماد,نام,تعداد,حجم,ارزش,دیروز,اولین,آخرین معامله - مقدار,آخرین معامله - تغییر,آخرین معامله - درصد,قیمت پایانی - مقدار,قیمت پایانی - تغییر,قیمت پایانی - درصد,کمترین,بیشترین
فروژ,صنايع فروآلياژ ايران,64788,16332189,814516508900,52100,51800,49950,-2150,-4.13,49850,-2250,-4.32,49500,51800
كرمان,س. توسعه و عمران استان كرمان,24414,1364253478,1717245415932,1200,1250,1284,84,7,1259,59,4.92,1205,1284
دي,بانك دي,24102,1364313436,1187105414436,846,853,888,42,4.96,870,24,2.84,836,888
خودرو,ايران‌ خودرو,20984,809214125,2452911078191,3135,3150,3022,-113,-3.6,3031,-104,-3.32,2979,3190
شستا,سرمايه گذاري تامين اجتماعي,17454,845220747,837237745973,1019,1020,989,-30,-2.94,991,-28,-2.75,977,1020
پالايش,صندوق پالايشي يكم-سهام,16557,21293080,2415708974970,117100,116100,114990,-2110,-1.8,113450,-3650,-3.12,112000,116800
خگستر,گسترش‌سرمايه‌گذاري‌ايران‌خودرو,15968,390399286,1582454461794,4226,4290,4006,-220,-5.21,4053,-173,-4.09,3943,4294
وسديد,گروه ‌صنعتي‌سديد,15047,521764684,1515592516288,2843,2928,2910,67,2.36,2905,62,2.18,2758,2928
اردستان,سيمان اردستان,14759,4218413,51759927510,11690,12270,12270,580,4.96,12270,580,4.96,12270,12270
آواپارس,بيمه اتكايي آواي پارس70% تاديه,14641,67440111,202320333000,1000,3000,3000,2000,200,3000,2000,200,3000,3000
شتران,پالايش نفت تهران,13149,323873262,1318903542373,4218,4188,4066,-152,-3.6,4072,-146,-3.46,4013,4188
خساپا,سايپا,12566,678340822,1625301715168,2514,2420,2395,-119,-4.73,2396,-118,-4.69,2389,2440
شپنا,پالايش نفت اصفهان,11885,181556990,1325401898260,7530,7480,7400,-130,-1.73,7300,-230,-3.05,7110,7500
دارا يكم,صندوق واسطه گري مالي يكم-سهام,10578,10738198,1206583429450,116660,115800,111130,-5530,-4.74,112360,-4300,-3.69,110260,116500
وساخت,سرمايه‌ گذاري‌ ساختمان‌ايران‌,10432,777718519,1514621456814,1831,1900,1959,128,6.99,1948,117,6.39,1854,1959
فاذر,صنايع‌ آذرآب‌,9125,513315721,959475132551,1792,1881,1881,89,4.97,1869,77,4.3,1800,1881
افران,صندوق س افرا نماد پايدار-ثابت,9060,323747801,6146297179045,18970,18985,18985,15,0.08,18985,15,0.08,18984,18986
شبندر,پالايش نفت بندرعباس,8858,91138135,814806323570,9150,9140,8990,-160,-1.75,8940,-210,-2.3,8820,9140
وتجارت,بانك تجارت,8716,377533728,634563905897,1749,1748,1690,-59,-3.37,1681,-68,-3.89,1640,1770
گشان,توسعه بين المللي پديده شانديز,8566,27911406,1298719413200,47550,48000,46200,-1350,-2.84,46550,-1000,-2.1,46150,48700
وبملت,بانك ملت,8204,324819433,1079504115818,3456,3420,3310,-146,-4.22,3323,-133,-3.85,3281,3448
تپكو,توليدتجهيزات‌سنگين‌هپكو,8187,335904933,603431027280,1772,1825,1740,-32,-1.81,1796,24,1.35,1719,1825
فرابورس,فرابورس ايران,7862,59561142,628478786480,11170,11020,10390,-780,-6.98,10550,-620,-5.55,10390,11290
گدنا,تهيه توزيع غذاي دنا آفرين فدك,7713,55826260,628557153230,12000,11750,11160,-840,-7,11260,-740,-6.17,11160,11900
دانا,بيمه دانا,7570,211802765,706787041412,3222,3350,3352,130,4.03,3337,115,3.57,3150,3426
كمند,صندوق س. با درآمد ثابت كمند,7419,413463429,4186269322309,10118,10125,10125,7,0.07,10125,7,0.07,10124,10126
اهرم,صندوق س سهامي كاريزما- اهرمي,7213,105861875,1420274113470,14090,13900,13310,-780,-5.54,13420,-670,-4.76,13150,13900
طلا,صندوق س.پشتوانه طلاي لوتوس,6990,6725488,1013184139911,150829,147000,153678,2849,1.89,150648,-181,-0.12,147000,153679
خاور,ايران خودرو ديزل,6957,290333480,1016516940292,3606,3580,3498,-108,-3,3501,-105,-2.91,3498,3634
فولاد,فولاد مباركه اصفهان,6761,118382059,719736194500,6210,6200,6100,-110,-1.77,6080,-130,-2.09,6030,6200
عيار,صندوق طلاي عيار مفيد,6702,8333670,494523350790,60115,58500,61780,1665,2.77,59340,-775,-1.29,56001,63100
كالا,بورس كالاي ايران,6328,37217566,719522128180,19990,20330,19380,-610,-3.05,19330,-660,-3.3,18810,20330
تسه1401,امتيازتسهيلات مسكن سال1401,6002,224449,276841175482,1227835,1220110,1237008,9173,0.75,1233426,5591,0.46,1220110,1245000
خبهمن,گروه‌بهمن‌,5936,295465878,632044955366,2241,2299,2130,-111,-4.95,2139,-102,-4.55,2095,2299
هماي,صندوق س هماي آگاه-ثابت,5900,154883180,1554532713217,10025,10037,10038,13,0.13,10037,12,0.12,10036,10038
فملي,ملي‌ صنايع‌ مس‌ ايران‌,5588,93175808,708276698380,7780,7720,7610,-170,-2.19,7600,-180,-2.31,7520,7720
ذوب,ذوب آهن اصفهان,5489,164832452,503825797661,3103,3180,3035,-68,-2.19,3057,-46,-1.48,2948,3199
انرژي,بورس انرژي ايران,5352,9780844,376151017040,40790,41200,37940,-2850,-6.99,38460,-2330,-5.71,37940,41200
آپ,آسان پرداخت پرشين,5245,58479557,484689559250,8000,8490,8210,210,2.63,8290,290,3.63,8000,8550
وكبهمن,مديريت سرمايه گذاري كوثربهمن,5121,55288627,193336510772,3494,3494,3600,106,3.03,3497,3,0.09,3251,3650
غنوش,نوش‌ مازندران‌,5065,32560805,305786211510,9700,9950,9430,-270,-2.78,9390,-310,-3.2,9220,9970
بوعلي,پتروشيمي بوعلي سينا,4952,8932941,322768200750,37230,37010,36470,-760,-2.04,36130,-1100,-2.95,35450,37010
سكه0312ن06,ربع سكه 0312رفاه(ن),4762,1739700,1391700226300,818315,1636630,773000,-45315,-5.54,799966,-18349,-2.24,773000,1636630
حكشتي,كشتيراني جمهوري اسلامي ايران,4700,23410023,624719351960,27560,27130,26380,-1180,-4.28,26690,-870,-3.16,26270,27560
هاي وب,داده گسترعصرنوين-هاي وب,4551,89128118,232598195465,2706,2685,2590,-116,-4.29,2610,-96,-3.55,2550,2749
فولاي,صنايع فولاد آلياژي يزد,4535,68993932,426916580090,6393,6650,6078,-315,-4.93,6188,-205,-3.21,5946,6650
كگل,معدني و صنعتي گل گهر,4500,46909376,395559254270,8640,8600,8400,-240,-2.78,8430,-210,-2.43,8110,8670
شپديس,پتروشيمي پرديس,4483,2391326,367318101300,156510,156510,154180,-2330,-1.49,153600,-2910,-1.86,150720,157000
اسياتك,انتقال داده هاي آسياتك,4326,14389292,225260668010,16370,16100,15560,-810,-4.95,15650,-720,-4.4,15560,16300
وخارزم,سرمايه گذاري خوارزمي,4316,75183284,320995824008,4482,4502,4271,-211,-4.71,4270,-212,-4.73,4169,4530
وساپا,سرمايه‌گذاري‌ سايپا,4290,101102090,575812274140,6020,6160,5660,-360,-5.98,5700,-320,-5.32,5600,6170
اعتماد,صندوق س.اعتماد آفرين پارسيان-د,4231,84976429,4356205641401,51225,51263,51264,39,0.08,51264,39,0.08,51263,51265
غزر,صنعتي زر ماكارون,4173,60192398,236262848676,4095,4053,3891,-204,-4.98,3925,-170,-4.15,3891,4090
سمگا,گروه سرمايه گذاري ميراث فرهنگي,4168,46241937,301267364020,6880,6930,6410,-470,-6.83,6520,-360,-5.23,6400,6930
فتوسا,توليد و توسعه سرب روي ايرانيان,4085,33227201,252765730520,8060,8120,7500,-560,-6.95,7610,-450,-5.58,7500,8120
نوري,پتروشيمي نوري,4012,3204286,319616166070,101880,100400,100400,-1480,-1.45,99750,-2130,-2.09,98560,101890
خپويش,سازه‌ پويش‌,3968,21043600,482339863680,23400,24410,22450,-950,-4.06,22920,-480,-2.05,22230,24410
كرازي,كارخانجات‌توليدي‌شيشه‌رازي‌,3953,181323095,296194640060,1606,1669,1619,13,0.81,1634,28,1.74,1570,1710
پترول,گ.س.وت.ص.پتروشيمي خليج فارس,3927,104254827,231868935066,2319,2300,2203,-116,-5,2224,-95,-4.1,2185,2357
ثاميد,توسعه و عمران اميد,3925,31976903,59404248262,1912,1916,1858,-54,-2.82,1858,-54,-2.82,1826,1940
وپاسار,بانك  پاسارگاد,3918,46611118,241935143650,5260,5360,5170,-90,-1.71,5190,-70,-1.33,5080,5370
ولصنم,ليزينگ‌صنعت‌ومعدن‌,3896,115375330,718297595524,5893,6200,6305,412,6.99,6226,333,5.65,5930,6305
كسرا,سراميك‌هاي‌صنعتي‌اردكان‌,3831,43222155,257566115170,5960,5960,6140,180,3.02,5960,0,0,5610,6220
شپلي,پلي اكريل ايران,3821,54441649,632283599320,11620,11960,11580,-40,-0.34,11610,-10,-0.09,11280,11960
غاذر,كشت‌وصنعت‌پياذر,3819,10377203,556346407570,51660,51670,53500,1840,3.56,53610,1950,3.77,51670,54240
خاذين,سايپاآذين‌,3755,131482867,364052960418,2674,2807,2744,70,2.62,2769,95,3.55,2693,2807
فلوله,لوله‌وماشين‌سازي‌ايران‌,3662,108053650,260073212375,2496,2511,2372,-124,-4.97,2407,-89,-3.57,2372,2511
اتكام,بيمه اتكايي امين,3631,67815133,330589348808,4767,4855,5005,238,4.99,4875,108,2.27,4553,5005
بركت,گروه دارويي بركت,3581,14767819,180346085130,12620,12660,12000,-620,-4.91,12210,-410,-3.25,11840,12810
فزر,پويا زركان آق دره,3550,12997121,416715628600,32900,32000,33000,100,0.3,32050,-850,-2.58,31250,33900
ولساپا,ليزينگ رايان‌ سايپا,3508,122854962,191870500149,1650,1670,1540,-110,-6.67,1562,-88,-5.33,1535,1684
سپيد,سپيد ماكيان,3484,8873552,168451654580,20040,20190,18980,-1060,-5.29,18980,-1060,-5.29,18680,20350
ساينا,صنايع بهداشتي ساينا,3455,7523039,256529270500,32100,34300,34300,2200,6.85,34100,2000,6.23,32300,34300
ماديرا,صنايع ماديران,3430,98808194,380906124294,3839,3910,3940,101,2.63,3855,16,0.42,3688,4030
غمينو,شركت صنايع غذايي مينو شرق,3355,72145163,668240061210,8720,9330,9300,580,6.65,9260,540,6.19,8910,9330
بورس,بورس اوراق بهادار تهران,3332,39656616,245744517540,6580,6580,6190,-390,-5.93,6200,-380,-5.78,6120,6620
خنصير,مهندسي‌نصيرماشين‌,3293,20536918,310872971380,15980,16200,14870,-1110,-6.95,15140,-840,-5.26,14870,16450
ديران,ايران‌دارو,3292,20765434,299764761840,14930,14810,14190,-740,-4.96,14440,-490,-3.28,14190,15600
كارا,صندوق س. كارا -د,3289,225342121,2975583500674,13193,13203,13206,13,0.1,13205,12,0.09,13203,13207
كيان,صندوق س. با درآمد ثابت كيان,3243,33633591,1346534412379,40013,40042,40013,0,0,40035,22,0.05,40013,40044
خودكفا,اقتصادي و خودكفايي آزادگان,3193,55728243,460559454680,8150,8390,8300,150,1.84,8260,110,1.35,7970,8390
سصفها,سيمان‌اصفهان‌,3178,5858876,488439780720,79400,83370,83370,3970,5,83370,3970,5,83000,83370
قچار,فراوردههاي غذايي وقند چهارمحال,3178,23226545,262177394900,11310,11550,11230,-80,-0.71,11290,-20,-0.18,10810,11880
غسالم,سالمين‌,3077,45100550,192606471661,4532,4534,4270,-262,-5.78,4271,-261,-5.76,4215,4590
سدبير,س. تدبيرگران فارس وخوزستان,3055,11893969,370179244850,32100,34250,29900,-2200,-6.85,31100,-1000,-3.12,29900,34300
ورنا,سرمايه‌گذاري‌ رنا(هلدينگ‌,3044,49905519,345549389610,7180,7250,6930,-250,-3.48,6920,-260,-3.62,6690,7330
شيراز,پتروشيمي‌شيراز,3024,3538139,295394382860,87790,87790,84000,-3790,-4.32,83490,-4300,-4.9,81970,87790
ثفارس,عمران‌وتوسعه‌فارس‌,3007,46011687,428817407170,9000,9100,9230,230,2.56,9320,320,3.56,9060,9450
شلرد,كود شيميايي اوره لردگان,3005,27176729,239697664250,9030,9120,8900,-130,-1.44,8820,-210,-2.33,8760,9120
شبريز,پالايش نفت تبريز,3002,10103781,160902760050,16660,16500,15750,-910,-5.46,15930,-730,-4.38,15670,16600
ارزش مسكن,ص.س.املاك ومستغلات ارزش مسكن,2974,1534632,17386175757,11450,11490,11325,-125,-1.09,11329,-121,-1.06,11200,11490
خمحركه,نيرو محركه‌,2972,37044214,211304590770,6050,6100,5630,-420,-6.94,5700,-350,-5.79,5630,6270
ثالوند,سرمايه گذاري مسكن الوند,2954,38577800,491737766340,12060,12420,12870,810,6.72,12750,690,5.72,12070,12900
كدما,معدني‌ دماوند,2949,2868226,155815741550,56550,57000,53730,-2820,-4.99,54320,-2230,-3.94,53730,57870
غگل,گلوكوزان‌,2945,34965530,202036147670,6100,6140,5680,-420,-6.89,5780,-320,-5.25,5680,6160
تليسه,دامداري تليسه نمونه,2945,36936689,148796540328,4174,4222,3962,-212,-5.08,4028,-146,-3.5,3900,4250
اخابر,مخابرات ايران,2918,45846508,332427784080,7720,7700,7230,-490,-6.35,7250,-470,-6.09,7180,7730
وسپهر,سرمايه گذاري مالي سپهرصادرات,2901,14523672,119172418290,8580,8500,8170,-410,-4.78,8210,-370,-4.31,8080,8500
توان,صندوق س. اهرمي توان مفيد-س,2875,32511782,384874712738,12180,12200,11832,-348,-2.86,11838,-342,-2.81,11636,12200
ومعادن,توسعه‌معادن‌وفلزات‌,2817,36935814,184130137440,5130,5090,4950,-180,-3.51,4990,-140,-2.73,4920,5140
چدن,توليدي چدن سازان,2756,47173749,110200539788,2481,2500,2308,-173,-6.97,2336,-145,-5.84,2308,2500
وبصادر,بانك صادرات ايران,2748,288200564,528348775341,1926,1840,1830,-96,-4.98,1833,-93,-4.83,1830,1857
حآفرين,ريل پرداز نو آفرين,2738,64448873,286765862244,4438,4590,4350,-88,-1.98,4450,12,0.27,4218,4590
فاسمين,كالسيمين‌,2726,10947520,278180108820,26410,26000,25700,-710,-2.69,25410,-1000,-3.79,25030,26380
مثقال,صندوق س.پشتوانه طلاي زرين آگاه,2684,9987708,183312424508,18453,17800,18940,487,2.64,18354,-99,-0.54,16810,19100
ميدكو,توسعه معادن وص.معدني خاورميانه,2655,16123515,182817276800,11720,11620,11280,-440,-3.75,11340,-380,-3.24,11170,11750
آگاس,صندوق س.هستي بخش آگاه-س,2609,3629183,354316413000,99995,99939,97313,-2682,-2.68,97630,-2365,-2.37,96550,99939
ثشاهد,سرمايه‌ گذاري‌ شاهد,2593,23818901,222863920690,9930,9820,9360,-570,-5.74,9360,-570,-5.74,9240,10010
فنفت,صنايع تجهيزات نفت,2585,9766401,377709786200,37650,38600,38750,1100,2.92,38650,1000,2.66,37550,38750
حفارس,حمل و نقل بين المللي خليج فارس,2572,25850407,370606581130,14960,14630,14220,-740,-4.95,14340,-620,-4.14,14220,15120
فنوال,نورد آلومينيوم‌,2569,51675741,397618563340,7230,7650,7730,500,6.92,7690,460,6.36,7320,7730
غدشت,دشت‌ مرغاب‌,2556,4743066,169565232820,36690,37010,36680,-10,-0.03,35750,-940,-2.56,34860,37990
زبينا,كشاورزي و دامپروري بينالود,2523,57366847,225456989462,4183,4205,3891,-292,-6.98,3930,-253,-6.05,3891,4205
شاروم,پتروشيمي اروميه,2519,4656874,88215543500,20000,20300,18800,-1200,-6,18950,-1050,-5.25,18600,20350
غچين,كشت‌ و صنعت‌ چين‌ چين,2514,43362471,294113000740,6570,6890,6890,320,4.87,6780,210,3.2,6490,6890
غبشهر,صنعتي‌ بهشهر,2485,52898037,144921211501,2904,2910,2726,-178,-6.13,2740,-164,-5.65,2701,2940
سيتا,سرمايه گذاري سيمان تامين,2483,6035807,66150240720,11350,11110,11200,-150,-1.32,10960,-390,-3.44,10790,11230
چكاپا,گروه صنايع كاغذ پارس,2470,37531822,110652373379,3044,3040,2949,-95,-3.12,2948,-96,-3.15,2908,3070
خكار,ايركا پارت صنعت,2437,54707277,182684240822,3504,3650,3259,-245,-6.99,3339,-165,-4.71,3259,3650
سآبيك,سيمان آبيك,2431,5811777,80682690200,14450,14410,13850,-600,-4.15,13880,-570,-3.94,13750,14410
ددانا,داروسازي دانا,2423,3090861,105175114250,35550,35500,34200,-1350,-3.8,34050,-1500,-4.22,33300,35600
تمشك,صندوق س تمشك نماد رشد-در صندوق,2395,13334478,132665317680,10110,10070,9850,-260,-2.57,9950,-160,-1.58,9670,10070
وصنعت,سرمايه گذاري توسعه صنعت وتجارت,2394,22534381,47393469810,2218,2200,2100,-118,-5.32,2103,-115,-5.18,2063,2200
بكاب,صنايع‌جوشكاب‌يزد,2347,4560661,149845323100,33600,35280,32090,-1510,-4.49,32860,-740,-2.2,31920,35280
كتوكا,توليدي و خدمات صنايع نسوز توكا,2347,50845029,640354245460,11810,12630,12630,820,6.94,12590,780,6.6,12080,12630
ختوقا,قطعات‌ اتومبيل‌ ايران‌,2315,35605079,158921140040,4610,4700,4360,-250,-5.42,4460,-150,-3.25,4300,4800
ثبهساز,بهساز كاشانه تهران,2305,24809253,46859357210,1983,1972,1885,-98,-4.94,1889,-94,-4.74,1845,2040
ياقوت,صندوق س ياقوت آگاه-ثابت,2283,27092769,457153615627,16870,16873,16872,2,0.01,16874,4,0.02,16872,16887
لپارس,پارس‌ الكتريك‌,2275,1769612,136359136840,80070,78810,76120,-3950,-4.93,77060,-3010,-3.76,76070,81600
غصينو,صنعتي مينو,2269,15979721,210668725930,13220,13520,13000,-220,-1.66,13180,-40,-0.3,12570,13870
ولبهمن,شركت بهمن ليزينگ,2267,47869678,136422868915,2999,3047,2840,-159,-5.3,2850,-149,-4.97,2800,3047
كمرجان,بازرگاني و توليدي مرجان كار,2244,13030578,105128045010,8620,8450,8020,-600,-6.96,8070,-550,-6.38,8020,8640
كماسه,تامين‌ ماسه‌ ريخته‌گري‌,2208,58741147,286583102776,5174,5140,4875,-299,-5.78,4879,-295,-5.7,4812,5294
ضسپا1211,اختيارخ خساپا-3250-1401/12/10,2201,865983,29223660000,55,42,29,-26,-47.27,34,-21,-38.18,27,43
شسينا,صنايع‌شيميايي‌سينا,2198,56677324,119232450265,2233,2230,2140,-93,-4.16,2104,-129,-5.78,2077,2279
غشهداب,كشت و صنعت شهداب ناب خراسان,2194,38437364,78792230299,2147,2133,2016,-131,-6.1,2050,-97,-4.52,2012,2185
امين,تامين سرمايه امين,2168,860534,7461447220,8570,8600,8690,120,1.4,8580,10,0.12,8600,8750
شلعاب,لعابيران‌,2157,20509367,159918173220,7650,7870,7670,20,0.26,7800,150,1.96,7430,8030
تپسي,پيشگامان فن آوري و دانش آراميس,2146,51687561,277019995510,5120,5290,5370,250,4.88,5360,240,4.69,5170,5370
غديس,پاكديس,2142,17824599,339248894910,20050,20600,19220,-830,-4.14,19030,-1020,-5.09,18650,20880
سكه مركزي,سلف تمام سكه 001 مركزي,2129,456300,949995692900,2116392,2050107,2089502,-26890,-1.27,2081954,-34438,-1.63,2050107,2099000
دسينا,داروسازي‌ سينا,2102,31873569,373905411910,10380,11500,12070,1690,16.28,11730,1350,13.01,11250,12070
غپينو,پارس‌ مينو,2098,36112500,122634166130,3504,3470,3390,-114,-3.25,3396,-108,-3.08,3323,3580
غويتا,ويتانا,2060,31292173,159734170140,5410,5400,5080,-330,-6.1,5100,-310,-5.73,5040,5480
كاذر,فرآورده‌هاي‌نسوزآذر,2059,55646389,300791488450,5210,5440,5460,250,4.8,5410,200,3.84,5050,5470
آباد,توريستي ورفاهي آبادگران ايران,2044,8169611,243714893390,28930,30370,30370,1440,4.98,29830,900,3.11,28970,30370
زقيام,كشت و دام قيام اصفهان,2042,29569391,79772847924,2742,2771,2682,-60,-2.19,2698,-44,-1.6,2620,2848
آريا,پليمر آريا ساسول,2025,1579813,122073971000,77750,77750,77450,-300,-0.39,77250,-500,-0.64,76600,78400
بكام,كارخانجات توليدي شهيد قندي,2016,45183214,113595521311,2412,2450,2501,89,3.69,2514,102,4.23,2394,2580
خمهر,مهركام‌پارس‌,1991,54765946,138979232459,2623,2708,2503,-120,-4.57,2538,-85,-3.24,2492,2708
وآذر,سرمايه‌گذاري‌توسعه‌آذربايجان‌,1982,1988340,250462569900,130620,130000,124090,-6530,-5,125970,-4650,-3.56,124090,131000
سرچشمه,سرمايه گذاري مس سرچشمه,1978,38948967,194993623494,5202,5290,5048,-154,-2.96,5006,-196,-3.77,4942,5290
قجام,فرآوردههاي غذايي وقندتربت‌جام‌,1965,43603228,327527983280,7740,7510,7510,-230,-2.97,7510,-230,-2.97,7510,7710
شفن,پتروشيمي فناوران,1939,15791374,88930469470,5800,5790,5640,-160,-2.76,5630,-170,-2.93,5510,5800
فارس,صنايع پتروشيمي خليج فارس,1929,53336167,498111756340,9390,9390,9420,30,0.32,9340,-50,-0.53,9290,9430
دتوليد,داروسازي توليد دارو,1923,12676972,133367993380,11240,11200,10460,-780,-6.94,10520,-720,-6.41,10460,11270
ثاخت,بين‌المللي‌توسعه‌ساختمان,1911,61584694,186246023696,3084,3077,2950,-134,-4.35,3024,-60,-1.95,2940,3143
ختور,رادياتور ايران‌,1901,22161464,129209931910,6070,6280,5720,-350,-5.77,5830,-240,-3.95,5660,6280
چخزر,صنايع چوب خزر كاسپين,1898,1936115,61940795100,33700,33250,31950,-1750,-5.19,32000,-1700,-5.04,31350,34450
وپويا,سرمايه گذاري پويا,1897,43898613,104701484904,2539,2520,2370,-169,-6.66,2385,-154,-6.07,2362,2539
گوهر,صندوق سكه طلاي كيان,1875,2321054,242765730591,104824,104030,105406,582,0.56,104593,-231,-0.22,102701,105800
قثابت,قند ثابت‌ خراسان‌,1865,60821646,150032718501,2566,2568,2438,-128,-4.99,2467,-99,-3.86,2438,2601
ولغدر,ليزينگ‌خودروغدير,1865,40000362,154677991338,4114,4100,3827,-287,-6.98,3867,-247,-6,3827,4180
زشگزا,شير و گوشت زاگرس شهركرد,1860,24038101,171952487760,7630,7370,7100,-530,-6.95,7150,-480,-6.29,7100,7500
ضخود1205,اختيارخ خودرو-2000-1401/12/03,1852,275176,273655544000,1059,1110,979,-80,-7.55,994,-65,-6.14,950,1120
وپارس,بانك‌پارسيان‌,1839,48457565,88909181422,1904,1891,1829,-75,-3.94,1845,-59,-3.1,1811,1938
صبا,گروه مالي صبا تامين,1838,28632229,106116104327,3795,3860,3701,-94,-2.48,3710,-85,-2.24,3661,3860
نهال,صندوق س. طلاي سرخ نوويرا,1829,8291389,122905499663,15348,15203,14901,-447,-2.91,14823,-525,-3.42,14552,15273
سامان,بانك سامان,1819,100294237,260687708144,2678,2670,2604,-74,-2.76,2599,-79,-2.95,2598,2670
سبزوا,سيمان لار سبزوار,1818,25591793,129074450810,5200,5250,4920,-280,-5.38,5040,-160,-3.08,4860,5400
شپاكسا,پاكسان‌,1806,43673714,99883925435,2328,2372,2270,-58,-2.49,2287,-41,-1.76,2186,2390
وهامون,سرمايه گذاري هامون صبا,1805,31020636,63007960128,2114,2113,2000,-114,-5.39,2031,-83,-3.93,1980,2148
دكوثر,داروسازي‌ كوثر,1797,35844652,225840560080,6660,6540,6330,-330,-4.95,6300,-360,-5.41,6200,6750
وطوبي,سرمايه گذاري اقتصاد شهر طوبي,1768,53527729,111664134276,2060,2110,2057,-3,-0.15,2086,26,1.26,2010,2160
استقلال,استقلال,1767,17279486,36832258704,2121,2163,2091,-30,-1.41,2132,11,0.52,2079,2163
شگويا,پتروشيمي تندگويان,1760,15124656,177683852440,11930,11870,11760,-170,-1.42,11750,-180,-1.51,11550,12000
ثغرب,شركت سرمايه گذاري مسكن شمالغرب,1755,11547659,93649645380,8040,8170,8100,60,0.75,8110,70,0.87,7800,8380
لبوتان,گروه‌صنعتي‌بوتان‌,1752,8826732,116569872050,13060,13710,13110,50,0.38,13210,150,1.15,12500,13710
ثمسكن,سرمايه‌گذاري‌ مسكن‌,1746,31800444,148706563433,4931,5000,4586,-345,-7,4676,-255,-5.17,4586,5025
فگستر,گسترش صنايع روي ايرانيان,1731,12406512,93762630050,7930,7730,7590,-340,-4.29,7560,-370,-4.67,7380,8000
رافزا,رايان هم افزا,1717,1185813,72852261500,65650,63100,61100,-4550,-6.93,61450,-4200,-6.4,61100,65000
حتوكا,حمل‌ونقل‌توكا,1715,21403516,180423959350,8170,8570,8570,400,4.9,8430,260,3.18,8090,8570
سفارس,سيمان فارس و خوزستان,1697,6002076,129702131330,22680,22770,21560,-1120,-4.94,21610,-1070,-4.72,21270,22850
وسينا,بانك سينا,1691,79633458,231943816480,3116,3100,2900,-216,-6.93,2913,-203,-6.51,2898,3172
حسير,ريل سير كوثر,1691,6971872,192248342800,27000,27900,27000,0,0,27550,550,2.04,26100,28400
كوير,توليدي فولاد سپيد فراب كوير,1682,44873650,142689711372,3317,3255,3152,-165,-4.97,3180,-137,-4.13,3152,3330
افرا,افرانت,1646,5460968,127016273700,24650,24450,22950,-1700,-6.9,23250,-1400,-5.68,22950,25200
خرينگ,رينگ‌سازي‌مشهد,1636,4029808,125786701440,30580,31130,31470,890,2.91,31210,630,2.06,29510,32100
زملارد,كشاورزي و دامپروري ملارد شير,1635,2731804,34023373880,12880,12880,12250,-630,-4.89,12450,-430,-3.34,12240,13160
اپال,فرآوري معدني اپال كاني پارس,1625,3532068,57711119580,16890,16890,16270,-620,-3.67,16600,-290,-1.72,16170,16890
وغدير,سرمايه‌گذاري‌غدير(هلدينگ‌,1622,15532564,286382349030,18700,18550,18490,-210,-1.12,18440,-260,-1.39,18360,18890
تملت,تامين سرمايه بانك ملت,1601,12543113,38105852364,3159,3160,3025,-134,-4.24,3038,-121,-3.83,2962,3160
پارس,پتروشيمي پارس,1595,42786607,102072571095,2414,2414,2400,-14,-0.58,2389,-25,-1.04,2356,2434
بزاگرس,نيروگاه زاگرس كوثر,1589,30467846,151169562547,4772,4784,4990,218,4.57,4962,190,3.98,4660,5010
دبالك,مواد اوليه دارويي البرز بالك,1586,13250523,128543229100,9220,9860,9710,490,5.31,9700,480,5.21,9260,9860
بالاس,مهندسي ساختمان تاسيسات راه آهن,1581,3948204,132536557800,33050,34400,32700,-350,-1.06,33550,500,1.51,31400,34700
غكورش,صنعت غذايي كورش,1570,8295289,79454576290,9810,9720,9650,-160,-1.63,9580,-230,-2.34,9400,9810
نوين,بيمه نوين,1568,42083259,76815462515,1848,1882,1820,-28,-1.52,1825,-23,-1.24,1760,1920
سشرق,سيمان‌ شرق‌,1566,8112935,81947228420,10650,10460,10190,-460,-4.32,10100,-550,-5.16,9910,10650
كزغال,زغال سنگ پروده طبس,1561,4361963,86752851050,21000,20850,20100,-900,-4.29,19900,-1100,-5.24,19550,20850
فجهان,مجتمع جهان فولاد سيرجان,1551,12045015,37798613958,3198,3160,3200,2,0.06,3170,-28,-0.88,3060,3201
حبندر,دريايي و کشتيراني خط دريابندر,1541,4783257,72318327930,14710,15100,15150,440,2.99,15120,410,2.79,14730,15150
آكورد,صندوق س. آرمان آتي كوثر-د,1532,8373836,374806995968,44722,44758,44760,38,0.08,44759,37,0.08,44758,44761
لطيف,محصولات كاغذي لطيف,1527,1129657,76000571000,67400,70100,65000,-2400,-3.56,67300,-100,-0.15,63550,71050
شگل,گلتاش‌,1523,31137592,202912556360,6380,6740,6410,30,0.47,6520,140,2.19,6250,6750
ونوين,بانك‌اقتصادنوين‌,1516,36097087,126280668473,3604,3601,3490,-114,-3.16,3498,-106,-2.94,3466,3630
پيزد,مجتمع صنايع لاستيك يزد,1503,9560112,147268398350,16200,16190,15400,-800,-4.94,15400,-800,-4.94,15390,16190
توسن,توسعه سامانه ي نرم افزاري نگين,1494,5196377,79837571890,15710,16080,15320,-390,-2.48,15360,-350,-2.23,15170,16080
كاما,باما,1491,18722831,164812669430,9390,8900,8740,-650,-6.92,8800,-590,-6.28,8740,9000
سحرخيز,صندوق س. گروه زعفران سحرخيز,1471,3449627,71084807831,21683,21302,20942,-741,-3.42,20607,-1076,-4.96,20211,21688
كاوه,فولاد كاوه جنوب كيش,1467,7791636,59231299820,7790,7810,7540,-250,-3.21,7680,-110,-1.41,7520,7820
تاصيكو,سرمايه گذاري صدرتامين,1466,9553218,112144333890,12250,12150,11670,-580,-4.73,11740,-510,-4.16,11640,12250
فنورد,نوردوقطعات‌ فولادي‌,1445,6883044,115881609600,17410,18050,16770,-640,-3.68,16840,-570,-3.27,16540,18050
وبانك,سرمايه گذاري گروه توسعه ملي,1441,15157919,158028759940,10670,10860,10620,-50,-0.47,10430,-240,-2.25,10230,10860
بهپاك,صنعتي بهپاك,1416,42237734,322087936510,7270,7630,7630,360,4.95,7630,360,4.95,7420,7630
خديزل,بهمن  ديزل,1415,19935812,131337373790,6810,6950,6510,-300,-4.41,6590,-220,-3.23,6470,6960
حآسا,آسيا سير ارس,1414,10184053,99561370970,10420,10470,9700,-720,-6.91,9780,-640,-6.14,9700,10470
ولملت,واسپاري ملت,1410,16420615,90533996280,5370,5680,5490,120,2.23,5510,140,2.61,5080,5740
وهور,مديريت انرژي اميد  تابان هور,1405,45376943,67340073198,1468,1502,1532,64,4.36,1484,16,1.09,1421,1539
پتاير,ايران‌ تاير,1404,52148520,73816234355,1466,1483,1409,-57,-3.89,1416,-50,-3.41,1381,1483
ولپارس,ليزينگ پارسيان,1402,5226639,21320549195,4313,4374,4040,-273,-6.33,4079,-234,-5.43,4012,4374
زفكا,كشت و دامداري فكا,1396,19839792,281600461180,13980,14250,14100,120,0.86,14190,210,1.5,13850,14730
ثرود,سرمايه‌گذاري مسكن زاينده رود,1388,8544471,95202851230,10920,11250,11000,80,0.73,11140,220,2.01,10670,11640
كهمدا,شيشه‌ همدان‌,1380,13029469,159926239360,12500,12260,12400,-100,-0.8,12270,-230,-1.84,11690,12660
همراه,شركت ارتباطات سيار ايران,1371,15066596,118047801480,8000,8090,7770,-230,-2.88,7840,-160,-2,7650,8140
پدرخش,درخشان‌ تهران‌,1362,10473617,137097436410,13610,14050,13440,-170,-1.25,13090,-520,-3.82,12930,14050
زر,صندوق س.پشتوانه سكه طلاي زر,1360,983737,90613496896,93184,90289,94900,1716,1.84,92112,-1072,-1.15,88100,95000
غگيلا,شيرپاستوريزه پگاه گيلان,1358,3592884,83190763150,24550,24100,22850,-1700,-6.92,23150,-1400,-5.7,22850,25100
ثنور,سرمايه گذاري كوه نور,1356,8062908,58182861210,7340,7440,7120,-220,-3,7220,-120,-1.63,7120,7490
آريان,سرمايه گذاري پارس آريان,1350,19410349,84549657638,4375,4490,4310,-65,-1.49,4359,-16,-0.37,4281,4490
خاهن,آهنگري‌ تراكتورسازي‌ ايران‌,1347,16557309,76153027834,4880,5221,4539,-341,-6.99,4599,-281,-5.76,4539,5221
خچرخش,چرخشگر,1342,5798520,119165255010,21920,21570,20390,-1530,-6.98,20550,-1370,-6.25,20390,22150
سپيدار,سپيدار سيستم آسيا,1341,838228,20803004900,25650,25200,24950,-700,-2.73,24800,-850,-3.31,23950,25900
سيمرغ,سيمرغ,1339,4308430,106402705050,25780,26000,24800,-980,-3.8,24700,-1080,-4.19,24350,26000
چكارن,كارتن‌ ايران‌,1338,34904611,132263777492,3896,3919,3823,-73,-1.87,3789,-107,-2.75,3702,3931
توريل,توكاريل,1337,19240516,219750218000,10970,11510,11510,540,4.92,11420,450,4.1,10700,11510
زكوثر,سرمايه گذاري كشاورزي كوثر,1333,7424265,113883376670,16400,16320,15260,-1140,-6.95,15340,-1060,-6.46,15260,16320
اتكاسا,بيمه اتكايي سامان,1329,17707682,73801388453,4290,4212,4162,-128,-2.98,4168,-122,-2.84,4162,4307
خصدرا,صنعتي‌ دريايي‌ ايران‌,1310,41137534,91506485916,2261,2298,2194,-67,-2.96,2224,-37,-1.64,2194,2310
فايرا,آلومينيوم‌ايران‌,1299,19920707,131465006990,6460,6490,6550,90,1.39,6600,140,2.17,6490,6780
تاپيكو,س. نفت و گاز و پتروشيمي تأمين,1298,6196262,78048074670,12930,12880,12710,-220,-1.7,12700,-230,-1.78,12480,12900
سكرد,سيمان كردستان,1298,8944279,65212552070,7340,7220,7170,-170,-2.32,7290,-50,-0.68,7050,7590
فلامي,لاميران‌,1295,6096609,155453806010,24540,25760,25760,1220,4.97,25500,960,3.91,24630,25760
شيران,س. صنايع‌شيميايي‌ايران,1290,6662948,71605401330,10970,11000,10770,-200,-1.82,10780,-190,-1.73,10460,11150
امين يكم,صندوق درآمد ثابت امين يكم فردا,1288,28575215,285135955582,9947,9975,9981,34,0.34,9978,31,0.31,9969,9989
دسانكو,داروسازي سبحان انكولوژي,1288,8495466,59432780300,6890,7170,6950,60,0.87,7000,110,1.6,6750,7280
شفارس,صنايع‌ شيميايي‌ فارس‌,1281,38455582,49604436385,1341,1350,1273,-68,-5.07,1290,-51,-3.8,1252,1369
ورازي,بيمه رازي,1279,47373788,67290092696,1455,1489,1414,-41,-2.82,1420,-35,-2.41,1412,1489
شاوان,پالايش نفت لاوان,1277,6963886,140633622150,20800,20950,20150,-650,-3.13,20200,-600,-2.88,20000,20950
فسوژ,سوژميران,1273,5563979,97760612590,18670,18890,17370,-1300,-6.96,17570,-1100,-5.89,17370,19140
كبافق,معادن‌ بافق‌,1273,3872650,112640847780,30400,30440,29030,-1370,-4.51,29090,-1310,-4.31,28880,30440
دامين,داروسازي‌ امين‌,1267,18646136,61300705827,3469,3370,3268,-201,-5.79,3288,-181,-5.22,3227,3486
دفارا,داروسازي‌ فارابي‌,1261,6374492,143636864690,22250,22590,22490,240,1.08,22530,280,1.26,21780,23300
پارسيان,بيمه پارسيان,1256,14528589,53604048123,3737,3831,3698,-39,-1.04,3690,-47,-1.26,3560,3834
كيمياتك,آريان كيميا تك,1252,3535153,45558611530,12540,13160,12750,210,1.67,12890,350,2.79,12430,13160
ومدير,گ.مديريت ارزش سرمايه ص ب كشوري,1243,5220163,21458032432,4248,4180,4105,-143,-3.37,4111,-137,-3.23,4052,4250
بكهنوج,توليد برق ماهتاب كهنوج,1238,36160564,52690380799,1485,1529,1458,-27,-1.82,1457,-28,-1.89,1411,1529
لبخند,صندوق س. لبخند فارابي-د,1237,47600775,520253520331,10919,10930,10929,10,0.09,10930,11,0.1,10929,10930
فخوز,فولاد  خوزستان,1235,30625461,91926712973,3118,3078,2976,-142,-4.55,3019,-99,-3.18,2971,3078
تيپيكو,سرمايه گذاري دارويي تامين,1228,5772205,146962432680,26030,25280,26200,170,0.65,25460,-570,-2.19,24810,26200
ولكار,ليزينگ كارآفرين,1218,2196864,19127392860,8730,8830,8720,-10,-0.11,8710,-20,-0.23,8440,8900
درهآور,دارويي ره آورد تامين,1209,1621108,120996432950,73050,75300,75950,2900,3.97,74650,1600,2.19,71250,77450
خزر,فنرسازي‌زر,1204,13744415,68953495030,5060,5270,4930,-130,-2.57,5020,-40,-0.79,4800,5270
وگردش,بانك گردشگري,1202,13148043,101975658400,7810,7700,7750,-60,-0.77,7760,-50,-0.64,7580,8030
كرماشا,صنايع پتروشيمي كرمانشاه,1190,1720311,109616996380,64830,64890,63520,-1310,-2.02,63720,-1110,-1.71,62700,64890
وهنر,گروه توسعه هنر ايران,1186,23545471,65983799197,2872,2911,2857,-15,-0.52,2802,-70,-2.44,2786,2939
دكيمي,كيميدارو,1183,5517444,187051760640,36300,35200,34490,-1810,-4.99,33900,-2400,-6.61,33760,36100
شسپا,نفت سپاهان,1182,19520336,76671374564,4093,4080,3900,-193,-4.72,3949,-144,-3.52,3889,4090
شراز,پالايش نفت شيراز,1180,4891821,69200723750,14560,14900,14070,-490,-3.37,14150,-410,-2.82,13940,14900
كترام,توليدي‌ كاشي‌ تكسرام‌,1174,42845643,423314952840,9410,9880,9880,470,4.99,9880,470,4.99,9880,9880
حريل,ريل پردازسير,1171,13731632,48767308302,3586,3789,3485,-101,-2.82,3551,-35,-0.98,3370,3789
بنو,بيمه تجارت نو,1156,11901778,46425588560,4076,4076,3873,-203,-4.98,3901,-175,-4.29,3873,4076
فسبزوار,پارس فولاد سبزوار,1153,1502799,35086945820,23990,23630,23290,-700,-2.92,23390,-600,-2.5,23050,24000
سنير,سيمان‌ سفيد ني‌ريز,1151,2245954,78556323620,36570,36850,34750,-1820,-4.98,34980,-1590,-4.35,34750,37100
دالبر,البرزدارو,1150,9225078,74974053840,8240,8790,8470,230,2.79,8130,-110,-1.33,7670,8790
پرسپوليس,پرسپوليس,1143,9922599,25834594299,2558,2609,2609,51,1.99,2604,46,1.8,2566,2609
كهربا,صندوق س.پشتوانه سكه طلا كهربا,1137,12876616,246404360690,18862,18600,19420,558,2.96,19136,274,1.45,18300,19655
زكشت,كشاورزي مكانيزه اصفهان كشت,1130,2113554,59139761950,27200,28400,28250,1050,3.86,28000,800,2.94,26600,29000
بپاس,بيمه پاسارگاد,1124,5959371,112519907700,19200,19050,18650,-550,-2.86,18900,-300,-1.56,18650,19050
خوساز,محورسازان‌ايران‌خودرو,1122,7037406,169147046050,24540,23810,23320,-1220,-4.97,24040,-500,-2.04,23320,25140
غدام,خوراك‌  دام‌ پارس‌,1121,2154171,99181827830,48170,47010,46460,-1710,-3.55,46040,-2130,-4.42,45770,48180
شنفت,نفت‌ پارس‌,1119,5134854,38576880150,7840,7910,7520,-320,-4.08,7590,-250,-3.19,7300,7990
پارتا,مجتمع صنعتي آرتاويل تاير,1118,5471555,46251619670,8440,8350,8480,40,0.47,8450,10,0.12,8020,8800
شغدير,پتروشيمي غدير,1114,1626436,113906158490,70220,70400,70950,730,1.04,70030,-190,-0.27,69210,71050
قاسم,قاسم ايران,1106,15048643,106376316590,7180,7050,7000,-180,-2.51,7070,-110,-1.53,6860,7400
وبهمن,سرمايه‌گذاري‌بهمن‌,1096,20128528,72415465074,3587,3695,3634,47,1.31,3598,11,0.31,3400,3759
سبهان,سيمان‌ بهبهان‌,1095,2455981,139368882210,55130,56660,55810,680,1.23,56750,1620,2.94,55100,57880
تجلي,تجلي توسعه معادن و فلزات,1095,31597359,45601091813,1501,1506,1428,-73,-4.86,1443,-58,-3.86,1426,1520
خموتور,موتورسازان‌تراكتورسازي‌ايران‌,1093,18051783,116800329840,6780,6790,6450,-330,-4.87,6470,-310,-4.57,6450,6930
كي بي سي,شركت كي بي سي,1093,8251923,102786572070,13050,13010,12410,-640,-4.9,12460,-590,-4.52,12400,13110
پارسان,گسترش نفت و گاز پارسيان,1085,3729540,118924395510,32500,32230,31850,-650,-2,31890,-610,-1.88,31500,32230
ثنوسا,نوسازي‌وساختمان‌تهران‌,1077,20702851,98720076760,4869,4980,4746,-123,-2.53,4768,-101,-2.07,4626,5040
بجهرم,توسعه مولد نيروگاهي جهرم,1076,24040711,49689603626,2166,2166,2089,-77,-3.55,2067,-99,-4.57,2058,2166
درازك,دارويي‌ رازك‌,1076,6272434,98009107310,16320,16630,15580,-740,-4.53,15630,-690,-4.23,15510,16630
فباهنر,مس‌ شهيدباهنر,1069,2963011,96157518340,33630,33550,32730,-900,-2.68,32450,-1180,-3.51,32160,33790
اطلس,صندوق س.توسعه اطلس مفيد-س,1051,660879,204327777952,318263,317002,308400,-9863,-3.1,309176,-9087,-2.86,302001,317002
كفپارس,فرآورده‌هاي‌ نسوز پارس‌,1051,18387024,74960185616,4321,4301,4090,-231,-5.35,4077,-244,-5.65,4019,4468
كلر,كلر پارس,1049,592052,51800856400,89750,89800,88150,-1600,-1.78,87500,-2250,-2.51,86050,91050
تاپكيش,تجارت الكترونيك پارسيان كيش,1030,5637561,51564193890,9310,9400,9300,-10,-0.11,9150,-160,-1.72,8700,9690
افق,فروشگاههاي زنجيره اي افق كوروش,1030,4667626,66527758520,14810,14930,14410,-400,-2.7,14290,-520,-3.51,14070,14930
غالبر,لبنيات‌ كالبر,1025,3075859,86927982720,29070,28340,28280,-790,-2.72,28260,-810,-2.79,27740,29900
كطبس,ذغال‌سنگ‌ نگين‌ ط‌بس‌,1025,3616824,57475973540,16840,16880,16200,-640,-3.8,15890,-950,-5.64,15670,17090
كپشير,پشم‌شيشه‌ايران‌,1017,8087479,62844863530,8090,7870,7890,-200,-2.47,7770,-320,-3.96,7690,8000
فسازان,غلتك سازان سپاهان,998,23604140,101068684962,4454,4549,4232,-222,-4.98,4282,-172,-3.86,4232,4549
خفنر,فنرسازي‌خاور,993,3872965,42443971510,11530,11800,10790,-740,-6.42,10960,-570,-4.94,10730,11800
ستران,سيمان‌ تهران‌,992,2575960,95496093830,37470,38150,37560,90,0.24,37070,-400,-1.07,36290,38150
كمنگنز,معادن‌منگنزايران‌,991,6368091,73357275840,11620,11400,11670,50,0.43,11520,-100,-0.86,11300,11890
وگستر,گسترش سرمايه گذاري ايرانيان,986,10856571,55696857920,5320,5530,4990,-330,-6.2,5130,-190,-3.57,4950,5530
هرمز,فولاد هرمزگان جنوب,985,5603201,75899670200,13360,13800,13710,350,2.62,13480,120,0.9,13150,13810
خشرق,الكتريك‌ خودرو شرق‌,980,3680390,61188631380,17120,17650,16400,-720,-4.21,16630,-490,-2.86,16270,17650
وفتخار,سرمايه گذاري افتخار سهام,975,15819407,57631170155,3571,3620,3678,107,3,3643,72,2.02,3576,3678
آوند,صندوق س. آوند مفيد-د,974,41489919,459037841676,11056,11063,11064,8,0.07,11064,8,0.07,11063,11074
كارين,صندوق س نگين سامان-ثابت,973,37387571,375092666245,10024,10032,10032,8,0.08,10033,9,0.09,10031,10033
سدور,سيمان‌ دورود,970,6441614,54791537820,8860,8960,8420,-440,-4.97,8510,-350,-3.95,8420,9100
فجر,فولاد اميركبيركاشان,967,6243222,101779946960,16790,16800,16160,-630,-3.75,16300,-490,-2.92,15710,17060
كروي,توسعه‌ معادن‌ روي‌ ايران‌,965,2546677,70059984180,28910,28090,27530,-1380,-4.77,27510,-1400,-4.84,26890,28820
پارند,صندوق س. پارند پايدار سپهر,962,55726728,563667255549,10109,10114,10115,6,0.06,10115,6,0.06,10114,10116
بگيلان,توسعه مسير برق گيلان,959,1576378,23584053890,15590,14970,14820,-770,-4.94,15010,-580,-3.72,14820,15340
دلر,داروسازي‌ اكسير,953,3133786,78432294020,24530,25730,24930,400,1.63,25030,500,2.04,24070,25740
اتكاي,بيمه اتكايي ايرانيان,944,14274963,96043330450,6440,6650,6760,320,4.97,6730,290,4.5,6470,6760
البرز,بيمه البرز,944,22653908,44880280940,2044,2040,1980,-64,-3.13,1981,-63,-3.08,1956,2040
اپرداز,آتيه داده پرداز,943,13135435,67388858830,5150,5220,5020,-130,-2.52,5130,-20,-0.39,4920,5300
زگلدشت,كشت و دام گلدشت نمونه اصفهان,941,6802608,129690228020,19030,19270,19380,350,1.84,19060,30,0.16,18300,19570
سدشت,صنايع سيمان دشتستان,935,2280818,77397432520,34010,32690,35000,990,2.91,33930,-80,-0.24,32310,35680
وسين,بيمه سينا,934,26960868,60161568276,2199,2263,2229,30,1.36,2231,32,1.46,2151,2264
زماهان,مجتمع توليد گوشت مرغ ماهان,928,6931969,52808247460,8120,8130,7560,-560,-6.9,7620,-500,-6.16,7560,8140
ساربيل,سيمان آرتا اردبيل,928,3095131,134816842410,45380,43520,43120,-2260,-4.98,43560,-1820,-4.01,43120,47000
رانفور,خدمات‌انفورماتيك‌,927,7169731,31207527624,4478,4341,4409,-69,-1.54,4416,-62,-1.38,4251,4481
ثپرديس,سرمايه گذاري مسكن پرديس,917,13480996,78929437530,5880,5930,5790,-90,-1.53,5850,-30,-0.51,5560,6100
شاراك,پتروشيمي شازند,917,2270808,69974566210,31630,31600,30740,-890,-2.81,31000,-630,-1.99,30420,31800
آينده,بازرگاني آينده سازان بهشت پارس,916,8884223,73518133600,8510,8350,8260,-250,-2.94,8280,-230,-2.7,8260,8480
وسكاب,س.ص.بازنشستگي كاركنان بانكها,912,9878755,30158840201,3105,3053,3062,-43,-1.38,3053,-52,-1.67,3010,3105
تكمبا,كمباين‌ سازي‌ ايران‌,912,11473047,66544575380,6170,6140,5740,-430,-6.97,5800,-370,-6,5740,6350
كچاد,معدني‌وصنعتي‌چادرملو,911,5948709,69400630740,11830,11880,11620,-210,-1.78,11730,-100,-0.85,11560,11950
بفجر,فجر انرژي خليج فارس,906,2671207,54362490920,21010,21330,20170,-840,-4,20630,-380,-1.81,20080,21330
گكوثر,هتل پارسيان كوثر اصفهان,901,21244265,48416682558,2387,2330,2268,-119,-4.99,2279,-108,-4.52,2268,2383
واحيا,م .صنايع و معادن احياء سپاهان,897,10911541,162756915100,15360,14900,14900,-460,-2.99,14920,-440,-2.86,14900,15200
وصنا,گروه‌صنايع‌بهشهرايران‌,895,19973110,52097718658,2769,2712,2640,-129,-4.66,2608,-161,-5.81,2576,2776
شتوكا,توكا رنگ فولاد سپاهان,894,3084486,48176650520,16340,16210,15440,-900,-5.51,15620,-720,-4.41,15200,16680
زنگان,صنعت روي زنگان,894,665540,43099187900,65400,68100,64150,-1250,-1.91,64750,-650,-0.99,61800,68100
غپاك,لبنيات‌ پاك‌,891,8877771,113892710660,13290,13280,12820,-470,-3.54,12830,-460,-3.46,12630,13280
سمايه,بانك سرمايه,890,7861631,43587070730,5510,5660,5510,0,0,5540,30,0.54,5380,5670
وآوا,سرمايه گذاري آوا نوين,888,12830997,37665030246,3025,3137,2887,-138,-4.56,2935,-90,-2.98,2834,3137
وبوعلي,سرمايه‌گذاري‌بوعلي‌,881,17618736,44550292650,2673,2666,2525,-148,-5.54,2529,-144,-5.39,2486,2685
ثباغ,شهر سازي و خانه سازي باغميشه,880,5620147,57832383120,10170,10590,10600,430,4.23,10290,120,1.18,9640,10810
زيتون,صندوق س زيتون نماد پايا- مختلط,875,29859939,424898191090,14320,14320,14220,-100,-0.7,14230,-90,-0.63,14100,14330
سخاش,سيمان‌خاش‌,868,1832803,131847305640,75620,76090,71860,-3760,-4.97,71940,-3680,-4.87,71840,76090
شرنگي,شيميايي رنگين,867,1546846,65779545500,41700,41050,42950,1250,3,42500,800,1.92,40550,42950
شوينده,مديريت صنعت شوينده ت.ص.بهشهر,862,4613769,88196801410,20430,20590,19030,-1400,-6.85,19120,-1310,-6.41,19000,20590
زدشت,كشت و صنعت دشت خرم دره,862,4045494,113947436800,30050,28500,28200,-1850,-6.16,28150,-1900,-6.32,27950,30350
ثعمرا,عمران و توسعه شاهد,860,27222406,305929716290,10600,10650,11340,740,6.98,11240,640,6.04,10630,11340
ضخود1211,اختيارخ خودرو-3250-1401/12/03,859,157651,23998718000,183,220,137,-46,-25.14,152,-31,-16.94,125,220
خمحور,توليدمحورخودرو,857,16208390,69739656799,4452,4580,4230,-222,-4.99,4303,-149,-3.35,4230,4580
جوين,كشت و صنعت جوين,844,12071849,68071160920,5730,5890,5560,-170,-2.97,5640,-90,-1.57,5560,5890
قنيشا,قند  نيشابور,836,22467472,59961922493,2793,2809,2656,-137,-4.91,2669,-124,-4.44,2654,2809
دسبحان,سبحان دارو,836,10463503,75406107170,7480,7470,7300,-180,-2.41,7210,-270,-3.61,7110,7500
زاگرس,پتروشيمي زاگرس,835,686549,89155900600,135550,133250,130300,-5250,-3.87,129850,-5700,-4.21,129100,135950
بموتو,موتوژن‌,835,12623107,37223895071,3007,3050,2930,-77,-2.56,2949,-58,-1.93,2900,3088
مبين,مبين انرژي خليج فارس,831,1164536,36736436450,32180,32200,31670,-510,-1.58,31980,-200,-0.62,31030,32200
حفاري,حفاري شمال,830,13057245,55920225635,4460,4470,4250,-210,-4.71,4283,-177,-3.97,4154,4500
وتوصا,گروه س توسعه صنعتي ايران,827,5259663,41176444280,8210,8260,7770,-440,-5.36,7830,-380,-4.63,7660,8260
آسيا,بيمه آسيا,823,21320736,40322995353,1904,1930,1900,-4,-0.21,1891,-13,-0.68,1864,1934
شبهرن,نفت‌ بهران‌,819,2807346,54653500600,19860,19980,19550,-310,-1.56,19630,-230,-1.16,19240,19980
خريخت,صنايع‌ريخته‌گري‌ايران‌,817,10303010,42967805725,4188,4203,4080,-108,-2.58,4170,-18,-0.43,4020,4300
ساوه,سيمان ساوه,813,1349649,107875785000,83600,84750,80150,-3450,-4.13,79950,-3650,-4.37,79450,84750
دلقما,دارويي‌ لقمان‌,811,21592635,63647315831,3087,3030,2941,-146,-4.73,2948,-139,-4.5,2933,3085
قهكمت,قندهكمتان‌,808,6823770,57593736800,8820,8750,8380,-440,-4.99,8440,-380,-4.31,8380,8930
مفاخر,توسعه فناوري اطلاعات خوارزمي,808,4573117,36945793180,8530,8610,8160,-370,-4.34,8080,-450,-5.28,7940,8610
شصدف,صنعتي دوده فام,808,1004215,32747830150,34100,33750,32350,-1750,-5.13,32600,-1500,-4.4,31800,33850
وخاور,بانك خاورميانه,807,10576836,44134757547,4264,4324,4150,-114,-2.67,4195,-69,-1.62,4135,4324
قشير,قند شيروان قوچان و بجنورد,806,5887279,49226088370,8880,8700,8290,-590,-6.64,8360,-520,-5.86,8260,8980
ولراز,ليزينگ رازي,806,3121365,79774191400,25350,26100,26100,750,2.96,25550,200,0.79,24600,26100
رتاپ,تجارت الكترونيك  پارسيان,795,7022082,20827691121,3063,3010,2980,-83,-2.71,2966,-97,-3.17,2901,3112
نطرين,عطرين نخ قم,793,5526210,40213659700,7280,7470,7060,-220,-3.02,7280,0,0,6800,7630
لكما,كارخانجات‌مخابراتي‌ايران‌,791,31173556,34446480245,1135,1116,1101,-34,-3,1105,-30,-2.64,1101,1127
رمپنا,گروه مپنا (سهامي عام),790,8316760,93305026360,11760,11790,11230,-530,-4.51,11310,-450,-3.83,11010,11790
سرو,صندوق س سروسودمند مدبران-سهام,788,1150893,104028147640,92820,92750,90430,-2390,-2.57,90390,-2430,-2.62,88340,92750
كپارس,كاشي‌ پارس‌,788,6476030,59714274610,9360,9240,9060,-300,-3.21,9220,-140,-1.5,8900,9550
دزهراوي,داروسازي‌زهراوي‌,785,10825057,52654757954,5050,5021,5008,-42,-0.83,4864,-186,-3.68,4798,5130
بپيوند,برق و انرژي پيوندگستر پارس,781,2397934,25347878080,11060,10290,10660,-400,-3.62,10570,-490,-4.43,10290,10940
شفارا,پتروشيمي فارابي,776,18131851,109652221500,5930,6100,6100,170,2.87,6050,120,2.02,5770,6100
فرآور,فرآوري‌موادمعدني‌ايران‌,774,2136642,54750312730,26940,26590,25450,-1490,-5.53,25620,-1320,-4.9,25200,27010
ارفع,شركت آهن و فولاد ارفع,773,2214404,39610440400,18270,17950,17920,-350,-1.92,18090,-180,-0.99,17780,18200
وپست,پست بانك ايران,773,7887003,45499183510,5860,6050,5720,-140,-2.39,5770,-90,-1.54,5700,6050
حتايد,تايدواترخاورميانه,771,6775269,34547705000,5290,5430,5100,-190,-3.59,5100,-190,-3.59,4980,5440
ولشرق,ليزينگ ايران و شرق,769,10785753,37071662418,3418,3480,3360,-58,-1.7,3437,19,0.56,3311,3540
اميد,تامين سرمايه اميد,768,14984769,79187570080,5520,5430,5500,-20,-0.36,5280,-240,-4.35,5250,5570
فزرين,زرين معدن آسيا,764,9749907,62391581310,6850,6900,6380,-470,-6.86,6400,-450,-6.57,6380,6900
سغرب,سيمان‌غرب‌,758,3967535,106061298310,25310,26470,27080,1770,6.99,26730,1420,5.61,25450,27080
وسرمد,بيمه  سرمد,753,25822812,41567392163,1647,1695,1598,-49,-2.98,1610,-37,-2.25,1598,1695
غپآذر,شير پگاه آذربايجان شرقي,752,1100097,45338832900,43850,44550,40800,-3050,-6.96,41200,-2650,-6.04,40800,44550
كامياب,صندوق س. كامياب آشنا-د,749,29292590,409940397049,13976,13994,13995,19,0.14,13995,19,0.14,13994,13995
تصميم,صندوق س با درآمد ثابت تصميم,744,25509389,583934904422,22872,22891,22891,19,0.08,22891,19,0.08,22890,22892
ريشمك,توليد و صادرات ريشمك,741,2577748,60927132650,24250,24250,22600,-1650,-6.8,23650,-600,-2.47,22600,24250
وتوشه,سرمايه‌ گذاري‌ پارس‌ توشه‌,739,7644110,41095884640,5710,5530,5500,-210,-3.68,5380,-330,-5.78,5320,5670
مداران,داده‌پردازي‌ايران‌,736,4961768,35629296960,7060,7060,7150,90,1.27,7180,120,1.7,6910,7330
سپر,صندوق س سپر سرمايه بيدار- ثابت,733,26067305,434085396637,16633,16652,16655,22,0.13,16652,19,0.11,16652,16655
ثبات,صندوق س. ثبات ويستا -د,728,78022753,1045073360350,13386,13395,13397,11,0.08,13394,8,0.06,13394,13397
فروس,فروسيليس‌ ايران‌,724,6155086,38902035320,6600,6490,6300,-300,-4.55,6320,-280,-4.24,6250,6600
پلاسك,پلاسكوكار,724,11074954,44084888793,4136,4190,4000,-136,-3.29,3981,-155,-3.75,3930,4210
لسرما,سرما آفرين‌,718,1699449,43255673210,26170,26530,25150,-1020,-3.9,25450,-720,-2.75,24870,27140
ضدي203,اختيارخ دي-600-14020217,717,90436,31402140000,326,358,364,38,11.66,347,21,6.44,320,373
سيلام,سيمان‌ ايلام‌,717,4004202,49961673880,12100,12210,12300,200,1.65,12480,380,3.14,12010,12700
فسا,پتروشيمي فسا,712,29801697,28264971230,957,985,929,-28,-2.93,948,-9,-0.94,929,985
شپترو,پتروشيمي آبادان,708,18209413,32587773098,1833,1832,1779,-54,-2.95,1790,-43,-2.35,1779,1865
خكرمان,سرمايه گذاري آرمان گستر پاريز,704,19430803,87238836475,4621,4500,4483,-138,-2.99,4490,-131,-2.83,4483,4550
والبر,سرمايه‌ گذاري‌ البرز(هلدينگ‌,702,6813261,41749821300,6320,6290,6070,-250,-3.96,6130,-190,-3.01,6020,6370
ونيكي,سرمايه‌گذاري‌ ملي‌ايران‌,697,5873082,38279896100,6870,6650,6530,-340,-4.95,6720,-150,-2.18,6460,6730
ميهن,بيمه ميهن,696,17178809,105914508050,6420,6220,6100,-320,-4.98,6170,-250,-3.89,6100,6580
ومهان,گروه توسعه مالي مهر آيندگان,690,6060062,32861695240,5550,5430,5400,-150,-2.7,5490,-60,-1.08,5380,5540
وايران,ليزينگ ايرانيان,689,8867323,37496035944,4201,4309,4307,106,2.52,4229,28,0.67,4011,4339
غشصفا,شيرپاستوريزه‌پگاه‌اصفهان‌,684,1510049,32312934040,22180,22990,21400,-780,-3.52,21400,-780,-3.52,20630,22990
تماوند,تامين سرمايه دماوند,682,8323257,49510349970,6220,6200,5910,-310,-4.98,5950,-270,-4.34,5910,6200
ونفت,سرمايه‌گذاري‌ صنعت‌ نفت‌,678,7837424,31531308631,4172,4180,3961,-211,-5.06,4023,-149,-3.57,3946,4260
شكربن,كربن‌ ايران‌,672,20844271,73308317592,3663,3763,3504,-159,-4.34,3517,-146,-3.99,3480,3763
كپشيرح,ح . پشم‌شيشه‌ايران‌,670,8156483,35902657533,4552,4533,4450,-102,-2.24,4402,-150,-3.3,4321,4659
كقزوي,شيشه‌ قزوين‌,669,4160509,76555318520,18930,18480,18460,-470,-2.48,18400,-530,-2.8,18370,18930
زشريف,كشت وصنعت شريف آباد,666,17514297,89730834710,5490,5240,5110,-380,-6.92,5120,-370,-6.74,5110,5270
شكلر,نيروكلر,651,2879666,83219238900,29480,29700,28950,-530,-1.8,28900,-580,-1.97,27800,29850
قشكر,شكرشاهرود,650,10317495,22659505571,2248,2280,2236,-12,-0.53,2196,-52,-2.31,2140,2290
غگلستا,شير پاستوريزه پگاه گلستان,649,3365793,51356863630,16300,16610,15160,-1140,-6.99,15260,-1040,-6.38,15160,16610
بمپنا,توليد برق عسلويه  مپنا,648,12788123,78522837860,6450,6450,6130,-320,-4.96,6140,-310,-4.81,6130,6450
وملل,اعتباري ملل,647,9943390,35293197457,3696,3735,3512,-184,-4.98,3549,-147,-3.98,3512,3735
سقاين,سيمان‌ قائن‌,640,1004196,50508881790,52140,53340,51610,-530,-1.02,50300,-1840,-3.53,49540,53340
ملت,بيمه ملت,638,14402686,22440612479,1611,1640,1580,-31,-1.92,1558,-53,-3.29,1513,1640
قزوين,كارخانجات‌ قند قزوين‌,636,6715597,40559920480,6210,6140,6150,-60,-0.97,6040,-170,-2.74,5900,6290
كساپا,سايپاشيشه‌,634,3505693,84577351410,24400,23240,24900,500,2.05,24130,-270,-1.11,23240,25390
غشاذر,پگاه‌آذربايجان‌غربي‌,632,5851564,37578980310,6810,6630,6430,-380,-5.58,6420,-390,-5.73,6340,6800
وتوسم,سرمايه‌گذاري‌توسعه‌ملي‌,629,3894452,19183757680,5100,5200,4940,-160,-3.14,4930,-170,-3.33,4850,5200
پاكشو,گروه صنعتي پاكشو,626,9105368,55262996460,6360,6250,6050,-310,-4.87,6220,-140,-2.2,6050,6250
غشان,شيرپاستوريزه‌پگاه‌خراسان‌,626,5823343,37919505170,6900,6930,6430,-470,-6.81,6510,-390,-5.65,6420,7000
بترانس,ايران‌ ترانسفو,626,35264002,77862916416,2374,2208,2208,-166,-6.99,2208,-166,-6.99,2208,2208
هم وزن,صندوق س. شاخصي كيان-س,620,20767653,247145919370,12103,12014,11856,-247,-2.04,11901,-202,-1.67,11610,12250
چكاوه,صنايع‌كاغذسازي‌كاوه‌,616,4295824,52925648690,12870,13090,12230,-640,-4.97,12320,-550,-4.27,12230,13200
حپترو,حمل و نقل پتروشيمي( سهامي عام,614,1208627,43134379970,37390,37290,35530,-1860,-4.97,35690,-1700,-4.55,35530,37290
سكارون,سيمان كارون,614,369522,23213690500,62450,64200,61800,-650,-1.04,62800,350,0.56,60600,64300
رنيك,جنرال مكانيك,612,5127450,77741686220,15650,15480,15330,-320,-2.04,15160,-490,-3.13,14870,15550
نيرو,نيرو سرمايه,605,1934715,63836655750,33850,32850,32850,-1000,-2.95,33000,-850,-2.51,32850,34100
تبرك,گروه كارخانجات صنعتي تبرك,599,6279011,63017900820,10020,10170,10160,140,1.4,10040,20,0.2,9680,10200
كيميا,معدني كيمياي زنجان گستران,595,8700785,67645862410,7980,7830,7820,-160,-2.01,7770,-210,-2.63,7590,8100
كسعدي,كاشي‌ سعدي‌,585,4253191,46103673910,11200,11700,10900,-300,-2.68,10840,-360,-3.21,10640,11700
خلنت,لنت‌ ترمزايران‌,585,1255083,39468794840,32900,32760,31260,-1640,-4.98,31450,-1450,-4.41,31260,33330
شمواد,توليد مواداوليه الياف مصنوعي,585,901688,63950124750,72400,74300,70250,-2150,-2.97,70900,-1500,-2.07,70250,74300
تفارس,تامين سرمايه خليج فارس,583,10723627,57444460710,5510,5600,5350,-160,-2.9,5360,-150,-2.72,5350,5600
ختراك,ريخته‌گري‌ تراكتورسازي‌ ايران‌,581,5502083,75864856510,13940,14100,14000,60,0.43,13790,-150,-1.08,13400,14200
فوكا,فولاد كاويان,578,4317746,54812609750,13060,13200,12670,-390,-2.99,12690,-370,-2.83,12670,13200
بساما,بيمه سامان,572,4100783,45811030220,11500,11420,11420,-80,-0.7,11170,-330,-2.87,10930,11560
اوان,مبين وان كيش,572,2037031,30945325310,16160,15450,15100,-1060,-6.56,15190,-970,-6,15030,15890
وثنو,سرمايه گذاري ساختماني نوين,569,14717446,32261712216,2222,2220,2230,8,0.36,2192,-30,-1.35,2156,2280
دتماد,توليدمواداوليه‌داروپخش‌,569,1548499,57279709500,38730,38100,37500,-1230,-3.18,36990,-1740,-4.49,36080,38950
خفناور,مهندسي صنعتي روان فن آور,568,2097232,49782596600,24250,24600,23550,-700,-2.89,23750,-500,-2.06,23550,24600
كلوند,كاشي‌ الوند,566,2551392,84320674450,34440,34590,33390,-1050,-3.05,33050,-1390,-4.04,32720,34590
وپسا,س. پتروشيمي ساختمان  خليج فارس,565,11922248,20955880889,1802,1805,1748,-54,-3,1758,-44,-2.44,1748,1839
داوه,داروسازي آوه سينا,564,4577360,36149192050,8290,8300,7980,-310,-3.74,7900,-390,-4.7,7710,8400
كفرا,فراورده‌ هاي‌ نسوزايران‌,562,3596325,31346819700,8820,9030,8890,70,0.79,8720,-100,-1.13,8420,9100
خراسان,پتروشيمي خراسان,561,341276,39458741310,116230,116000,116250,20,0.02,115940,-290,-0.25,114760,117000
وسپه,سرمايه‌گذاري‌ سپه‌,557,12210364,58588330218,4873,4870,4830,-43,-0.88,4798,-75,-1.54,4710,4945
شدوص,دوده‌ صنعتي‌ پارس‌,555,5859374,71887825610,12870,12610,12240,-630,-4.9,12270,-600,-4.66,12230,12870
وصندوق,سرمايه‌گذاري‌صندوق‌بازنشستگي‌,551,2103444,30650993170,14720,14790,14920,200,1.36,14680,-40,-0.27,14330,14920
ضستا1206,اختيارخ شستا-1100-1401/12/03,549,157927,5151112000,50,47,32,-18,-36,33,-17,-34,25,47
كگاز,شيشه‌ و گاز,547,2206844,32097991730,15030,15070,14280,-750,-4.99,14540,-490,-3.26,14280,15460
وحكمت,بيمه حكمت صبا,542,21498679,39191599561,1800,1800,1854,54,3,1823,23,1.28,1752,1854
ضجار2022,اختيارخ وتجارت-1500-1402/02/20,537,79297,32981250000,472,484,430,-42,-8.9,416,-56,-11.86,393,485
شپارس,بين‌ المللي‌ محصولات‌  پارس‌,532,5936972,37422003980,6550,6660,6230,-320,-4.89,6300,-250,-3.82,6230,6660
آبين,كشت و صنعت آبشيرين,526,11350277,111346217370,9530,9810,9810,280,2.94,9620,90,0.94,9810,9810
فجام,جام‌دارو,525,4241317,23201353280,5550,5500,5500,-50,-0.9,5470,-80,-1.44,5300,5620
وشمال,س. چشم انداز توسعه شمال,521,1332760,28146447750,21250,20850,21650,400,1.88,21100,-150,-0.71,20850,21650
سپاها,سيمان‌سپاهان‌,521,4187577,48995773550,12250,12240,11820,-430,-3.51,11700,-550,-4.49,11400,12240
فولاژ,فولاد آلياژي ايران,518,2875559,31519020070,11110,11500,10980,-130,-1.17,11070,-40,-0.36,10670,11500
سشمال,سيمان‌ شمال‌,512,4375642,56251997550,13690,13890,13070,-620,-4.53,12860,-830,-6.06,12740,13890
شخارك,پتروشيمي‌ خارك‌,511,658643,25561349340,40260,40190,38500,-1760,-4.37,39860,-400,-0.99,38000,40190
كسرام,پارس‌ سرام‌,510,6574236,38777314980,6160,6050,5860,-300,-4.87,5900,-260,-4.22,5860,6300
دتوزيع,توزيع دارو پخش,507,1177656,41646395350,36200,36400,36200,0,0,35350,-850,-2.35,34650,37000
بخاور,بيمه زندگي خاورميانه,505,8354228,21921635618,2645,2740,2619,-26,-0.98,2624,-21,-0.79,2560,2740
وپترو,سرمايه‌گذاري صنايع پتروشيمي‌,504,3323143,53289320190,16630,16220,15800,-830,-4.99,16040,-590,-3.55,15670,16570
پرديس,سرمايه گذاري پرديس,504,11309190,39912103764,3707,3707,3520,-187,-5.04,3529,-178,-4.8,3450,3730
سلار,شركت سيمان لارستان,500,1870552,50540724450,27450,28250,27300,-150,-0.55,27000,-450,-1.64,26650,28250
فردا,صندوق س آواي فرداي زاگرس-ثابت,497,26882642,406185694521,15098,15109,15111,13,0.09,15110,12,0.08,15109,15111
تكشا,گسترش‌صنايع‌وخدمات‌كشاورزي‌,494,1108008,27896044200,26100,26000,25190,-910,-3.49,25180,-920,-3.52,24800,26650
فيروزا,صندوق ارمغان فيروزه آسيا-ثابت,483,12499010,405649725500,32429,32454,32455,26,0.08,32455,26,0.08,32454,32455
ركيش,كارت اعتباري ايران كيش,481,9415951,28031125136,3094,3111,2988,-106,-3.43,2977,-117,-3.78,2940,3111
ولتجار,واسپاري تجار ايرانيان,479,11703713,29625049603,2542,2589,2572,30,1.18,2531,-11,-0.43,2466,2589
ساذري,آذريت‌,478,4217322,33390206850,7700,7630,7930,230,2.99,7920,220,2.86,7520,7930
كحافظ,كاشي‌ وسراميك‌ حافظ‌,478,7207225,44737848360,6440,6430,6150,-290,-4.5,6210,-230,-3.57,6010,6470
پلاست,كارخانجات توليدي پلاستيران,476,4824587,54273007240,11580,11690,11240,-340,-2.94,11250,-330,-2.85,11240,11690
واميد,گروه مديريت سرمايه گذاري اميد,475,13519372,175986981020,13070,12790,12940,-130,-0.99,13020,-50,-0.38,12660,13040
آرام,صندوق س شاخصي آرام مفيد,472,3087859,35161764930,11680,11640,11420,-260,-2.23,11390,-290,-2.48,11290,11650
سفاسي,شركت فارسيت اهواز,464,5245977,20080557566,3899,3851,3800,-99,-2.54,3828,-71,-1.82,3783,4000
كساوه,صنايع‌ كاشي‌ و سراميك‌ سينا,464,1392246,69173585530,52560,50160,50140,-2420,-4.6,49680,-2880,-5.48,49010,52270
ضستا6004,اختيارخ شستا-865-1402/06/08,460,73607,22473875000,338,341,299,-39,-11.54,305,-33,-9.76,289,341
داسوه,داروسازي‌ اسوه‌,460,927159,47025796830,49590,51200,51890,2300,4.64,50720,1130,2.28,48120,52060
جم پيلن,پتروشيمي جم پيلن,459,521855,73225478060,142100,145000,141140,-960,-0.68,140770,-1330,-0.94,139080,145000
غشهد,شهد ايران ‌,457,3274670,21345759590,6750,7030,6510,-240,-3.56,6520,-230,-3.41,6420,7030
غفارس,شير پاستوريزه پگاه فارس,453,4977342,41326544800,8530,8710,8180,-350,-4.1,8300,-230,-2.7,8110,8740
دجابر,داروسازي‌ جابرابن‌حيان‌,452,2461547,31295383370,13150,13440,12390,-760,-5.78,12710,-440,-3.35,12260,13450
پكرمان,گروه‌ صنعتي‌ بارز,447,6179066,117973964260,20020,20020,19020,-1000,-5,19090,-930,-4.65,19020,20660
وآرين,شركت توسعه اقتصادي آرين,441,11328918,15177657674,1377,1350,1336,-41,-2.98,1340,-37,-2.69,1336,1363
زرفام,صندوق س.پشتوانه طلا زرفام آشنا,440,1342931,20634836402,15446,15180,15694,248,1.61,15366,-80,-0.52,14510,15996
خكمك,كمك‌فنرايندامين‌,438,1330064,28126455010,22000,22350,20900,-1100,-5,21150,-850,-3.86,20900,22350
ثجوان,تامين مسكن جوانان,427,7732862,40080587580,5050,5200,5200,150,2.97,5180,130,2.57,4950,5200
چافست,افست‌,426,7223752,40795269150,5920,5940,5630,-290,-4.9,5650,-270,-4.56,5630,5940
زمگسا,كشاورزي‌ ودامپروي‌ مگسال‌,425,1214253,39641053300,34120,34000,32660,-1460,-4.28,32650,-1470,-4.31,32420,34000
اعتلا,شركت سرمايه گذاري اعتلاء البرز,424,14151356,67031283250,4970,4950,4730,-240,-4.83,4740,-230,-4.63,4730,4950
وتعاون,بيمه تعاون,422,11263382,18938561253,1740,1714,1657,-83,-4.77,1681,-59,-3.39,1653,1765
ساروم,سيمان‌اروميه‌,421,1100479,32546945190,30830,30830,29510,-1320,-4.28,29580,-1250,-4.05,29100,31000
طخود1205,اختيارف خودرو-2000-1401/12/03,420,194986,2090810000,10,9,10,0,0,11,1,10,8,13
سخزر,سيمان‌ خزر,413,1239855,37588623030,29780,29900,29890,110,0.37,30320,540,1.81,28720,31000
تپمپي,پمپ‌ سازي‌ ايران‌,412,1871891,42051201930,23020,23700,22760,-260,-1.13,22460,-560,-2.43,21750,23700
كوثر,بيمه كوثر,410,11247944,50613694621,4702,4668,4467,-235,-5,4500,-202,-4.3,4467,4778
وتوكا,سرمايه‌گذاري‌توكافولاد(هلدينگ,410,2994317,26462911530,9030,9160,8820,-210,-2.33,8840,-190,-2.1,8700,9250
جهرم,پتروشيمي جهرم,409,12833396,11315938351,907,907,880,-27,-2.98,882,-25,-2.76,880,907
دعبيد,لابراتوارداروسازي‌  دكترعبيدي‌,409,893925,12017265910,14040,13530,13480,-560,-3.99,13940,-100,-0.71,13350,13890
داراب,پتروشيمي داراب,409,10340947,10111231214,1005,1030,975,-30,-2.99,978,-27,-2.69,975,1030
دكپسول,توليد ژلاتين كپسول ايران,409,625129,40406996800,65250,66850,64350,-900,-1.38,64650,-600,-0.92,63000,67350
وزمين,بانك ايران زمين,405,4542262,34636860260,7490,7630,7630,140,1.87,7630,140,1.87,7500,7630
سرود,سيمان‌شاهرود,404,2311372,64673088220,29400,30000,27740,-1660,-5.65,27980,-1420,-4.83,27670,30000
وسبحان,سرمايه گذاري سبحان,402,9621261,20936503957,2236,2200,2165,-71,-3.18,2176,-60,-2.68,2151,2240
ضسپا1206,اختيارخ خساپا-2200-1401/12/10,401,109492,33382898000,370,342,295,-75,-20.27,305,-65,-17.57,295,342
سخوز,سيمان خوزستان,398,968389,32590890510,34930,33700,33530,-1400,-4.01,33650,-1280,-3.66,33050,34420
ودي,بيمه  دي,396,5342790,26289676774,4981,4930,4980,-1,-0.02,4921,-60,-1.2,4801,5090
قصفها,قنداصفهان‌,396,248483,23107035680,96780,98700,91950,-4830,-4.99,92990,-3790,-3.92,91950,98700
فاهواز,نورد و لوله اهواز,395,18694176,81327484005,4358,4405,4350,-8,-0.18,4350,-8,-0.18,4281,4405
فخاس,فولاد خراسان,394,1813099,19765530350,11330,11300,10870,-460,-4.06,11250,-80,-0.71,10770,11300
سصوفي,سيمان‌ صوفيان‌,392,2339396,55154579310,24730,23830,23600,-1130,-4.57,23580,-1150,-4.65,23000,24940
پرداخت,به پرداخت ملت,389,1123385,13231599160,11820,11800,11480,-340,-2.88,11810,-10,-0.08,11360,12200
چفيبر,فيبر ايران‌,383,2234596,11992831310,5610,5750,5330,-280,-4.99,5410,-200,-3.57,5330,5750
دارو,كارخانجات‌داروپخش‌,380,1668896,34996821300,21410,21470,21000,-410,-1.91,20970,-440,-2.06,20660,21600
واتي,سرمايه‌ گذاري‌ آتيه‌ دماوند,378,2450819,25647525150,10720,10490,10500,-220,-2.05,10460,-260,-2.43,10010,10900
ساراب,سيمان‌ داراب‌,378,715843,18218498930,25610,26040,25550,-60,-0.23,25450,-160,-0.62,24300,26300
پاسا,ايران‌ياساتايرورابر,378,4314658,43791879470,10620,10410,10330,-290,-2.73,10150,-470,-4.43,10090,10790
وسنا,سرمايه گذاري نيروگاهي ايران,377,2471926,22170085610,8730,8990,8990,260,2.98,8970,240,2.75,8730,8990
شليا,شركت مواد ويژه ليا,375,1018954,47567662900,45400,46750,46750,1350,2.97,46700,1300,2.86,44550,46750
سفار,سيمان‌فارس‌,371,438653,39496576400,92940,94450,89810,-3130,-3.37,90040,-2900,-3.12,88300,94450
سامانح,ح. بانك سامان,369,17522574,25879312462,1521,1486,1477,-44,-2.89,1477,-44,-2.89,1476,1510
قمرو,قند مرودشت‌,365,1542833,17362902990,11450,11810,11300,-150,-1.31,11250,-200,-1.75,10710,11810
ضستا1205,اختيارخ شستا-1000-1401/12/03,364,83840,5787318000,88,82,69,-19,-21.59,69,-19,-21.59,60,82
شپاس,نفت پاسارگاد,363,1848620,34375026600,19530,19040,18560,-970,-4.97,18590,-940,-4.81,18560,19270
شكام,صنايع شيميايي كيمياگران امروز,362,5815939,45887758710,8300,7890,7890,-410,-4.94,7890,-410,-4.94,7890,7890
كصدف,كاشي صدف سرام استقلال آباده,361,1754244,46354074100,26600,26950,25850,-750,-2.82,26400,-200,-0.75,25850,27350
كفرآور,فرآورده هاي سيمان شرق,359,2087063,31907519380,15740,15800,15270,-470,-2.99,15290,-450,-2.86,15270,15800
غبهنوش,بهنوش‌ ايران‌,357,344164,20463119570,62040,61960,58940,-3100,-5,59460,-2580,-4.16,58940,61960
واعتبار,سرمايه گذاري اعتبار ايران,357,9948018,26908681493,2869,2800,2720,-149,-5.19,2705,-164,-5.72,2669,2906
دماوند,توليد نيروي برق دماوند,351,1410956,28360215600,21150,20100,20100,-1050,-4.96,20500,-650,-3.07,20100,20100
ضستا1105,اختيارخ شستا-1000-1401/11/05,349,167540,692871000,17,14,1,-16,-94.12,4,-13,-76.47,1,14
ومعلم,بيمه معلم,348,7216574,13240687273,1888,1875,1805,-83,-4.4,1837,-51,-2.7,1796,1933
دشيري,شيرين دارو,348,215603,25085708100,113150,116500,116500,3350,2.96,116350,3200,2.83,113600,116500
زپارس,ملي كشت و صنعت و دامپروري پارس,348,619058,45246619340,71870,73500,73000,1130,1.57,73090,1220,1.7,72000,74000
حبندرح,ح.دريايي وكشتيراني خط دريابندر,347,1297804,14087297230,10560,10750,10870,310,2.94,10850,290,2.75,10410,10870
كنور,توسعه معدني و صنعتي صبانور,346,808701,13702546590,17350,17950,16860,-490,-2.82,17290,-60,-0.35,16720,17950
گوهران,سرمايه گذاري توسعه گوهران اميد,346,2010846,9699210729,4919,4929,4837,-82,-1.67,4856,-63,-1.28,4770,4929
قشرين,قند شيرين خراسان,328,6915356,60055285960,8940,8710,8680,-260,-2.91,8680,-260,-2.91,8680,8890
غگلپا,شير پاستوريزه پگاه گلپايگان,327,416985,25098719500,61950,62000,59600,-2350,-3.79,60200,-1750,-2.82,59000,62100
ضجار2026,اختيارخ وتجارت-1900-1402/02/20,326,64717,10783334000,231,250,165,-66,-28.57,167,-64,-27.71,160,250
كگهر,سنگ آهن گهرزمين,326,324269,14314003000,45050,44300,43800,-1250,-2.77,44950,-100,-0.22,43800,45100
حسينا,توسعه خدمات دريايي وبندري سينا,325,1716341,18070047330,10850,10730,10490,-360,-3.32,10530,-320,-2.95,10250,10860
ارمغان,ص سرمايه گذاري ارمغان ايرانيان,323,30101542,304024793748,10084,10090,10107,23,0.23,10100,16,0.16,10090,10108
غپونه,نوش پونه مشهد,321,1483214,23140536670,16320,15570,15550,-770,-4.72,15600,-720,-4.41,15510,16660
قتربت,قند تربت حيدريه,321,1038837,19557144290,19360,19010,18780,-580,-3,18830,-530,-2.74,18780,19540
فراز,صندوق س.سهام فراز داريك-س,319,8359896,152795951327,18276,18279,18281,5,0.03,18277,1,0.01,18274,18399
قيستو,شركت قند بيستون,317,1476152,36903299150,24350,23800,25000,650,2.67,25000,650,2.67,23700,25050
ثشرق,سرمايه گذاري مسكن شمال شرق,315,4477776,21108535465,4878,4800,4667,-211,-4.33,4714,-164,-3.36,4635,4889
كاج,صندوق س. نوع دوم نو ويرا -د,315,6035147,64021232779,10601,10608,10614,13,0.12,10608,7,0.07,10607,10614
شفا,سرمايه گذاري شفادارو,312,1984339,34076348080,17960,17730,17130,-830,-4.62,17170,-790,-4.4,17070,17730
سفانو,سيمان فارس نو,309,661218,39397570360,62180,62880,60030,-2150,-3.46,59580,-2600,-4.18,57830,62880
وحافظ,بيمه حافظ,308,13609994,48749431423,3478,3582,3582,104,2.99,3582,104,2.99,3540,3582
حرهشا,رهشاد سپاهان (سهامي عام,306,242337,27014706550,108400,111650,111650,3250,3,111500,3100,2.86,108100,111650
آساميد,صندوق س.مشترك آسمان اميد -د,305,10009532,171184049751,17089,17099,17099,10,0.06,17102,13,0.08,17099,17106
كشرق,صنعتي و معدني شمال شرق شاهرود,304,128874,13621420500,110900,105700,105950,-4950,-4.46,106100,-4800,-4.33,103200,109200
گنج,صندوق س. طلا كيميا زرين كاردان,304,1277669,22616147274,17743,17026,17984,241,1.36,17701,-42,-0.24,17026,17999
باران,بيمه زندگي باران,303,4611934,17371199470,3866,3900,3751,-115,-2.97,3767,-99,-2.56,3751,3911
كپرور,فرآوري زغال سنگ پروده طبس,300,2245978,20337905930,9330,9240,9010,-320,-3.43,9060,-270,-2.89,8880,9500
شجم,صنايع پتروشيمي تخت جمشيد,294,1487751,12174769740,8180,8250,8140,-40,-0.49,8180,0,0,8080,8450
سهگمت,سيمان‌هگمتان‌,293,406069,17288651960,42760,43140,42760,0,0,42580,-180,-0.42,41190,43800
بسويچ,پارس‌سويچ‌,290,1420916,6591277000,4660,4830,4620,-40,-0.86,4650,-10,-0.21,4520,4830
بميلا,توسعه سرمايه گذاري ميلاد پارس,289,2469592,23433517640,9520,9510,9400,-120,-1.26,9490,-30,-0.32,9250,9760
حاريا,كشتيراني آريا,288,1779281,10500390850,5840,5920,5920,80,1.37,5900,60,1.03,5810,5950
خعمرا,توسعه و عمران شهرستان نائين,286,1859681,10203284670,5630,5600,5470,-160,-2.84,5490,-140,-2.49,5470,5600
ثتران,سرمايه گذاري مسكن تهران,283,7132240,39648122160,5295,5559,5559,264,4.99,5559,264,4.99,5559,5559
بايكا,كارخانجات كابلسازي ‌ايران‌,282,611281,10209718670,17150,16640,16640,-510,-2.97,16700,-450,-2.62,16640,17400
ضسپا1205,اختيارخ خساپا-2000-1401/12/10,282,41809,18650356000,522,480,437,-85,-16.28,446,-76,-14.56,410,480
غنيلي,مجتمع توليدي نيلي صنعت كرمان,282,6892042,41352252000,5720,6000,6000,280,4.9,6000,280,4.9,6000,6000
سهرمز,سيمان‌هرمزگان‌,281,679437,18967658200,28780,28750,28300,-480,-1.67,27920,-860,-2.99,27510,29480
رفاه,فروشگاه هاي زنجيره اي رفاه,281,235837,78781349850,324350,334050,334050,9700,2.99,334050,9700,2.99,334050,334050
خفولا,خدمات فني فولاد يزد,281,651941,32017778600,50600,49100,49100,-1500,-2.96,49100,-1500,-2.96,49100,49900
وآفر,سرمايه گذاري ارزش آفرينان,279,1276204,32688138850,26300,26900,25550,-750,-2.85,25600,-700,-2.66,25550,26900
خليبل,ماليبل سايپا,276,558390,15216107000,26500,27250,27250,750,2.83,27200,700,2.64,27000,27250
ضشنا1106,اختيارخ شپنا-7000-1401/11/19,274,24270,14064666000,729,750,590,-139,-19.07,580,-149,-20.44,450,750
كخاك,صنايع‌خاك‌چيني‌ايران‌,272,623405,9138056240,15040,15480,14630,-410,-2.73,14870,-170,-1.13,14310,15480
شرانل,نفت ايرانول,269,445678,27296753150,61850,61600,61850,0,0,61500,-350,-0.57,60800,62000
هامرز,صندوق س اعتماد هامرز-ثابت,269,13922413,140973352133,10119,10126,10126,7,0.07,10126,7,0.07,10125,10126
شاملا,معدني‌ املاح‌  ايران‌,266,2368695,26934970120,11760,11650,11350,-410,-3.49,11370,-390,-3.32,11200,11850
فافزا,فولاد افزا سپاهان,266,769462,30738905250,41050,41300,40600,-450,-1.1,39950,-1100,-2.68,39850,41900
ثامان,سامان‌ گستراصفهان‌,265,1257965,19516570170,16150,16010,15370,-780,-4.83,15510,-640,-3.96,15350,16730
حآساح,ح.آسيا سير ارس,265,2013833,12539854670,6440,6270,6290,-150,-2.33,6230,-210,-3.26,6010,6500
نفيس,صندوق س.پشتوانه طلاي صبا,265,954901,11491228372,11871,11980,12176,305,2.57,12034,163,1.37,11702,12370
سفارود,كارخانه فارسيت درود,265,1057688,13417116560,12870,12970,12790,-80,-0.62,12690,-180,-1.4,12620,13110
غشوكو,شوكو پارس,264,5192450,45298369380,8920,8700,8660,-260,-2.91,8720,-200,-2.24,8660,9000
كايتا,ايتالران‌,264,194370,7011890600,35500,36550,36050,550,1.55,35900,400,1.13,35000,36550
تكنار,مجتمع معادن مس تكنار,264,298737,18422341150,63250,63250,61600,-1650,-2.61,61650,-1600,-2.53,61400,63400
سمازن,سيمان‌مازندران‌,262,1043182,16869025380,16800,16240,16250,-550,-3.27,16170,-630,-3.75,15840,16500
دپارس,پارس‌ دارو,262,719772,29533689820,42340,42000,41110,-1230,-2.91,41030,-1310,-3.09,40250,42440
دهدشت,صنايع پتروشيمي دهدشت,262,2355615,28350677400,11800,11900,11740,-60,-0.51,12040,240,2.03,11530,12150
ماني,صندوق س. با درآمد ثابت ماني,256,8925401,119682866786,13401,13409,13410,9,0.07,13409,8,0.06,13409,13410
جم,پتروشيمي جم,255,676257,24969596180,37370,37990,36830,-540,-1.45,37250,-120,-0.32,36780,37990
غبهار,كشت وصنعت بهاران گلبهار خراسان,254,959255,15253797600,16350,16290,15860,-490,-3,15900,-450,-2.75,15860,16290
وبشهر,توسعه‌ صنايع‌ بهشهر(هلدينگ,252,2062617,14639891000,7210,7100,7000,-210,-2.91,7170,-40,-0.55,6910,7220
سباقر,سيمان باقران,252,1496441,21933707600,15000,14610,14550,-450,-3,14660,-340,-2.27,14550,15300
دسبحا,گروه دارويي سبحان,251,1730362,18241319230,10650,10400,10740,90,0.85,10580,-70,-0.66,10200,10900
كورز,ورزيران‌,251,43308,23921876750,536350,552400,552400,16050,2.99,552350,16000,2.98,539500,552400
كاريس,صندوق س.سپند كاريزما-س,249,2776559,46885852031,17348,17270,16860,-488,-2.81,16886,-462,-2.66,16620,17337
فروسيل,فروسيليسيم خمين,241,597901,10727554820,18270,18380,17810,-460,-2.52,17940,-330,-1.81,17810,18380
آوند2,صندوق س. آوند مفيد-د,241,24000000,24000000,11056,1,1,-11055,-99.99,1,-11055,-99.99,1,1
ويسا,سرمايه گذاري ايساتيس پويا,238,2243220,13362276180,6110,6230,5930,-180,-2.95,5960,-150,-2.45,5930,6230
سغدير,توسعه سرمايه و صنعت غدير,236,1294694,8691075370,7000,7090,6790,-210,-3,6860,-140,-2,6650,7090
ما,بيمه  ما,234,1428551,4462864906,3234,3200,3140,-94,-2.91,3199,-35,-1.08,3060,3203
دروز,داروسازي‌ روزدارو,232,1213143,25959774630,22440,22160,21320,-1120,-4.99,21400,-1040,-4.63,21320,22160
گپارس,امور رفاهي كارگزاران پارس,228,88792,12564870150,142100,146350,137850,-4250,-2.99,141500,-600,-0.42,137850,146350
هجرت,پخش هجرت,227,1284609,39185638800,30800,30400,29950,-850,-2.76,30500,-300,-0.97,29750,31400
ارزش,صندوق س ارزش آفرين بيدار-سهام,227,1748926,23844106450,13840,13880,13530,-310,-2.24,13630,-210,-1.52,13010,13950
دسانكوح,ح . داروسازي سبحان انكولوژي,224,2153099,10544247265,4876,4724,4840,-36,-0.74,4897,21,0.43,4724,5050
كيان2,صندوق س. با درآمد ثابت كيان,223,22300000,22300000,40013,1,1,-40012,-100,1,-40012,-100,1,1
بالبر,كابل‌ البرز,223,242104,13928243120,60550,57530,57530,-3020,-4.99,57530,-3020,-4.99,57530,57530
فافق,صنايع مس افق كرمان,221,3207869,15529138740,4960,4830,4860,-100,-2.02,4840,-120,-2.42,4820,4990
وكادو,تكادو,220,1582018,28893102130,18740,19000,18190,-550,-2.93,18260,-480,-2.56,18180,19130
قپيرا,فرآورده‌هاي‌غدايي‌وقندپيرانشهر,219,773825,6530247150,8810,8890,8580,-230,-2.61,8630,-180,-2.04,8220,8930
فكمند,گسترش قطعه سازي كمند,219,1280319,59817597700,45400,46750,46750,1350,2.97,46500,1100,2.42,45600,46750
ثاصفا,شركت‌ ساختمان‌ اصفهان‌,217,692829,11224816520,16060,16540,16540,480,2.99,16200,140,0.87,15580,16540
خاتم,صندوق س خاتم ايساتيس پويا-ثابت,216,7113552,109788222309,15420,15433,15433,13,0.08,15434,14,0.09,15432,15434
واحصا,احياء صنايع خراسان,213,234062,14582062600,64200,62300,62300,-1900,-2.96,62300,-1900,-2.96,62300,62300
ساروج,بين المللي ساروج بوشهر,208,2840342,75170953600,26350,26950,26300,-50,-0.19,26450,100,0.38,26000,27500
ضخود1208,اختيارخ خودرو-2600-1401/12/03,207,36765,18943627000,549,522,495,-54,-9.84,515,-34,-6.19,440,556
وپخش,داروپخش‌ (هلدينگ‌,204,312937,12409391440,40260,39870,39490,-770,-1.91,40130,-130,-0.32,39100,40000
قشهد,شهد,203,435968,6708980780,16110,16090,15470,-640,-3.97,15770,-340,-2.11,15310,16100
تسه1400,امتيازتسهيلات مسكن سال1400,203,2596,3214967221,1226989,1170000,1260000,33011,2.69,1238431,11442,0.93,1165640,1288338
درازي,پخش رازي,201,899057,20517178050,23900,23850,22550,-1350,-5.65,22800,-1100,-4.6,22350,24450
خكاوه,سايپا ديزل,201,1353235,25738529700,19600,19020,19020,-580,-2.96,19570,-30,-0.15,19020,19020
دابور,داروسازي‌ ابوريحان‌,199,562382,10232357980,18990,18940,18400,-590,-3.11,18370,-620,-3.26,18050,18940
ضخود3072,اختيارخ خودرو-3500-1402/03/03,199,32613,10035086000,393,349,318,-75,-19.08,308,-85,-21.63,280,403
حخزر,كشتيراني درياي خزر,196,1909262,55285330900,30300,29250,28800,-1500,-4.95,28950,-1350,-4.46,28800,30150
ضخاو1207,اختيارخ وخاور-5000-1401/12/01,196,38308,2063817000,73,95,58,-15,-20.55,54,-19,-26.03,36,95
تشتاد,صنايع توليدي اشتاد ايران‌,195,2245011,13249093540,6080,5930,5900,-180,-2.96,5900,-180,-2.96,5900,6000
پسهند,صنايع‌ لاستيكي‌  سهند,195,229682,8834991290,39790,40330,38660,-1130,-2.84,39010,-780,-1.96,38120,40330
بنيرو,نيروترانس‌,195,2175117,6333416816,3057,2951,2870,-187,-6.12,2989,-68,-2.22,2856,2981
سبجنو,سيمان‌ بجنورد,195,242725,10026601150,41950,43100,41980,30,0.07,41520,-430,-1.03,40730,43100
تسه0011,امتيازتسهيلات مسكن بهمن 1400,192,2374,2911053982,1222899,1180003,1249999,27100,2.22,1226223,3324,0.27,1180003,1250000
لوتوس,تامين سرمايه لوتوس پارسيان,191,1198487,5917641482,4990,4953,4934,-56,-1.12,4983,-7,-0.14,4921,5000
فبيرا,بسته‌ بندي‌ ايران‌,189,2639899,5404994784,2058,2098,2005,-53,-2.58,2052,-6,-0.29,1997,2119
كاسپين,داروسازي كاسپين تامين,189,573918,8645692120,15610,15980,15120,-490,-3.14,15060,-550,-3.52,14830,15980
شتولي,تولي‌پرس‌,188,370982,6275611070,16590,16920,16920,330,1.99,16920,330,1.99,16320,16920
ضسپا1207,اختيارخ خساپا-2400-1401/12/10,185,39299,7981116000,241,202,186,-55,-22.82,203,-38,-15.77,180,225
مدير,ص.س.مديريت ثروت ص.بازنشستگي-س,184,1395925,16619867022,12010,12011,11800,-210,-1.75,11906,-104,-0.87,11756,12011
اوصتا,صندوق انديشه ورزان صباتامين -د,180,71351834,1869848630411,26188,26205,26207,19,0.07,26206,18,0.07,26205,26209
ثتوسا,س.توسعه و عمران استان اردبيل,172,376085,6836457870,18720,18720,18160,-560,-2.99,18300,-420,-2.24,18160,18720
تسه9911,امتياز تسهيلات مسكن بهمن99,172,2946,3603416179,1224932,1200000,1221022,-3910,-0.32,1223155,-1777,-0.15,1200000,1239799
آساس,صندوق س.آسمان آرماني سهام-س,171,120336,30142967085,253379,253000,250320,-3059,-1.21,250490,-2889,-1.14,247859,256000
سپيدما,صندوق س. سپيد دماوند-د,171,42920371,618771172323,14404,14416,14417,13,0.09,14417,13,0.09,14416,14417
ثعتما,س. ساختماني اعتماد گستر,166,474490,6622881070,14270,14560,13850,-420,-2.94,14060,-210,-1.47,13850,14600
تابا,تابان نيرو سپاهان,165,412123,10094900250,25200,24900,24450,-750,-2.98,24500,-700,-2.78,24450,24900
وارس,سرمايه گذاري ارس صبا,165,2121419,36420743340,17680,17480,17150,-530,-3,17170,-510,-2.88,17150,17480
ضخود1210,اختيارخ خودرو-3000-1401/12/03,164,12342,3241759000,297,281,210,-87,-29.29,263,-34,-11.45,200,352
وشهر,بانك شهر,161,4978614,32659707840,6370,6560,6560,190,2.98,6520,150,2.35,6560,6560
ضخود1206,اختيارخ خودرو-2200-1401/12/03,161,33553,27568130000,933,950,835,-98,-10.5,822,-111,-11.9,790,950
سجام,مجتمع سيمان غرب آسيا,160,3807750,8504981161,2287,2231,2229,-58,-2.54,2240,-47,-2.06,2219,2327
كازرو,پتروشيمي كازرون,160,1591090,19697265210,12530,12540,12410,-120,-0.96,12380,-150,-1.2,12170,12710
حپارسا,توسعه حمل و نقل ريلي پارسيان,153,303630,14754991300,50400,50100,48100,-2300,-4.56,48600,-1800,-3.57,47800,50100
ضجار2020,اختيارخ وتجارت-1300-1402/02/20,152,18565,10666416000,623,620,600,-23,-3.69,575,-48,-7.7,542,774
سپ,پرداخت الكترونيك سامان كيش,148,139622,2296209050,16920,16790,16410,-510,-3.01,16910,-10,-0.06,16300,16790
ضهرم1205,اختيارخ اهرم-11000-1401/12/22,146,3017,8405227000,3450,3110,2900,-550,-15.94,2786,-664,-19.25,2600,3111
ضخود1212,اختيارخ خودرو-3500-1401/12/03,146,25860,2048114000,107,130,70,-37,-34.58,79,-28,-26.17,70,130
پاداش,صندوق س. ارزش پاداش-د,142,6667547,68551233604,10269,10281,10282,13,0.13,10281,12,0.12,10281,10282
تسه9912,امتياز تسهيلات مسكن اسفند99,141,1464,1816737996,1248717,1200177,1245002,-3715,-0.3,1240941,-7776,-0.62,1200177,1259980
ضسپا1204,اختيارخ خساپا-1900-1401/12/10,141,39944,20564324000,627,510,510,-117,-18.66,515,-112,-17.86,500,553
دريا,صندوق س درياي آبي فيروزه-سهام,140,5097090,56844715390,11430,11590,11100,-330,-2.89,11150,-280,-2.45,10900,11590
الماس,صندوق س.امين تدبيرگران فردا-س,139,212233,30192560570,138366,138000,142980,4614,3.33,142261,3895,2.81,134000,149500
تسه0009,امتيازتسهيلات مسكن آذر 1400,139,2477,3023982263,1221474,1160404,1239990,18516,1.52,1220824,-650,-0.05,1160404,1240000
وجامي,سرمايه گذاري جامي,136,4440842,18416171774,4027,4147,4147,120,2.98,4147,120,2.98,4147,4147
وفتخارح,ح . سرمايه گذاري افتخار سهام,136,7008439,12594027739,1748,1742,1800,52,2.97,1797,49,2.8,1741,1800
ضستا0104,اختيارخ شستا-1000-1402/01/09,136,63717,6070039000,119,120,94,-25,-21.01,95,-24,-20.17,90,120
غمهرا,توليدي‌مهرام‌,133,1608282,14538869280,8610,9040,9040,430,4.99,8970,360,4.18,9040,9040
آوا,صندوق س.سهام آواي معيار-س,133,740241,6851775227,9700,9887,9350,-350,-3.61,9256,-444,-4.58,9010,9887
ضستا1203,اختيارخ شستا-800-1401/12/03,133,23451,4699939000,226,212,200,-26,-11.5,200,-26,-11.5,180,220
ممسني,پتروشيمي ممسني,132,947350,12093461570,12490,12860,12770,280,2.24,12770,280,2.24,12550,12860
ضستا0106,اختيارخ شستا-1200-1402/01/09,131,41922,2487234000,72,58,60,-12,-16.67,59,-13,-18.06,50,68
فماك,ماداكتو استيل كرد,131,1535720,26214963300,16280,17090,17090,810,4.98,17070,790,4.85,16700,17090
ضدي202,اختيارخ دي-550-14020217,130,7423,2750169000,358,417,398,40,11.17,370,12,3.35,301,400
سيستم,همكاران سيستم,128,909224,6908245120,7620,7790,7500,-120,-1.57,7610,-10,-0.13,7420,7790
سلام,صندوق س سلام فارابي-سهام,128,1309050,14116741090,11090,11080,10830,-260,-2.34,10780,-310,-2.8,10700,11150
گوهرانح,ح . س. توسعه گوهران اميد,127,2655478,6856607234,2647,2728,2570,-77,-2.91,2582,-65,-2.46,2515,2744
فمراد,آلومراد,127,333470,6836135000,19530,20500,20500,970,4.97,19950,420,2.15,20500,20500
كاردان,صندوق س تجارت شاخصي كاردان,125,81447,20118645100,249740,250200,246210,-3530,-1.41,247020,-2720,-1.09,244590,250790
تسه0010,امتيازتسهيلات مسكن دي1400,124,1422,1744381798,1216092,1155301,1231000,14908,1.23,1226710,10618,0.87,1155301,1260000
كمينا,شيشه سازي مينا,123,624382,5713095300,9430,9150,9150,-280,-2.97,9250,-180,-1.91,9150,9150
سمتاز,سيمان ممتازان كرمان,123,1086504,39879683600,37800,36700,36700,-1100,-2.91,36700,-1100,-2.91,36700,37000
انار,صندوق س.انارنماد ارزش-درسهام,122,461651,6118579690,13520,13500,13090,-430,-3.18,13250,-270,-2,12190,13550
لبخند2,صندوق س. لبخند فارابي-د,120,12000000,12000000,10919,1,1,-10918,-99.99,1,-10918,-99.99,1,1
وآفري,بيمه كارآفرين,120,2202173,5918690428,2767,2685,2684,-83,-3,2731,-36,-1.3,2684,2702
زعف0210پ11,زعفران0210نگين سحرخيز(پ),119,71920,23253083640,328066,328000,328000,-66,-0.02,323319,-4747,-1.45,318000,332996
فجوش,جوش‌ و اكسيژن‌ ايران‌,119,873019,2015800871,2380,2309,2309,-71,-2.98,2377,-3,-0.13,2309,2309
زعف0210پ05,زعفران0210نگين زرين(پ),118,44032,13953991633,322491,316000,319900,-2591,-0.8,316906,-5585,-1.73,313121,320000
شكبير,پتروشيمي اميركبير,118,299058,23897639950,82350,79950,79900,-2450,-2.98,81750,-600,-0.73,79900,80850
ضملت3020,اختيارخ وبملت-2227-1402/03/28,118,13056,13269082000,1132,1088,955,-177,-15.64,1016,-116,-10.25,800,1125
شساخت,مهندسي و ساختمان صنايع نفت,116,205610,7654684500,38100,37350,37100,-1000,-2.62,37900,-200,-0.52,37050,38000
دشيمي,شيمي‌ داروئي‌ داروپخش‌,115,1312582,30018750340,24070,22870,22870,-1200,-4.99,22870,-1200,-4.99,22870,22870
نخل,صندوق س.خليج فارس-د,115,8188024,82155879995,10025,10034,10035,10,0.1,10034,9,0.09,10033,10035
ضستا1204,اختيارخ شستا-900-1401/12/03,114,28643,3369276000,142,169,111,-31,-21.83,118,-24,-16.9,108,169
مارون,پتروشيمي مارون,113,23039,4239850950,181500,188000,183000,1500,0.83,181600,100,0.06,182450,188000
وثوق,سرمايه گذاري وثوق امين,112,2280533,54504738700,23250,23900,23900,650,2.8,23500,250,1.08,23900,23900
تسه0006,امتيازتسهيلات مسكن شهريور1400,112,2293,2793950726,1223206,1162048,1225005,1799,0.15,1218470,-4736,-0.39,1162048,1250000
ومشان,س. فني و مهندسي مشانير,110,100824,9663591900,98650,95800,95700,-2950,-2.99,95850,-2800,-2.84,95700,99100
آفاق,صندوق س نوع دوم افق آتي-ثابت,110,2816606,28267563227,10027,10035,10037,10,0.1,10036,9,0.09,10035,10037
وسالت,بانك قرض الحسنه رسالت,106,120675,7554255000,64500,62600,62600,-1900,-2.95,62600,-1900,-2.95,62600,62600
سيدكو,سرمايه گذاري توسعه صنايع سيمان,106,537241,5215351080,10010,9750,9750,-260,-2.6,9940,-70,-0.7,9650,10000
تاتمس,كارخانجات صنعتي وتوليدي اتمسفر,106,46705,5491746100,115900,115300,117450,1550,1.34,117600,1700,1.47,115300,118200
فيروزه,صندوق شاخص30 شركت فيروزه- سهام,105,386267,7788820480,20670,20350,20680,10,0.05,20160,-510,-2.47,20040,20760
فاما,صنعتي‌ آما,103,3036003,23923703640,7370,7880,7880,510,6.92,7880,510,6.92,7880,7880
ضستا1104,اختيارخ شستا-900-1401/11/05,102,18753,1571558000,120,100,83,-37,-30.83,84,-36,-30,61,100
ضسپا1209,اختيارخ خساپا-2800-1401/12/10,101,28355,2315380000,108,73,78,-30,-27.78,82,-26,-24.07,71,90
شسم,توليد سموم‌ علف‌ كش,99,40212,12764211100,311300,317500,317500,6200,1.99,317400,6100,1.96,311850,317500
ثاژن,سخت آژند,98,1874659,9185090650,4820,4870,4910,90,1.87,4900,80,1.66,4860,4910
سلام2,صندوق س سلام فارابي-سهام,98,980000,980000,11090,1,1,-11089,-99.99,1,-11089,-99.99,1,1
ددام,داروسازي زاگرس فارمد پارس,98,1561865,17883354250,10910,11450,11450,540,4.95,11450,540,4.95,11450,11450
لپيام,گسترش صنايع پيام,96,1182698,31045822500,25500,26250,26250,750,2.94,26250,750,2.94,26250,26250
سخند,صندوق س.سپهرخبرگان نفت-د,95,436342,4015892162,9231,9231,9196,-35,-0.38,9204,-27,-0.29,9161,9289
ضسپا1208,اختيارخ خساپا-2600-1401/12/10,95,14400,1747360000,153,128,112,-41,-26.8,121,-32,-20.92,112,147
حگهر,حمل و نقل گهرترابر سيرجان,95,556911,6434096940,11540,11900,11540,0,0,11550,10,0.09,11300,11900
آرمان,بيمه آرمان,93,641781,3379370910,5240,5100,5380,140,2.67,5250,10,0.19,5090,5390
وايرا,سرمايه گذاري صنايع ايران,92,3099647,6445780480,2108,2100,2100,-8,-0.38,2089,-19,-0.9,2045,2100
تداوم,صندوق تداوم اطمينان تمدن-ثابت,92,964680,9753818462,10103,10111,10111,8,0.08,10111,8,0.08,10110,10111
دقاضي,داروسازي شهيد قاضي,92,285184,5344480660,19310,18750,18740,-570,-2.95,19070,-240,-1.24,18740,18750
شزنگ,تجهيزنيروي‌زنگان‌,91,57602,4366231600,74350,75800,75800,1450,1.95,75500,1150,1.55,75800,75800
ضخود1207,اختيارخ خودرو-2400-1401/12/03,90,14917,9764055000,747,790,606,-141,-18.88,655,-92,-12.32,606,790
رشد,صندوق س.رشد پايدار آبان-د,88,2998289,30086740946,10029,10035,10035,6,0.06,10035,6,0.06,10033,10035
تسه0008,امتيازتسهيلات مسكن آبان1400,87,1382,1704612034,1220047,1167000,1250000,29953,2.46,1233438,13391,1.1,1167000,1250000
ضستا1106,اختيارخ شستا-1100-1401/11/05,87,47043,47043000,1,1,1,0,0,1,0,0,1,1
تسه0001,امتيازتسهيلات مسكن فروردين1400,87,463,577962842,1263348,1210000,1245915,-17433,-1.38,1248300,-15048,-1.19,1210000,1269850
ضخود1209,اختيارخ خودرو-2800-1401/12/03,86,15545,5701184000,401,410,345,-56,-13.97,367,-34,-8.48,327,412
پشاهن,توليدي پلاستيك‌ شاهين,84,52957,3465034700,66950,68700,65050,-1900,-2.84,66400,-550,-0.82,64950,68700
صايند,صندوق س. گنجينه آينده روشن-د,83,1438192,14588700552,10130,10144,10155,25,0.25,10144,14,0.14,10122,10155
زعف0210پ20,زعفران0210نگين وحدت جام(پ),82,42217,13315048448,320584,313407,316005,-4579,-1.43,315395,-5189,-1.62,309000,323000
ثنظام,س. ساختماني نظام مهندسي ايران,82,329685,18412907250,54250,55850,55850,1600,2.95,55850,1600,2.95,55850,55850
دفرا,فرآورده‌هاي‌ تزريقي‌ ايران‌,78,177286,4618546740,26900,27490,26370,-530,-1.97,26630,-270,-1,25700,27490
تمشك2,صندوق س تمشك نماد رشد-در صندوق,78,8000000,8000000,10110,1,1,-10109,-99.99,1,-10109,-99.99,1,1
ساحل,صندوق س.اوراق دولت خليج فارس-د,77,12870810,141630742621,10995,11004,11004,9,0.08,11004,9,0.08,11004,11005
ولقمان,سرمايه گذاري لقمان,77,332642,1527376829,4676,4746,4550,-126,-2.69,4663,-13,-0.28,4536,4746
پلوله,گازلوله‌,77,408601,11951579250,30150,29250,29250,-900,-2.99,29250,-900,-2.99,29250,29250
ضسپا1210,اختيارخ خساپا-3000-1401/12/10,76,18091,1059224000,81,61,57,-24,-29.63,59,-22,-27.16,51,69
ضخود1200,اختيارخ خودرو-1500-1401/12/03,74,58800,90160122000,1603,1600,1500,-103,-6.43,1533,-70,-4.37,1460,1600
غدانه,پنبه و دانه هاي روغني خراسان,73,950000,14867500000,14910,15650,15650,740,4.96,15610,700,4.69,15650,15650
ضستا1207,اختيارخ شستا-1200-1401/12/03,73,16387,271479000,25,18,18,-7,-28,17,-8,-32,15,20
وكار,بانك‌ كارآفرين‌,72,503021,1650895938,3256,3300,3290,34,1.04,3257,1,0.03,3280,3300
ضجار2027,اختيارخ وتجارت-2000-1402/02/20,71,8662,1374618000,184,199,154,-30,-16.3,159,-25,-13.59,116,200
رايكا,صندوق س نوع دوم رايكا- ثابت	,71,1444488,15368796661,10630,10639,10641,11,0.1,10640,10,0.09,10639,10641
غناب,روغن‌ نباتي‌ ناب,70,6133,3785287600,636250,617200,617200,-19050,-2.99,617200,-19050,-2.99,617200,617200
آتيمس,صندوق س.آرمان آتيه درخشان مس-س,70,31819,6888050938,217635,220000,212667,-4968,-2.28,216476,-1159,-0.53,210500,220000
اخزا101,اسناد خزانه-م1بودجه01-040326,70,184000,102347289000,554990,555000,556100,1110,0.2,556240,1250,0.23,555000,556900
داريك,صندوق س.اعتماد داريك-د,70,3649322,53024729282,14499,14529,14531,32,0.22,14530,31,0.21,14529,14531
تسه0002,امتيازتسهيلاتمسكن ارديبهشت1400,68,895,1119576770,1256249,1215029,1250005,-6244,-0.5,1250924,-5325,-0.42,1215020,1269910
نمرينو,ايران‌ مرينوس‌,67,48995,6056761900,117740,123620,123620,5880,4.99,119760,2020,1.72,123620,123620
سكرما,سيمان‌ كرمان‌,66,120648,2135825740,17880,18170,17620,-260,-1.45,17850,-30,-0.17,17430,18170
بازده,صندوق س. بازده ثابت-د,66,12072480,125581362300,10395,10403,10404,9,0.09,10402,7,0.07,10401,10404
زنجان,صنايع كشاورزي وكود زنجان,65,606192,1588223040,2701,2620,2620,-81,-3,2620,-81,-3,2620,2620
اخزا002,اسنادخزانه-م2بودجه00-031024,65,99200,61645637000,619290,618410,620530,1240,0.2,621430,2140,0.35,618410,624500
تسه0007,امتيازتسهيلات مسكن مهر1400,65,799,983451660,1220800,1160002,1240000,19200,1.57,1230853,10053,0.82,1160002,1250000
صنم,ص.س.صندوق در صندوق صنم,62,177331,2281637065,13279,13250,12940,-339,-2.55,12867,-412,-3.1,12750,13250
ضستا0105,اختيارخ شستا-1100-1402/01/09,62,10293,738536000,83,75,72,-11,-13.25,72,-11,-13.25,67,80
تسه0005,امتيازتسهيلات مسكن مرداد 1400,62,1248,1510590246,1210205,1160000,1220000,9795,0.81,1210409,204,0.02,1160000,1250000
ضدي207,اختيارخ دي-800-14020217,61,4493,901962000,209,201,237,28,13.4,201,-8,-3.83,165,237
سنوين,سرمايه گذاري اقتصاد نوين,60,922238,5846988920,6160,6340,6340,180,2.92,6250,90,1.46,6340,6340
لخانه,لوازم‌ خانگي‌ پارس‌,60,453597,9793159230,20970,21590,21590,620,2.96,21500,530,2.53,21590,21590
ضستا6003,اختيارخ شستا-765-1402/06/08,59,16791,6076505000,400,382,360,-40,-10,362,-38,-9.5,353,382
فلات,گروه صنايع معادن فلات ايرانيان,58,402205,11583504000,28000,28800,28800,800,2.86,28800,800,2.86,28800,28800
تسه0003,امتيازتسهيلات مسكن خرداد1400,57,574,716898619,1238439,1181000,1250017,11578,0.93,1248952,10513,0.85,1181000,1250017
سكه0312پ01,تمام سكه طرح جديد0312 رفاه,57,18500,40149699000,2066909,2170254,2170254,103345,5,2170254,103345,5,2170254,2170254
دحاوي,الحاوي,57,676073,7842446800,11270,11600,11600,330,2.93,11510,240,2.13,11600,11600
فخاسح,ح . فولاد خراسان,57,812126,7387294330,9380,9500,8910,-470,-5.01,9100,-280,-2.99,8870,9500
تسه0004,امتيازتسهيلات مسكن تير1400,57,428,520803805,1212496,1162415,1245000,32504,2.68,1216831,4335,0.36,1162415,1250000
گام020813,گواهي اعتبارمولد رفاه0208	,57,3780000,3008873150000,798340,797000,796000,-2340,-0.29,796000,-2340,-0.29,795000,797000
زعف0210پ10,زعفران0210نگين طلاي سرخ(پ),56,49387,16128230300,330250,327000,325000,-5250,-1.59,326568,-3682,-1.11,316002,330000
اگ020318,گام بانك تجارت0203,55,550000,497888050000,895500,905251,905251,9751,1.09,905251,9751,1.09,905251,905251
زرين,صندوق س. سهام زرين كوروش-س,55,145364,2155209408,14866,14867,14867,1,0.01,14826,-40,-0.27,14800,14990
يارا,صندوق س. آريا-د,54,1219840,15624452802,12800,12809,12809,9,0.07,12809,9,0.07,12808,12809
افق ملت,صندوق س در سهام افق ملت,53,19116,3268272590,174070,177090,171000,-3070,-1.76,170970,-3100,-1.78,168000,177090
كهرام,توليدي گرانيت بهسرام,53,30880,1714242400,56400,56000,55300,-1100,-1.95,56100,-300,-0.53,55300,56000
دارا,صندوق س. دارا الگوريتم-د,53,3291949,33011576968,10022,10027,10028,6,0.06,10028,6,0.06,10027,10028
تپولا,مهندسي مرآت پولاد,52,90825,1691755020,19140,19140,18570,-570,-2.98,19050,-90,-0.47,18570,19420
ضجار2025,اختيارخ وتجارت-1800-1402/02/20,52,8723,1991666000,285,435,220,-65,-22.81,228,-57,-20,200,435
برن0204پ01,برنج طارم0204تجارت مازندران(پ),50,4926,4042706908,825277,829000,826999,1722,0.21,820688,-4589,-0.56,817000,829000
وامين,س. امين توان آفرين ساز,50,108468,1220003270,11350,11240,11240,-110,-0.97,11350,0,0,11240,11340
ضخود2036,اختيارخ خودرو-4000-1402/02/13,49,7763,870766000,102,150,100,-2,-1.96,112,10,9.8,100,150
دريا2,صندوق س درياي آبي فيروزه-سهام,49,4838663,4838663,11430,1,1,-11429,-99.99,1,-11429,-99.99,1,1
وامير,گروه صنعتي و معدني امير,49,50031,15927416300,313200,320000,315000,1800,0.57,318350,5150,1.64,306250,320000
ضخود3070,اختيارخ خودرو-3000-1402/03/03,48,4037,2138978000,644,473,555,-89,-13.82,530,-114,-17.7,473,577
فالوم,آلومتك‌,47,501501,4959844890,9610,9890,9890,280,2.91,9740,130,1.35,9890,9890
رماس,صندوق س.راهبرد ممتازابن سينا-س,45,251704,3244374285,13115,13300,12800,-315,-2.4,12890,-225,-1.72,12550,13560
ترمه,صندوق سرمايه گذاري ترمه-سهام	,44,85597,907403170,10780,10600,10710,-70,-0.65,10600,-180,-1.67,10550,10710
اطلس2,صندوق س.توسعه اطلس مفيد-س,44,362000,362000,318263,1,1,-318262,-100,1,-318262,-100,1,1
ضستا6010,اختيارخ شستا-1465-1402/06/08,44,9867,1250540000,134,121,138,4,2.99,127,-7,-5.22,110,138
آ س پ,آ.س.پ,44,933277,7139859210,7330,7670,7540,210,2.86,7650,320,4.37,7500,7670
گنگين,اقتصادي نگين گردشگري ايرانيان,42,666361,24233123950,36450,35400,35550,-900,-2.47,36400,-50,-0.14,35400,36450
ضخود1201,اختيارخ خودرو-1600-1401/12/03,42,16515,23627305000,2399,1500,1410,-989,-41.23,1431,-968,-40.35,1400,1500
گوهر2,صندوق سكه طلاي كيان,40,400000,400000,104824,1,1,-104823,-100,1,-104823,-100,1,1
ضهاي3000,اختيارخ هاي وب-1845-1402/03/03,40,2362,2740928688,1123,1224,1031,-92,-8.19,1071,-52,-4.63,1022,1224
تكنو,تكنوتار,39,645457,7513119480,11090,11640,11640,550,4.96,11330,240,2.16,11640,11640
ضستا6001,اختيارخ شستا-565-1402/06/08,39,5381,2630227000,534,505,485,-49,-9.18,489,-45,-8.43,400,559
ضسپا3026,اختيارخ خساپا-2400-1402/03/24,39,13427,6620019000,557,480,481,-76,-13.64,493,-64,-11.49,480,650
ضستا6006,اختيارخ شستا-1065-1402/06/08,38,3296,654685000,229,229,185,-44,-19.21,199,-30,-13.1,182,240
قاروم,قند اروميه,38,6228,812918650,133100,130700,130450,-2650,-1.99,132850,-250,-0.19,130450,132700
ضخاور1104,اختيارخ خاور-2400-14011109,38,3935,3941187000,1156,1051,1049,-107,-9.26,1002,-154,-13.32,1000,1051
ولانا,شركت ليزينگ آريا دانا,38,160160,4020016000,24400,25100,25100,700,2.87,24650,250,1.02,25100,25100
ضهرم1208,اختيارخ اهرم-14000-1401/12/22,38,2301,2607625000,1220,1195,1350,130,10.66,1133,-87,-7.13,905,1350
آرام2,صندوق س شاخصي آرام مفيد,37,3700000,3700000,11680,1,1,-11679,-99.99,1,-11679,-99.99,1,1
فسديد,لوله‌وتجهيزات‌ سديد - ورشكسته,37,49170,3173923500,63950,64550,64550,600,0.94,64550,600,0.94,64550,64550
ضشنا1105,اختيارخ شپنا-6500-1401/11/19,36,1491,1432436000,1182,1120,930,-252,-21.32,961,-221,-18.7,850,1120
خبنيان,بنيان ديزل,35,70185,737644350,10830,10510,10510,-320,-2.95,10830,0,0,10510,10510
وبازار,صندوق س شاخصي بازارآشنا,35,330230,4412342770,13780,13760,13480,-300,-2.18,13360,-420,-3.05,13230,13810
فيروزه2,صندوق شاخص30 شركت فيروزه- سهام,35,325326,325326,20670,1,1,-20669,-100,1,-20669,-100,1,1
اخزا0022,اسنادخزانه-م2بودجه00-031024,34,1452,897490280,619290,615600,617400,-1890,-0.31,618110,-1180,-0.19,615600,620000
ثروتم,صندوق س. ثروت آفرين پارسيان-س,34,263848,28316810792,109100,108834,106939,-2161,-1.98,107322,-1778,-1.63,105662,108834
وملت,سرمايه گذاري ملت,34,457912,1022975408,2191,2234,2234,43,1.96,2199,8,0.37,2234,2234
نگين,ص.س. زمين و ساختمان نگين شهرري,33,49986,3967276260,79330,79340,79360,30,0.04,79370,40,0.05,78600,79500
زعف0210پ18,زعفران0210نگين بهرامن(پ),32,22364,7073299187,317148,312502,319990,2842,0.9,316281,-867,-0.27,312000,321999
شصفها,پتروشيمي‌ اصفهان‌,31,99866,16303124500,160050,163250,163250,3200,2,162700,2650,1.66,163250,163250
ضخاور110,اختيارخ خاور-3500-14020116,31,1226,652410000,795,850,470,-325,-40.88,532,-263,-33.08,470,850
هپارس029,اختيارف ت­ وپارس-2000-02/09/08,31,1878091,1878091,1,1,1,0,0,1,0,0,1,1
ضسرو1015,اختيارخ سرو-68000-1402/10/06,30,13500,5644035000,43995,43207,40000,-3995,-9.08,41808,-2187,-4.97,40000,44000
فبستم,صنايع ‌بسته‌بندي‌ مشهد,30,41577,540501000,13400,13000,13000,-400,-2.99,13380,-20,-0.15,13000,13000
ضستا1103,اختيارخ شستا-800-1401/11/05,30,6060,1116846000,210,210,182,-28,-13.33,184,-26,-12.38,172,200
برليان,صندوق سرمايه گذاري برليان-سهام,29,95208,1000325550,10730,10760,10100,-630,-5.87,10510,-220,-2.05,10100,10760
اخزا005,اسنادخزانه-م5بودجه00-030626,28,37400,25100028000,670410,671000,671200,790,0.12,671120,710,0.11,671000,671220
اخزا103,اسناد خزانه-م3بودجه01-040520,28,52900,28356097000,534600,535000,536500,1900,0.36,536030,1430,0.27,535000,536600
اخزا004,اسنادخزانه-م4بودجه00-030522,28,156400,107211438000,685260,684500,686040,780,0.11,685500,240,0.04,684500,688000
ضشنا1108,اختيارخ شپنا-8000-1401/11/19,28,2667,279185000,108,199,85,-23,-21.3,105,-3,-2.78,46,199
زعف0210پ08,زعفران0210نگين روستا(پ),28,9052,2856811215,317273,310000,318440,1167,0.37,315600,-1673,-0.53,308773,318440
اخزا001,اسنادخزانه-م1بودجه00-030821,27,110400,71832894000,646290,647910,647180,890,0.14,650660,4370,0.68,646900,655000
اراد115,مرابحه عام دولت115-ش.خ060630,26,5010000,5010000000000,1000000,1000000,1000000,0,0,1000000,0,0,1000000,1000000
زعف0210پ09,زعفران0210نگين نوين(پ)	,26,18608,5876192350,317324,315000,318000,676,0.21,315788,-1536,-0.48,312000,318000
طسپا1203,اختيارف خساپا-1800-1401/12/10,25,5830,124007000,19,24,17,-2,-10.53,21,2,10.53,17,24
اخزا1012,اسناد خزانه-م1بودجه01-040326,25,927,513166430,554990,551010,555000,10,0,553580,-1410,-0.25,551010,555440
ضدي206,اختيارخ دي-750-14020217,24,3658,743796000,215,198,260,45,20.93,203,-12,-5.58,198,279
اخزا009,اسناد خزانه-م9بودجه00-031101,24,41300,25525714000,617750,617770,619200,1450,0.23,618060,310,0.05,616110,619990
ضدي215,اختيارخ دي-1400-14020217,24,3527,297237000,105,159,104,-1,-0.95,84,-21,-20,80,110
طخود1207,اختيارف خودرو-2400-1401/12/03,24,5723,196372000,27,38,30,3,11.11,34,7,25.93,26,38
ضخود1214,اختيارخ خودرو-4000-1401/12/03,23,6159,280612000,55,50,45,-10,-18.18,46,-9,-16.36,25,50
صنوين,صندوق سرمايه‌گذاري صنوين-مختلط,23,20790,2855615820,138890,137020,137000,-1890,-1.36,137360,-1530,-1.1,137000,138800
درسا,صندوق سرمايه گذاري درسا - سهام,23,288543,3452362190,12450,12340,11810,-640,-5.14,11960,-490,-3.94,11810,12340
اخزا006,اسنادخزانه-م6بودجه00-030723,23,154500,101686655000,657530,658000,658540,1010,0.15,658170,640,0.1,658000,659000
پادا,صندوق س.پاداش سرمايه پارس-س,22,81301,10038509982,129952,129912,125722,-4230,-3.26,123473,-6479,-4.99,122933,129912
قنقش,قند نقش جهان,22,16371,3868467300,243600,236300,236300,-7300,-3,241450,-2150,-0.88,236300,236300
ضسپا3027,اختيارخ خساپا-2600-1402/03/24,22,420,158091000,419,380,380,-39,-9.31,376,-43,-10.26,351,390
بتك,كارخانجات كابل سازي‌ تك‌,22,674,248638600,376400,368900,368900,-7500,-1.99,376000,-400,-0.11,368900,368900
زعف0210پ19,زعفران0210نگين تروند قاينات(پ),21,11538,3647110094,316829,313900,317000,171,0.05,316096,-733,-0.23,312000,318989
ضستا6007,اختيارخ شستا-1165-1402/06/08,21,1565,267316000,190,184,161,-29,-15.26,171,-19,-10,161,190
ضسرو1014,اختيارخ سرو-62000-1402/10/06,21,5210,2340350000,48352,45300,44500,-3852,-7.97,44920,-3432,-7.1,44300,45400
هم وزن2,صندوق س. شاخصي كيان-س,21,13000000,13000000,12103,1,1,-12102,-99.99,1,-12102,-99.99,1,1
اخزا0052,اسنادخزانه-م5بودجه00-030626,21,739,492964200,670410,668960,670210,-200,-0.03,667070,-3340,-0.5,661070,670230
ضستا6008,اختيارخ شستا-1265-1402/06/08,21,2235,364250000,207,170,194,-13,-6.28,163,-44,-21.26,150,194
زعف0210پ22,زعفران0210نگين گليران(پ),20,23960,7827425900,328209,325000,331000,2791,0.85,326687,-1522,-0.46,320000,331000
اراد107,مرابحه عام دولت107-ش.خ030724,20,1785000,1741120400000,937000,915010,983850,46850,5,975420,38420,4.1,915000,983850
ضستا1208,اختيارخ شستا-1300-1401/12/03,20,401,4294000,29,4,15,-14,-48.28,11,-18,-62.07,3,30
داريوش,صندوق س. ثروت داريوش -س,20,101353,1267019300,13139,12502,12500,-639,-4.86,12501,-638,-4.86,12500,12585
سكه0111پ05,تمام سكه طرح جديد0111آينده,20,4500,9766143000,2066909,2170254,2170254,103345,5,2170254,103345,5,2170254,2170254
ضخاور1105,اختيارخ خاور-2600-14011109,20,1951,1560887000,917,800,800,-117,-12.76,800,-117,-12.76,800,801
ضخاور1107,اختيارخ خاور-3000-14011109,19,755,309200000,585,400,400,-185,-31.62,410,-175,-29.91,400,498
ضستا6000,اختيارخ شستا-465-1402/06/08,19,863,515024000,655,651,595,-60,-9.16,597,-58,-8.85,595,651
ضخود3068,اختيارخ خودرو-2600-1402/03/03,19,647,511628000,854,801,840,-14,-1.64,791,-63,-7.38,750,840
ضخود3074,اختيارخ خودرو-4000-1402/03/03,18,1021,241734000,229,250,235,6,2.62,237,8,3.49,220,250
ضهرم1209,اختيارخ اهرم-15000-1401/12/22,18,1548,1384862000,854,839,840,-14,-1.64,895,41,4.8,700,1009
ضستا6005,اختيارخ شستا-965-1402/06/08,18,2242,529527000,272,263,247,-25,-9.19,236,-36,-13.24,230,270
زعف0210پ23,زعفران0210نگين مدبرتوس(پ)	,18,4790,1509160800,316711,313208,317900,1189,0.38,315065,-1646,-0.52,308774,317900
ضخود3073,اختيارخ خودرو-3750-1402/03/03,18,1095,303830000,281,290,280,-1,-0.36,277,-4,-1.42,260,290
اراد116,مرابحه عام دولت116-ش.خ060630	,18,3300000,3257100000000,940000,987000,987000,47000,5,987000,47000,5,987000,987000
سيناد,صندوق س.سپهرسودمند سينا-د,18,7903974,79361188960,10032,10040,10041,9,0.09,10041,9,0.09,10040,10041
ضخاور1103,اختيارخ خاور-2200-14011109,18,526,636788000,1356,1250,1200,-156,-11.5,1211,-145,-10.69,1200,1300
رشد2,صندوق س.رشد پايدار آبان-د,17,1681346,1681346,10029,1,1,-10028,-99.99,1,-10028,-99.99,1,1
ضشنا1109,اختيارخ شپنا-9000-1401/11/19,17,1601,89600000,85,140,48,-37,-43.53,56,-29,-34.12,48,60
شگامرن,مجتمع پترو صنعت گامرون,17,4942,1888848000,401050,421100,381000,-20050,-5,382200,-18850,-4.7,381000,421100
فنرژي,گسترش صنايع انرژي آذرآب,17,130938,2270464920,17690,17340,17340,-350,-1.98,17520,-170,-0.96,17340,17340
وثخوز,سرمايه گذاري و توسعه خوزستان,17,14597,462724900,30800,31700,31700,900,2.92,30850,50,0.16,31700,31700
طشنا1106,اختيارف شپنا-7000-1401/11/19,16,288,50500000,99,80,121,22,22.22,175,76,76.77,80,225
سپيدما2,صندوق س. سپيد دماوند-د,16,149300000,149300000,14404,1,1,-14403,-99.99,1,-14403,-99.99,1,1
ضخاور111,اختيارخ خاور-3700-14020116,16,2146,814600000,527,450,350,-177,-33.59,380,-147,-27.89,350,450
ضستا6002,اختيارخ شستا-665-1402/06/08,15,3494,1477056000,458,430,420,-38,-8.3,423,-35,-7.64,411,430
ضخود3067,اختيارخ خودرو-2400-1402/03/03,15,2637,2663813000,1050,1000,1020,-30,-2.86,1010,-40,-3.81,952,1020
ضهرم1207,اختيارخ اهرم-13000-1401/12/22,15,115,185385000,1753,1701,1674,-79,-4.51,1612,-141,-8.04,1400,1701
مرواريد,صندوق س. مرواريد بها بازار-س,15,24695,269909010,11091,11050,10820,-271,-2.44,10930,-161,-1.45,10820,11050
زعف0210پ16,زعفران0210نگين بيرجند(پ),15,2821,883260546,314583,312293,316201,1618,0.51,313102,-1481,-0.47,310124,316469
ضسپا1203,اختيارخ خساپا-1800-1401/12/10,14,754,473430000,686,630,615,-71,-10.35,628,-58,-8.45,615,655
آسام,صندوق س.آرمان سپهر آشنا-م,14,87454,1413950548,16484,16210,16050,-434,-2.63,16168,-316,-1.92,16050,16430
ضهرم7002,اختيارخ اهرم-7500-1402/07/23,14,4072,31486790000,8400,8000,8300,-100,-1.19,7733,-667,-7.94,7720,9000
اخزا909,اسنادخزانه-م9بودجه99-020316,14,14100,12912418000,915330,915810,916010,680,0.07,915770,440,0.05,915540,916010
ضملت1144,اختيارخ وبملت-2600-1401/11/24,14,654,428240000,831,701,640,-191,-22.98,655,-176,-21.18,640,701
ضستا1102,اختيارخ شستا-700-1401/11/05,14,1476,422082000,304,300,288,-16,-5.26,286,-18,-5.92,275,300
پارسيانح,ح.بيمه پارسيان,13,337412,843530000,1894,2500,2500,606,32,2500,606,32,2500,2500
ثنا,صندوق س.زرين نهال ثنا-س,13,752762,9017209613,11976,12000,11800,-176,-1.47,11979,3,0.03,11441,12000
ضپلا1208,اختيارخ پالايش-100000-01/12/16,13,4131,751194500,20500,18500,19998,-502,-2.45,18184,-2316,-11.3,15880,20000
سايرا,ايرانيت‌,13,108987,3253261950,29300,29850,29850,550,1.88,29650,350,1.19,29850,29850
طخود1206,اختيارف خودرو-2200-1401/12/03,13,2282,40954000,21,30,17,-4,-19.05,18,-3,-14.29,17,30
هيوا,صندوق س. ثروت هيوا-س,13,99247,1121291250,11517,11400,11200,-317,-2.75,11298,-219,-1.9,11200,11550
ضهرم1206,اختيارخ اهرم-12000-1401/12/22,13,488,997192000,2364,2100,1900,-464,-19.63,2043,-321,-13.58,1899,2200
گنجينه,صندوق س. گنجينه داريوش-د,12,2917421,29308631045,10041,10047,10046,5,0.05,10046,5,0.05,10046,10047
ضچكا1208,اختيارخ چكاپا-3250-1401/12/07,12,346,41509000,163,297,130,-33,-20.25,120,-43,-26.38,50,297
ضخود1213,اختيارخ خودرو-3750-1401/12/03,12,2175,88900000,82,40,40,-42,-51.22,41,-41,-50,40,59
ضهرم7008,اختيارخ اهرم-13000-1402/07/23,12,2635,10732750000,4761,4435,4050,-711,-14.93,4073,-688,-14.45,4034,4435
تاراز,صندوق س آواي تاراز زاگرس-سهام,11,19011,246952020,13360,13310,12910,-450,-3.37,12990,-370,-2.77,12820,13310
ضخود1108,اختيارخ خودرو-2400-1401/11/12,11,508,303464000,697,600,580,-117,-16.79,597,-100,-14.35,580,600
اخزا010,اسناد خزانه-م10بودجه00-031115,11,12700,7776267400,610344,579854,611201,857,0.14,612304,1960,0.32,579854,612890
سكه0310پ04,تمام سكه طرح جديد 0310 صادرات,11,1600,3472406400,2066909,2170254,2170254,103345,5,2170254,103345,5,2170254,2170254
نشان,صندوق س. نشان هامرز-د,11,40091,465409582,11601,11608,11609,8,0.07,11609,8,0.07,11608,11609
طحفا1207,اختيارف حفارس-15000-1401/12/24,11,930,800500000,100,830,885,785,785,861,761,761,830,885
ضخود3071,اختيارخ خودرو-3250-1402/03/03,11,1015,407111000,496,399,400,-96,-19.35,401,-95,-19.15,399,430
ضذوب1105,اختيارخ ذوب-2085-1401/11/12,11,128,108464485,1084,701,800,-284,-26.2,736,-348,-32.1,333,800
ضخود1203,اختيارخ خودرو-1800-1401/12/03,10,1686,2065290000,1149,1511,1220,71,6.18,1225,76,6.61,1100,1511
ضدي201,اختيارخ دي-500-14020217,10,605,285078000,460,478,410,-50,-10.87,471,11,2.39,410,490
اخزا0012,اسنادخزانه-م1بودجه00-030821,10,420,272092760,646290,648200,648500,2210,0.34,647840,1550,0.24,644390,648810
ضكاريس205,اختيارخ كاريس-16000-14020205,10,322,654857000,2371,2200,2040,-331,-13.96,2034,-337,-14.21,2000,2200
بذر,صندوق س بذر اميد آفرين-سهام,10,21450,2642189240,126350,126180,126220,-130,-0.1,123180,-3170,-2.51,122900,126220
ضترا3024,اختيارخ شتران-4000-1402/03/28,10,184,167842000,1134,913,900,-234,-20.63,912,-222,-19.58,900,1080
طخود1204,اختيارف خودرو-1900-1401/12/03,9,431,5210000,10,13,13,3,30,12,2,20,9,13
اخزا908,اسنادخزانه-م8بودجه99-020606,9,2900,2513712000,867010,865000,868000,990,0.11,866800,-210,-0.02,865000,868000
ضملت1146,اختيارخ وبملت-3000-1401/11/24,9,278,95582000,439,400,313,-126,-28.7,344,-95,-21.64,300,400
ضخود1202,اختيارخ خودرو-1700-1401/12/03,9,4200,5600000000,1327,1550,1320,-7,-0.53,1333,6,0.45,1320,1550
ضشنا1107,اختيارخ شپنا-7500-1401/11/19,9,182,30015000,250,121,250,0,0,165,-85,-34,121,300
گام020661,گواهي اعتبار مولد شهر0206,9,120000,99785000000,835000,830000,834000,-1000,-0.12,831540,-3460,-0.41,830000,834000
ضصاد1124,اختيارخ وبصادر-1400-1401/11/19,9,370,156673000,468,401,419,-49,-10.47,423,-45,-9.62,401,427
اراد43,مرابحه عام دولت4-ش.خ 0205,9,720000,701280000000,988810,974000,974000,-14810,-1.5,974000,-14810,-1.5,974000,974000
ضهرم1204,اختيارخ اهرم-10000-1401/12/22,9,265,1094700000,4205,4000,4189,-16,-0.38,4131,-74,-1.76,3800,4205
اگ020719,گام بانك صادرات ايران0207,9,11071,9050845627,816999,817000,817999,1000,0.12,817527,528,0.06,817000,817999
اخزا007,اسنادخزانه-م7بودجه00-030912,9,25700,16393242000,636450,638000,638010,1560,0.25,637870,1420,0.22,637000,638010
ضهرم7000,اختيارخ اهرم-6500-1402/07/23,9,62,571108000,10016,8536,8700,-1316,-13.14,9211,-805,-8.04,8500,9330
ضحفا1207,اختيارخ حفارس-15000-1401/12/24,9,322,379010000,1689,1200,1170,-519,-30.73,1177,-512,-30.31,1170,1200
ضخود1113,اختيارخ خودرو-3500-1401/11/12,9,827,10997000,21,9,20,-1,-4.76,13,-8,-38.1,9,21
ضخاور112,اختيارخ خاور-3900-14020116,8,801,208751000,414,400,260,-154,-37.2,261,-153,-36.96,230,350
عقيق,صندوق سرمايه گذاري عقيق-سهام,8,70055,3646887500,53320,50000,52800,-520,-0.98,52060,-1260,-2.36,50000,54500
تصميم2,صندوق س با درآمد ثابت تصميم,8,25000000,25000000,22872,1,1,-22871,-100,1,-22871,-100,1,1
ضخود1111,اختيارخ خودرو-3000-1401/11/12,8,210,22500000,227,150,100,-127,-55.95,107,-120,-52.86,100,150
ضملت3024,اختيارخ وبملت-2969-1402/03/28,8,336,328178000,575,444,1000,425,73.91,977,402,69.91,334,1000
اخزا003,اسنادخزانه-م3بودجه00-030418,8,7100,4988191000,703190,701910,703010,-180,-0.03,702560,-630,-0.09,701900,703020
ثنا2,صندوق س.زرين نهال ثنا-س,8,748000,748000,11976,1,1,-11975,-99.99,1,-11975,-99.99,1,1
ضسلا1206,اختيارخ سلام-10000-1401/12/22,8,785,1057490000,1690,1460,1460,-230,-13.61,1347,-343,-20.3,1130,1460
ضستر1106,اختيارخ خگستر-3000-1401/11/26,8,119,104898000,1967,900,996,-971,-49.36,881,-1086,-55.21,800,996
ضملت3017,اختيارخ وبملت-1782-1402/03/28,7,363,571290000,1900,1630,1500,-400,-21.05,1574,-326,-17.16,1500,1650
ضذوب1104,اختيارخ ذوب-1911-1401/11/12,7,49,67673045,1505,1200,1200,-305,-20.27,1200,-305,-20.27,1199,1200
ضسپا3025,اختيارخ خساپا-2200-1402/03/24,7,441,281840000,733,500,620,-113,-15.42,639,-94,-12.82,500,670
فردا2,صندوق س آواي فرداي زاگرس-ثابت,7,6781299,6781299,15098,1,1,-15097,-99.99,1,-15097,-99.99,1,1
سرو2,صندوق س سروسودمند مدبران-سهام,7,1700000,1700000,92820,1,1,-92819,-100,1,-92819,-100,1,1
ضسپا3028,اختيارخ خساپا-2800-1402/03/24,7,4540,1497670000,362,330,330,-32,-8.84,330,-32,-8.84,329,330
ضسپا3030,اختيارخ خساپا-3250-1402/03/24,7,1308,376878000,312,289,288,-24,-7.69,288,-24,-7.69,270,289
طترا3024,اختيارف شتران-4000-1402/03/28,7,417,184290000,1,600,253,252,25200,442,441,44100,252,600
ضترا3023,اختيارخ شتران-3750-1402/03/28,7,210,228576000,1238,1115,1050,-188,-15.19,1088,-150,-12.12,1050,1280
اخزا910,اسنادخزانه-م10بودجه99-020807,7,7800,6482501000,831920,830920,831500,-420,-0.05,831090,-830,-0.1,830920,831500
ضفلا1173,اختيارخ فولاد-5000-1401/11/26,7,318,339040000,1240,1100,1000,-240,-19.35,1066,-174,-14.03,1000,1100
افران2,صندوق س افرا نماد پايدار-ثابت,7,171300000,171300000,18970,1,1,-18969,-99.99,1,-18969,-99.99,1,1
هماي2,صندوق س هماي آگاه-ثابت,7,22800000,22800000,10025,1,1,-10024,-99.99,1,-10024,-99.99,1,1
ضستا0107,اختيارخ شستا-1300-1402/01/09,7,700,28000000,63,40,40,-23,-36.51,40,-23,-36.51,40,40
زيتون2,صندوق س زيتون نماد پايا- مختلط,7,27500000,27500000,14320,1,1,-14319,-99.99,1,-14319,-99.99,1,1
ضشنا2025,اختيارخ شپنا-5859-1402/02/24,7,136,210440000,1660,1550,1550,-110,-6.63,1547,-113,-6.81,1540,1550
طخود1208,اختيارف خودرو-2600-1401/12/03,7,1541,85719000,83,99,40,-43,-51.81,56,-27,-32.53,40,99
ضپلا1206,اختيارخ پالايش-80000-01/12/16,6,368,135830600,37110,37109,37900,790,2.13,36910,-200,-0.54,13900,37900
اخزا008,اسنادخزانه-م8بودجه00-030919,6,10100,6412938000,634770,638990,635500,730,0.12,634940,170,0.03,634770,638990
گنجين,صندوق س. گنجينه يكم آويد-د,6,510261,8949519410,17526,17545,17539,13,0.07,17539,13,0.07,17539,17545
اخزا0042,اسنادخزانه-م4بودجه00-030522,6,253,173225050,685260,685300,684540,-720,-0.11,684680,-580,-0.08,684510,685300
كيا,كيا الكترود شرق,6,69174,697273920,9600,10080,10080,480,5,10080,480,5,10080,10080
سپرمي,پرميت‌,6,3593,119287600,33500,33200,33200,-300,-0.9,33500,0,0,33200,33200
ضمان,صندوق تضمين ا.سرمايه كاريزما-م,6,600000,6810000000,11900,11600,11100,-800,-6.72,11350,-550,-4.62,11100,11600
ومللح,ح . اعتباري ملل,6,60880,164128680,2827,2880,2686,-141,-4.99,2696,-131,-4.63,2686,2880
ضهاي3005,اختيارخ هاي وب-2768-1402/03/03,6,702,203835360,501,660,660,159,31.74,268,-233,-46.51,250,660
طذوب1112,اختيارف ذوب-3475-1401/11/12,6,5730,2651282460,1,402,402,401,40100,402,401,40100,402,402
ضخود3069,اختيارخ خودرو-2800-1402/03/03,6,514,258402000,581,500,602,21,3.61,503,-78,-13.43,500,602
دقاضيح,ح . داروسازي شهيد قاضي,5,367688,6141874800,17460,17300,16710,-750,-4.3,16700,-760,-4.35,16700,17300
كارا4,صندوق س. كارا -د,5,99573279,1314512129894,13193,13201,13202,9,0.07,13201,8,0.06,13201,13202
فاذر4,صنايع‌ آذرآب‌,5,4755012018,7427328772116,1792,1562,1562,-230,-12.83,1562,-230,-12.83,1562,1562
سپيدما4,صندوق س. سپيد دماوند-د,5,124417000,1793471055000,14404,14415,14415,11,0.08,14415,11,0.08,14415,14415
ضملت1148,اختيارخ وبملت-3500-1401/11/24,5,298,24978000,151,81,170,19,12.58,84,-67,-44.37,81,170
ضخاور113,اختيارخ خاور-4100-14020116,5,381,86379000,338,299,225,-113,-33.43,227,-111,-32.84,225,299
اخزا820,اسنادخزانه-م20بودجه98-020806,5,100100,83433350000,832050,833500,833500,1450,0.17,833500,1450,0.17,833500,833500
آگاس2,صندوق س.هستي بخش آگاه-س,5,500000,500000,99995,1,1,-99994,-100,1,-99994,-100,1,1
ثهام,صندوق س ثروت هامرز-سهام,5,13400,177436680,13440,13400,13240,-200,-1.49,13240,-200,-1.49,13230,13400
اراد50,مرابحه عام دولت5-ش.خ0302,5,110000,110000000000,1000000,1000000,1000000,0,0,1000000,0,0,1000000,1000000
شكف,كف,5,1400,55440000,40400,39600,39600,-800,-1.98,40400,0,0,39600,39600
پاداش2,صندوق س. ارزش پاداش-د,5,32000000,32000000,10269,1,1,-10268,-99.99,1,-10268,-99.99,1,1
اخزا0032,اسنادخزانه-م3بودجه00-030418,5,156,109334330,703190,700120,702010,-1180,-0.17,700860,-2330,-0.33,700120,702010
اخزا0062,اسنادخزانه-م6بودجه00-030723,5,148,97206140,657530,656530,657510,-20,0,656800,-730,-0.11,656520,657510
كارا2,صندوق س. كارا -د,5,211000000,211000000,13193,1,1,-13192,-99.99,1,-13192,-99.99,1,1
ضجار2024,اختيارخ وتجارت-1700-1402/02/20,5,239,62710000,356,260,260,-96,-26.97,262,-94,-26.4,260,270
سكه0112پ03,تمام سكه طرح جديد0112سامان,5,1000,2170254000,2066909,2170254,2170254,103345,5,2170254,103345,5,2170254,2170254
طملي1174,اختيارف فملي-7500-1401/11/12,4,16,2195000,250,170,145,-105,-42,137,-113,-45.2,70,170
ضكاريس207,اختيارخ كاريس-18000-14020205,4,120,132402000,1350,947,1070,-280,-20.74,1103,-247,-18.3,947,1430
اوصتا2,صندوق انديشه ورزان صباتامين -د,4,34348520,34348520,26188,1,1,-26187,-100,1,-26187,-100,1,1
فماك2,ماداكتو استيل كرد,4,4000000,66800000000,16280,16700,16700,420,2.58,16700,420,2.58,16700,16700
آكورد2,صندوق س. آرمان آتي كوثر-د,4,2000000,2000000,44722,1,1,-44721,-100,1,-44721,-100,1,1
ضترا1145,اختيارخ شتران-3710-1401/11/19,4,226,182834000,655,500,500,-155,-23.66,500,-155,-23.66,500,500
ضخود0109,اختيارخ خودرو-3000-1402/01/09,4,365,110250000,286,300,350,64,22.38,302,16,5.59,300,350
ضجار2023,اختيارخ وتجارت-1600-1402/02/20,4,136,30033000,470,203,300,-170,-36.17,221,-249,-52.98,203,300
ضفلا1172,اختيارخ فولاد-4500-1401/11/26,4,12,21450000,1600,1600,1900,300,18.75,1787,187,11.69,1600,1900
اگ020618,گام بانك تجارت0206,4,1220,1019920000,842750,836000,836000,-6750,-0.8,836000,-6750,-0.8,836000,836000
ضجار2029,اختيارخ وتجارت-2400-1402/02/20,4,11,2669000,200,244,239,39,19.5,243,43,21.5,239,244
ضملت3018,اختيارخ وبملت-1930-1402/03/28,4,148,219600000,1850,1480,1480,-370,-20,1484,-366,-19.78,1480,1550
ضسپا3029,اختيارخ خساپا-3000-1402/03/24,4,749,170214000,278,210,284,6,2.16,227,-51,-18.35,200,284
ضچكا1207,اختيارخ چكاپا-3000-1401/12/07,4,102,26827000,240,157,264,24,10,263,23,9.58,157,270
طستا1105,اختيارف شستا-1000-1401/11/05,4,1010,10100000,4,10,10,6,150,10,6,150,10,10
ثمين,صندوق س. ثروت افزون ثمين-س,4,10490,141891200,13536,13580,13300,-236,-1.74,13526,-10,-0.07,13300,13580
آرمانح,ح.بيمه آرمان,4,34372,124602363,3737,3625,3625,-112,-3,3625,-112,-3,3625,3626
سكه0211پ02,تمام سكه طرح جديد0211ملت,4,700,1519177800,2066909,2170254,2170254,103345,5,2170254,103345,5,2170254,2170254
ضملت1145,اختيارخ وبملت-2800-1401/11/24,4,50,27880000,630,550,560,-70,-11.11,558,-72,-11.43,550,560
ضهرم7010,اختيارخ اهرم-15000-1402/07/23,4,278,837838000,3682,3480,3479,-203,-5.51,3014,-668,-18.14,3000,3480
ضدي200,اختيارخ دي-450-14020217,4,29,13059000,488,455,446,-42,-8.61,450,-38,-7.79,444,455
ضبساما305,اختيارخ بساما-12000-14020310,4,4,2425000,1000,660,550,-450,-45,606,-394,-39.4,550,660
ضجار2028,اختيارخ وتجارت-2200-1402/02/20,3,9,2963000,206,333,299,93,45.15,329,123,59.71,299,333
اخزا0082,اسنادخزانه-م8بودجه00-030919,3,138,87547890,634770,634800,634010,-760,-0.12,634400,-370,-0.06,634010,634800
ثبات2,صندوق س. ثبات ويستا -د,3,20400000,20400000,13386,1,1,-13385,-99.99,1,-13385,-99.99,1,1
اوج,صندوق س.اوج دماوند-س,3,946,10776142,11407,11479,11365,-42,-0.37,11391,-16,-0.14,11365,11479
زعف0210پ25,زعفران0210نگين زرپران (پ),3,124,39488000,325500,312000,320000,-5500,-1.69,318452,-7048,-2.17,312000,320000
ضخاور1100,اختيارخ خاور-1600-14011109,3,232,431400000,2000,1860,1800,-200,-10,1859,-141,-7.05,1800,1860
اوصتا4,صندوق انديشه ورزان صباتامين -د,3,61478126,1610407449742,26188,26205,26160,-28,-0.11,26195,7,0.03,26160,26205
ضستا1107,اختيارخ شستا-1200-1401/11/05,3,1009,1009000,1,1,1,0,0,1,0,0,1,1
ضخود1204,اختيارخ خودرو-1900-1401/12/03,3,52,53614000,1158,1032,1031,-127,-10.97,1031,-127,-10.97,1031,1032
ضجار2021,اختيارخ وتجارت-1400-1402/02/20,3,19,9502000,527,520,499,-28,-5.31,500,-27,-5.12,499,520
ضحفا1208,اختيارخ حفارس-16000-1401/12/24,3,12,12000000,1000,1000,1000,0,0,1000,0,0,1000,1000
افاد81,منفعت دولت8-ش.خاص مهر0205,3,495000,479803500000,1000000,969300,969300,-30700,-3.07,969300,-30700,-3.07,969300,969300
اراد644,مرابحه عام دولتي64-ش.خ0111,3,35910000,35857820910000,998680,998501,998666,-14,0,998547,-133,-0.01,998501,998666
زعف0210پ21,زعفران0210نگين ملل(پ),3,332,103819600,324603,311772,324000,-603,-0.19,312710,-11893,-3.66,311772,324000
ولملتح,ح . واسپاري ملت,3,7038,27448200,3955,3900,3900,-55,-1.39,3900,-55,-1.39,3900,3900
ضفلا1174,اختيارخ فولاد-5500-1401/11/26,3,7,4160000,700,640,560,-140,-20,594,-106,-15.14,560,640
اخزا0102,اسناد خزانه-م10بودجه00-031115,3,177,108059340,610344,610890,610010,-334,-0.05,610500,156,0.03,610010,610890
فيروزا2,صندوق ارمغان فيروزه آسيا-ثابت,2,59000000,59000000,32429,1,1,-32428,-100,1,-32428,-100,1,1
ضخاور106,اختيارخ خاور-2700-14020116,2,258,309600000,1357,1200,1200,-157,-11.57,1200,-157,-11.57,1200,1200
ضملي1170,اختيارخ فملي-5500-1401/11/12,2,15,29250000,1919,1950,1950,31,1.62,1950,31,1.62,1950,1950
ضترا1143,اختيارخ شتران-3090-1401/11/19,2,28,43038800,1004,950,950,-54,-5.38,950,-54,-5.38,950,950
ضستا6009,اختيارخ شستا-1365-1402/06/08,2,265,42400000,157,160,160,3,1.91,160,3,1.91,160,160
طكارا106,اختيارف كارا-13995-14020130,2,2000,158000000,1,79,79,78,7800,79,78,7800,79,79
اخزا905,اسنادخزانه-م5بودجه99-020218,2,1200,1122012000,933650,935010,935010,1360,0.15,935010,1360,0.15,935010,935010
سپر4,صندوق س سپر سرمايه بيدار- ثابت,2,43371216,722372535282,16633,16652,16675,42,0.25,16656,23,0.14,16652,16675
اخزا9112,اسنادخزانه-م11بودجه99-020906,2,28,22780800,815010,815990,811210,-3800,-0.47,813600,-1410,-0.17,811210,815990
سپر2,صندوق س سپر سرمايه بيدار- ثابت,2,11000000,11000000,16633,1,1,-16632,-99.99,1,-16632,-99.99,1,1
خعمراح,ح. توسعه و عمران شهرستان نائين,2,50000,215000000,4500,4300,4300,-200,-4.44,4300,-200,-4.44,4300,4300
صيدك404,صكوك مرابحه صيدك404-3ماهه18%,2,11102,10968776000,960000,988000,988000,28000,2.92,988000,28000,2.92,988000,988000
اخزا914,اسنادخزانه-م14بودجه99-021025,2,800,630607000,799990,790000,788010,-11980,-1.5,788260,-11730,-1.47,788010,790000
ضسرو1016,اختيارخ سرو-74000-1402/10/06,2,2000,759500000,39437,38950,37000,-2437,-6.18,37975,-1462,-3.71,37000,38950
ويستا,صندوق س. ويستا -س,2,14241,185902449,13563,13087,12989,-574,-4.23,13054,-509,-3.75,12989,13087
ضهاي3008,اختيارخ هاي وب-3460-1402/03/03,2,2,450944,311,166,250,-61,-19.61,208,-103,-33.12,166,250
چنوپا,نيوپان‌ 22 بهمن‌,2,2600,47424000,17710,18240,18240,530,2.99,18240,530,2.99,18240,18240
اخزا907,اسنادخزانه-م7بودجه99-020704,2,900,764600000,846010,855000,848000,1990,0.24,849560,3550,0.42,848000,855000
ضشنا2026,اختيارخ شپنا-6277-1402/02/24,2,14,21000000,1900,1500,1500,-400,-21.05,1500,-400,-21.05,1500,1500
ضترا3019,اختيارخ شتران-2800-1402/03/28,2,8,16250000,2000,2250,1900,-100,-5,2031,31,1.55,1900,2250
ويستا2,صندوق س. ويستا -س,2,200000,200000,13563,1,1,-13562,-99.99,1,-13562,-99.99,1,1
اراد1214,مرابحه عام دولت121-ش.خ030324,2,49360000,45082635160000,959000,913287,913400,-45600,-4.75,913343,-45657,-4.76,913287,913400
اراد334,مرابحه عام دولت3-ش.خ 0303,2,5972900,5256588021700,990000,880046,880100,-109900,-11.1,880073,-109927,-11.1,880046,880100
اخزا0072,اسنادخزانه-م7بودجه00-030912,2,108,68778850,636450,637000,636510,60,0.01,636840,390,0.06,636510,637000
ضخود0111,اختيارخ خودرو-3500-1402/01/09,2,60,12060000,250,201,201,-49,-19.6,201,-49,-19.6,201,201
ضخاو1209,اختيارخ وخاور-6000-1401/12/01,2,1030,40300000,50,40,10,-40,-80,39,-11,-22,10,40
ضهاي3006,اختيارخ هاي وب-2998-1402/03/03,2,2,760968,453,351,351,-102,-22.52,351,-102,-22.52,351,351
ضخود1112,اختيارخ خودرو-3250-1401/11/12,2,50,2800000,120,72,52,-68,-56.67,56,-64,-53.33,52,72
طستا1106,اختيارف شستا-1100-1401/11/05,2,15,1250000,80,70,90,10,12.5,83,3,3.75,70,90
اخزا911,اسنادخزانه-م11بودجه99-020906,2,2000,1630619000,815010,815300,815310,300,0.04,815310,300,0.04,815300,815310
ضخود0108,اختيارخ خودرو-2800-1402/01/09,2,101,11300000,850,110,300,-550,-64.71,112,-738,-86.82,110,300
اخزا904,اسنادخزانه-م4بودجه99-011215,2,15500,15094207000,974630,973790,973820,-810,-0.08,973820,-810,-0.08,973790,973820
ضپلا1207,اختيارخ پالايش-90000-01/12/16,2,509,126950000,28060,24000,25000,-3060,-10.91,24941,-3119,-11.12,24000,25000
طخود1200,اختيارف خودرو-1500-1401/12/03,2,228,2252000,94,10,9,-85,-90.43,10,-84,-89.36,9,10
ضملت3022,اختيارخ وبملت-2598-1402/03/28,2,295,231000000,1,750,800,799,79900,783,782,78200,750,800
ضسلا1205,اختيارخ سلام-9000-1401/12/22,2,320,759600000,2480,2380,2280,-200,-8.06,2374,-106,-4.27,2280,2380
ضسپا1200,اختيارخ خساپا-1500-1401/12/10,2,18,14586000,1037,811,810,-227,-21.89,810,-227,-21.89,810,811
ضدي204,اختيارخ دي-650-14020217,2,66,21000000,345,300,360,15,4.35,318,-27,-7.83,300,360
ضترا1146,اختيارخ شتران-4018-1401/11/19,2,21,5810238,482,171,171,-311,-64.52,171,-311,-64.52,171,171
كمند2,صندوق س. با درآمد ثابت كمند,2,120000000,120000000,10118,1,1,-10117,-99.99,1,-10117,-99.99,1,1
حآفرين2,ريل پرداز نو آفرين,2,36000000,159920000000,4438,4450,4440,2,0.05,4442,4,0.09,4440,4450
افران4,صندوق س افرا نماد پايدار-ثابت,2,116994169,2221017304296,18970,18984,18984,14,0.07,18984,14,0.07,18984,18984
اراد314,مرابحه عام دولت3-ش.خ 0208,2,9320000,8657925840000,994300,928874,929050,-65250,-6.56,928962,-65338,-6.57,928874,929050
ضهرم1203,اختيارخ اهرم-9000-1401/12/22,2,20,61200000,3233,3000,3100,-133,-4.11,3060,-173,-5.35,3000,3100
ضستا1101,اختيارخ شستا-600-1401/11/05,2,14,5320000,400,380,380,-20,-5,380,-20,-5,380,380
ضسلا7005,اختيارخ سلام-11000-1402/07/19,2,101,218490000,2587,2160,2490,-97,-3.75,2163,-424,-16.39,2160,2490
ضسپا3020,اختيارخ خساپا-1600-1402/03/24,2,11,11150000,1100,1000,1150,50,4.55,1014,-86,-7.82,1000,1150
ضسپا1202,اختيارخ خساپا-1700-1401/12/10,2,31,23650000,836,700,765,-71,-8.49,763,-73,-8.73,700,765
ضترا3029,اختيارخ شتران-6500-1402/03/28,2,6,1800000,441,300,300,-141,-31.97,300,-141,-31.97,300,300
نسب0203,آتي نفتاي سبك-1402/03/17,1,100,164435500,1730900,1644355,1644355,-86545,-5,1644355,-86545,-5,1644355,1644355
صينا205,صكوك منفعت سينا دارو-3ماهه 19%,1,1,974902,974902,974902,974902,0,0,974902,0,0,974902,974902
ضملت3023,اختيارخ وبملت-2784-1402/03/28,1,10,7800000,1020,780,780,-240,-23.53,780,-240,-23.53,780,780
ضسپا3023,اختيارخ خساپا-1900-1402/03/24,1,3,2640000,960,880,880,-80,-8.33,880,-80,-8.33,880,880
تملي107,تسهيلات مسكن ب.ملي-مهر1401,1,10,7888770,830396,788877,788877,-41519,-5,788877,-41519,-5,788877,788877
سمتا024,سلف موازي متانول بوشهر 024,1,100,102245600,1021981,1022456,1022456,475,0.05,1022456,475,0.05,1022456,1022456
امين يكم4,صندوق درآمد ثابت امين يكم فردا,1,50000000,498950000000,9947,9979,9979,32,0.32,9979,32,0.32,9979,9979
سنفت021,سلف موازي نفت.س صادر اروند 021,1,100,237665500,2375550,2376655,2376655,1105,0.05,2376655,1105,0.05,2376655,2376655
مشير304,مشاركت ش شيراز304-3ماهه18%,1,1000,950000000,947583,950000,950000,2417,0.26,950000,2417,0.26,950000,950000
تفيرو,مهندسي فيروزا,1,1405,55638000,38850,39600,39600,750,1.93,39600,750,1.93,39600,39600
ضتفارس600,اختيارخ تفارس-2195-14020629,1,1,2200000,3500,2200,2200,-1300,-37.14,2200,-1300,-37.14,2200,2200
طحسير609,اختيارف حسير-13695-14020627,1,1,5500000,5000,5500,5500,500,10,5500,500,10,5500,5500
ضصاد3022,اختيارخ وبصادر-1600-1402/03/17,1,50,20000000,799,400,400,-399,-49.94,400,-399,-49.94,400,400
ضخاور107,اختيارخ خاور-2900-14020116,1,1,1130000,750,1130,1130,380,50.67,1130,380,50.67,1130,1130
ضملت1147,اختيارخ وبملت-3250-1401/11/24,1,6,1500000,330,250,250,-80,-24.24,250,-80,-24.24,250,250
طملي1171,اختيارف فملي-6000-1401/11/12,1,2,60000,15,30,30,15,100,30,15,100,30,30
اگ020619,گام بانك صادرات ايران0206,1,17,14280000,840000,840000,840000,0,0,840000,0,0,840000,840000
برن0203پ02,برنج فجر0203 تجارت مازندران(پ),1,200,114400000,573635,572000,572000,-1635,-0.29,572000,-1635,-0.29,572000,572000
ضخود1109,اختيارخ خودرو-2600-1401/11/12,1,100,50000000,584,500,500,-84,-14.38,500,-84,-14.38,500,500
زير0203پ01,زيره سبز 0203 كيميابذر(پ),1,10,16300000,1600030,1630000,1630000,29970,1.87,1630000,29970,1.87,1630000,1630000
ضذوب1113,اختيارخ ذوب-3910-1401/11/12,1,1,11510,44,10,10,-34,-77.27,10,-34,-77.27,10,10
ضخود0112,اختيارخ خودرو-3750-1402/01/09,1,2,460000,250,230,230,-20,-8,230,-20,-8,230,230
اراد119,مرابحه عام دولت119-ش.خ060811	,1,100000,95235000000,952350,952350,952350,0,0,952350,0,0,952350,952350
اخزا9082,اسنادخزانه-م8بودجه99-020606,1,33,28077390,867010,850830,850830,-16180,-1.87,850830,-16180,-1.87,850830,850830
اراد46,مرابحه عام دولت4-ش.خ 0302,1,30000,30000000000,992000,1000000,1000000,8000,0.81,1000000,8000,0.81,1000000,1000000
سمتا025,سلف موازي متانول بوشهر 025,1,100,116268000,1162139,1162680,1162680,541,0.05,1162680,541,0.05,1162680,1162680
وغدير2,سرمايه‌گذاري‌غدير(هلدينگ‌,1,10000000,184500000000,18700,18450,18450,-250,-1.34,18450,-250,-1.34,18450,18450
متا0203,آتي متانول-1402/03/17,1,100,90970000,909900,909700,909700,-200,-0.02,909700,-200,-0.02,909700,909700
سمتا023,سلف موازي استاندارد سمتا023,1,100,104817700,1047690,1048177,1048177,487,0.05,1048177,487,0.05,1048177,1048177
ضسلا7004,اختيارخ سلام-10000-1402/07/19,1,4,12640000,3500,3160,3160,-340,-9.71,3160,-340,-9.71,3160,3160
اراد76,مرابحه عام دولت76-ش.خ030406,1,5000,5000000000,983000,1000000,1000000,17000,1.73,1000000,17000,1.73,1000000,1000000
اخزا821,اسنادخزانه-م21بودجه98-020906,1,400,327200000,829000,818000,818000,-11000,-1.33,818000,-11000,-1.33,818000,818000
ضهرم7009,اختيارخ اهرم-14000-1402/07/23,1,1000,3934000000,3995,3934,3934,-61,-1.53,3934,-61,-1.53,3934,3934
ضصاد1126,اختيارخ وبصادر-1600-1401/11/19,1,64,11520000,327,180,180,-147,-44.95,180,-147,-44.95,180,180
ضهاي3004,اختيارخ هاي وب-2583-1402/03/03,1,35,16048620,694,423,423,-271,-39.05,423,-271,-39.05,423,423
سمتا011,سلف موازي استاندارد سمتا011,1,10,99343100,9930590,9934310,9934310,3720,0.04,9934310,3720,0.04,9934310,9934310
نسب0201,آتي نفتاي سبك-1402/01/17,1,100,175050000,1750000,1750500,1750500,500,0.03,1750500,500,0.03,1750500,1750500
متا0201,آتي متانول-1402/01/17,1,100,90910000,909200,909100,909100,-100,-0.01,909100,-100,-0.01,909100,909100
ضفلا7023,اختيارخ فولاد-2150-1402/07/26,1,4,14000000,3318,3500,3500,182,5.49,3500,182,5.49,3500,3500
ضهرم7003,اختيارخ اهرم-8000-1402/07/23,1,3,24000000,8100,8000,8000,-100,-1.23,8000,-100,-1.23,8000,8000
ضكاريس200,اختيارخ كاريس-11000-14020205,1,5,35000000,1,7000,7000,6999,699900,7000,6999,699900,7000,7000
ضدي210,اختيارخ دي-950-14020217,1,10,1500000,150,150,150,0,0,150,0,0,150,150
ضكاريس206,اختيارخ كاريس-17000-14020205,1,200,318200000,2172,1591,1591,-581,-26.75,1591,-581,-26.75,1591,1591
ضفلا7025,اختيارخ فولاد-2813-1402/07/26,1,85,195415000,2499,2299,2299,-200,-8,2299,-200,-8,2299,2299
ضملي7020,اختيارخ فملي-1853-1402/07/05,1,1,4000000,4864,4000,4000,-864,-17.76,4000,-864,-17.76,4000,4000
ضصاد1129,اختيارخ وبصادر-1900-1401/11/19,1,5,350000,160,70,70,-90,-56.25,70,-90,-56.25,70,70
ضپلا1202,اختيارخ پالايش-56000-01/12/16,1,3,1710000,22897,57000,57000,34103,148.94,57000,34103,148.94,57000,57000
ضملي7023,اختيارخ فملي-2520-1402/07/05,1,1,4312000,4893,4312,4312,-581,-11.87,4312,-581,-11.87,4312,4312
طهرم7000,اختيارف اهرم-6500-1402/07/23,1,1,300000,224,300,300,76,33.93,300,76,33.93,300,300
ضخاور108,اختيارخ خاور-3100-14020116,1,2,1720000,1000,860,860,-140,-14,860,-140,-14,860,860
ثروت,ص.خ.ثروت آفرين فيروزه 85%تاديه,1,2000,1380000000,690000,690000,690000,0,0,690000,0,0,690000,690000
سمتا031,سلف موازي متانول مرجان 031,1,100,96739900,966971,967399,967399,428,0.04,967399,428,0.04,967399,967399
ضخود1115,اختيارخ خودرو-4000-1401/11/12,1,40,200000,79,5,5,-74,-93.67,5,-74,-93.67,5,5
اراد96,مرابحه عام دولت96-ش.خ030414,1,65000,60664500000,956900,933300,933300,-23600,-2.47,933300,-23600,-2.47,933300,933300
فولاد2,فولاد مباركه اصفهان,1,5000000,30500000000,6210,6100,6100,-110,-1.77,6100,-110,-1.77,6100,6100
كيمياتك2,آريان كيميا تك,1,36000000,451440000000,12540,12540,12540,0,0,12540,0,0,12540,12540
اراد1034,مرابحه عام دولت103-ش.خ050821,1,7111000,5753012330000,1020000,809030,809030,-210970,-20.68,809030,-210970,-20.68,809030,809030
ضكاريس202,اختيارخ كاريس-13000-14020205,1,5,25000000,2700,5000,5000,2300,85.19,5000,2300,85.19,5000,5000
ضترا3020,اختيارخ شتران-3000-1402/03/28,1,3,6300000,2250,2100,2100,-150,-6.67,2100,-150,-6.67,2100,2100
ضسلا7003,اختيارخ سلام-9000-1402/07/19,1,300,1041000000,3900,3470,3470,-430,-11.03,3470,-430,-11.03,3470,3470
گام020613,گواهي اعتبار مولد رفاه0206	,1,5000,4200000000,833000,840000,840000,7000,0.84,840000,7000,0.84,840000,840000
طستا1103,اختيارف شستا-800-1401/11/05,1,150,150000,5,1,1,-4,-80,1,-4,-80,1,1
فردا4,صندوق س آواي فرداي زاگرس-ثابت,1,52875108,798942881880,15098,15110,15110,12,0.08,15110,12,0.08,15110,15110
مارون2,پتروشيمي مارون,1,605731,107577825600,181500,177600,177600,-3900,-2.15,177600,-3900,-2.15,177600,177600
درسا2,صندوق سرمايه گذاري درسا - سهام,1,500000,500000,12450,1,1,-12449,-99.99,1,-12449,-99.99,1,1
تبريز0342,مشاركت ش تبريز034-3 ماهه 18%,1,299000,299000000000,1043356,1000000,1000000,-43356,-4.16,1000000,-43356,-4.16,1000000,1000000
ضستا0101,اختيارخ شستا-700-1402/01/09,1,1,397000,388,397,397,9,2.32,397,9,2.32,397,397
ضهرم7004,اختيارخ اهرم-9000-1402/07/23,1,3,21000000,7633,7000,7000,-633,-8.29,7000,-633,-8.29,7000,7000
سپنتا031,سلف موازي پنتان پتروكنگان031,1,100,198689200,1985840,1986892,1986892,1052,0.05,1986892,1052,0.05,1986892,1986892
سميعا002,سلف موازي استاندارد سميعا002,1,100,168679800,1678718,1686798,1686798,8080,0.48,1686798,8080,0.48,1686798,1686798
ضسلا1207,اختيارخ سلام-11000-1401/12/22,1,205,145550000,900,710,710,-190,-21.11,710,-190,-21.11,710,710
ضكاريس201,اختيارخ كاريس-12000-14020205,1,5,30000000,1,6000,6000,5999,599900,6000,5999,599900,6000,6000
كرماشا2,صنايع پتروشيمي كرمانشاه,1,977309,62088440770,64830,63530,63530,-1300,-2.01,63530,-1300,-2.01,63530,63530
اراد61,مرابحه عام دولت61-ش.خ0309,1,15000,15000000000,1000000,1000000,1000000,0,0,1000000,0,0,1000000,1000000
عقيق2,صندوق سرمايه گذاري عقيق-سهام,1,70000,70000,53320,1,1,-53319,-100,1,-53319,-100,1,1
صيبا503,صكوك مرابحه سيبا503-3ماهه 18%,1,5000,5100000000,1015000,1020000,1020000,5000,0.49,1020000,5000,0.49,1020000,1020000
ضفلا7020,اختيارخ فولاد-1653-1402/07/26,1,2,6000000,4000,3000,3000,-1000,-25,3000,-1000,-25,3000,3000
سمتا022,سلف موازي استاندارد سمتا022,1,100,104418800,1043702,1044188,1044188,486,0.05,1044188,486,0.05,1044188,1044188
اخزا0092,اسناد خزانه-م9بودجه00-031101,1,25,15400250,617750,616010,616010,-1740,-0.28,616010,-1740,-0.28,616010,616010
ياقوت2,صندوق س ياقوت آگاه-ثابت,1,200000,200000,16870,1,1,-16869,-99.99,1,-16869,-99.99,1,1
اخزا9142,اسنادخزانه-م14بودجه99-021025,1,51,39603540,799990,776540,776540,-23450,-2.93,776540,-23450,-2.93,776540,776540
اخزا9102,اسنادخزانه-م10بودجه99-020807,1,24,18967920,831920,790330,790330,-41590,-5,790330,-41590,-5,790330,790330
كمند4,صندوق س. با درآمد ثابت كمند,1,86654525,877290411100,10118,10124,10124,6,0.06,10124,6,0.06,10124,10124
اخزا906,اسنادخزانه-م6بودجه99-020321,1,100,91321000,914850,913210,913210,-1640,-0.18,913210,-1640,-0.18,913210,913210
پالايش2,صندوق پالايشي يكم-سهام,1,5200000,5200000,117100,1,1,-117099,-100,1,-117099,-100,1,1
پادا2,صندوق س.پاداش سرمايه پارس-س,1,20000,20000,129952,1,1,-129951,-100,1,-129951,-100,1,1
سمتا021,سلف موازي استاندارد سمتا021,1,100,104180800,1041324,1041808,1041808,484,0.05,1041808,484,0.05,1041808,1041808
كگل4,معدني و صنعتي گل گهر,1,511638835,4313115379050,8640,8430,8430,-210,-2.43,8430,-210,-2.43,8430,8430
ضصاد1125,اختيارخ وبصادر-1500-1401/11/19,1,50,17500000,388,350,350,-38,-9.79,350,-38,-9.79,350,350
ضهرم1200,اختيارخ اهرم-7000-1401/12/22,1,2,10222000,7420,5111,5111,-2309,-31.12,5111,-2309,-31.12,5111,5111
ضشنا1104,اختيارخ شپنا-6000-1401/11/19,1,1,1400000,1650,1400,1400,-250,-15.15,1400,-250,-15.15,1400,1400
ضستا0103,اختيارخ شستا-900-1402/01/09,1,20,3800000,194,190,190,-4,-2.06,190,-4,-2.06,190,190
شراز2,پالايش نفت شيراز,1,4600000,64860000000,14560,14100,14100,-460,-3.16,14100,-460,-3.16,14100,14100
اگ0204182,گام بانك تجارت0204,1,342000,299592000000,876000,876000,876000,0,0,876000,0,0,876000,876000
ماني4,صندوق س. با درآمد ثابت ماني,1,2235000,30011580000,13401,13428,13428,27,0.2,13428,27,0.2,13428,13428
ضجار2018,اختيارخ وتجارت-1100-1402/02/20,1,10,7900000,828,790,790,-38,-4.59,790,-38,-4.59,790,790
