نماد,نام,تعداد,حجم,ارزش,دیروز,اولین,آخرین معامله - مقدار,آخرین معامله - تغییر,آخرین معامله - درصد,قیمت پایانی - مقدار,قیمت پایانی - تغییر,قیمت پایانی - درصد,کمترین,بیشترین
خگستر,گسترش‌سرمايه‌گذاري‌ايران‌خودرو,23520,633224372,2848695934418,4757,4780,4469,-288,-6.05,4499,-258,-5.42,4425,4860
دي,بانك دي,22312,1077073463,946481241955,914,900,869,-45,-4.92,879,-35,-3.83,869,930
خودرو,ايران‌ خودرو,22085,934850049,3069888593698,3390,3480,3251,-139,-4.1,3284,-106,-3.13,3221,3490
شتران,پالايش نفت تهران,21896,567579638,2388370051941,4174,4240,4268,94,2.25,4208,34,0.81,4122,4284
پالايش,صندوق پالايشي يكم-سهام,21500,30057714,3531992910710,117230,120000,116700,-530,-0.45,117510,280,0.24,116520,120100
خساپا,سايپا,18825,1124443223,2718177137103,2540,2425,2418,-122,-4.8,2417,-123,-4.84,2413,2470
شستا,سرمايه گذاري تامين اجتماعي,17072,901527745,948073643148,1082,1094,1047,-35,-3.23,1052,-30,-2.77,1036,1095
كرمان,س. توسعه و عمران استان كرمان,16907,824242271,949027497428,1216,1225,1150,-66,-5.43,1151,-65,-5.35,1131,1230
شبندر,پالايش نفت بندرعباس,16861,221503155,2077027254180,9660,9740,9380,-280,-2.9,9380,-280,-2.9,9230,9740
فولاد,فولاد مباركه اصفهان,14448,257670035,1583039003060,6400,6190,6130,-270,-4.22,6140,-260,-4.06,6100,6310
كالا,بورس كالاي ايران,13888,80331518,1627135393860,21490,21500,20030,-1460,-6.79,20260,-1230,-5.72,19990,21840
شپنا,پالايش نفت اصفهان,13254,184186772,1415471302290,7880,7980,7670,-210,-2.66,7680,-200,-2.54,7480,7980
دارا يكم,صندوق واسطه گري مالي يكم-سهام,11909,16321094,1967190465370,120670,122000,119660,-1010,-0.84,120530,-140,-0.12,118910,122300
وتجارت,بانك تجارت,11781,450153264,839625299337,1925,1920,1850,-75,-3.9,1865,-60,-3.12,1826,1940
خاور,ايران خودرو ديزل,11371,422924190,1608132162694,3893,3956,3777,-116,-2.98,3802,-91,-2.34,3777,3959
وبملت,بانك ملت,10539,447800063,1618800012973,3608,3650,3590,-18,-0.5,3615,7,0.19,3550,3710
وساخت,سرمايه‌ گذاري‌ ساختمان‌ايران‌,9930,680136730,1106156047619,1546,1649,1654,108,6.99,1626,80,5.17,1572,1654
هماي,صندوق س هماي آگاه-ثابت,9759,224612636,2247671588939,10175,10007,10007,-168,-1.65,10007,-168,-1.65,10006,10008
تسه1401,امتيازتسهيلات مسكن سال1401,8626,350853,414862951040,1190412,1190000,1200000,9588,0.81,1182441,-7971,-0.67,1150001,1205000
خبهمن,گروه‌بهمن‌,8323,348335476,819415799162,2501,2460,2330,-171,-6.84,2352,-149,-5.96,2326,2500
فاذر,صنايع‌ آذرآب‌,8310,534934849,834904496376,1506,1490,1581,75,4.98,1561,55,3.65,1431,1581
طلا,صندوق س.پشتوانه طلاي لوتوس,8175,10869744,1721549933196,147483,156002,162231,14748,10,158380,10897,7.39,152000,162231
افران,صندوق س افرا نماد پايدار-ثابت,7986,219399406,4153519183047,18901,18931,18932,31,0.16,18931,30,0.16,18931,18932
فملي,ملي‌ صنايع‌ مس‌ ايران‌,7715,124578419,952023212680,7860,7800,7610,-250,-3.18,7640,-220,-2.8,7560,7840
كاما,باما,7710,106609900,1000660362440,8890,8870,9480,590,6.64,9390,500,5.62,8870,9510
فروژ,صنايع فروآلياژ ايران,7255,10628007,501110530050,44950,47150,47150,2200,4.89,47150,2200,4.89,47150,47150
وآذر,سرمايه‌گذاري‌توسعه‌آذربايجان‌,6885,7972989,1066378835190,130830,137370,129000,-1830,-1.4,133750,2920,2.23,127500,137370
فخوز,فولاد  خوزستان,6706,161158132,505102067877,3323,3228,3110,-213,-6.41,3134,-189,-5.69,3091,3228
اهرم,صندوق س سهامي كاريزما- اهرمي,6640,81726899,1169289719590,14710,14800,14210,-500,-3.4,14310,-400,-2.72,14070,14800
فرابورس,فرابورس ايران,6525,44862359,504304693140,11660,11790,11080,-580,-4.97,11240,-420,-3.6,10900,11870
سپيد,سپيد ماكيان,6498,29029916,592377895540,21860,20510,20430,-1430,-6.54,20410,-1450,-6.63,20330,21660
هاي وب,داده گسترعصرنوين-هاي وب,6443,205377254,551746096949,2781,2728,2660,-121,-4.35,2687,-94,-3.38,2647,2747
انرژي,بورس انرژي ايران,6267,11901603,517210037470,46100,44360,42880,-3220,-6.98,43460,-2640,-5.73,42880,46100
كمند,صندوق س. با درآمد ثابت كمند,6217,276037360,2787757369716,10082,10099,10100,18,0.18,10099,17,0.17,10099,10100
گدنا,تهيه توزيع غذاي دنا آفرين فدك,6116,58199257,654558476880,10530,11250,11260,730,6.93,11250,720,6.84,11050,11260
ارزش مسكن,ص.س.املاك ومستغلات ارزش مسكن,6082,3355108,38399717248,11478,11430,11580,102,0.89,11445,-33,-0.29,11300,11645
قچار,فراوردههاي غذايي وقند چهارمحال,5916,35066701,419762757580,12530,12580,11710,-820,-6.54,11970,-560,-4.47,11660,12580
وسپهر,سرمايه گذاري مالي سپهرصادرات,5909,48193846,446313788090,8670,9270,9270,600,6.92,9260,590,6.81,9000,9270
ولساپا,ليزينگ رايان‌ سايپا,5594,245444177,417719455871,1709,1710,1700,-9,-0.53,1702,-7,-0.41,1650,1760
شپديس,پتروشيمي پرديس,5552,4123487,652158653490,156380,159000,157120,740,0.47,158160,1780,1.14,156810,162000
سمگا,گروه سرمايه گذاري ميراث فرهنگي,5527,45619284,317149322610,7180,7080,6850,-330,-4.6,6950,-230,-3.2,6710,7290
پترول,گ.س.وت.ص.پتروشيمي خليج فارس,5487,160075154,393962112271,2547,2618,2430,-117,-4.59,2461,-86,-3.38,2375,2618
كگل,معدني و صنعتي گل گهر,5476,45644107,400645036160,9010,9150,8730,-280,-3.11,8780,-230,-2.55,8500,9160
وپاسار,بانك  پاسارگاد,5412,70560597,400004744900,5890,5880,5560,-330,-5.6,5670,-220,-3.74,5500,5880
وساپا,سرمايه‌گذاري‌ سايپا,5336,120530092,735211914820,6470,6490,6020,-450,-6.96,6100,-370,-5.72,6020,6500
عيار,صندوق طلاي عيار مفيد,5172,8158544,522839099422,59529,62350,65481,5952,10,64085,4556,7.65,62350,65481
وبصادر,بانك صادرات ايران,5170,310713117,602405898056,1971,1920,1940,-31,-1.57,1939,-32,-1.62,1880,2044
وخارزم,سرمايه گذاري خوارزمي,5003,111805794,510080414109,4686,4700,4523,-163,-3.48,4562,-124,-2.65,4484,4740
ثاميد,توسعه و عمران اميد,4999,49951518,93268806643,1899,1889,1844,-55,-2.9,1867,-32,-1.69,1835,1940
تليسه,دامداري تليسه نمونه,4987,65945830,275893227966,4411,4405,4103,-308,-6.98,4184,-227,-5.15,4103,4449
سامان,بانك سامان,4939,244801982,685986737222,2722,2803,2803,81,2.98,2802,80,2.94,2776,2803
شيراز,پتروشيمي‌شيراز,4830,17538128,1415915315840,75480,80760,80760,5280,7,80730,5250,6.96,79880,80760
غزر,صنعتي زر ماكارون,4826,64509748,267767216140,4134,4200,4122,-12,-0.29,4151,17,0.41,4068,4245
بگيلان,توسعه مسير برق گيلان,4785,12070139,174772072390,14610,14530,14110,-500,-3.42,14480,-130,-0.89,13980,14900
غنوش,نوش‌ مازندران‌,4613,28813918,286754486690,9980,10110,9780,-200,-2,9950,-30,-0.3,9640,10320
ورنا,سرمايه‌گذاري‌ رنا(هلدينگ‌,4591,65477998,450600892170,7180,7160,6760,-420,-5.85,6880,-300,-4.18,6690,7270
اعتماد,صندوق س.اعتماد آفرين پارسيان-د,4560,70371236,3596631768392,51050,51109,51110,60,0.12,51109,59,0.12,51109,51112
نوري,پتروشيمي نوري,4472,7899114,835912795880,111360,105800,105800,-5560,-4.99,105820,-5540,-4.97,105800,106800
دانا,بيمه دانا,4440,133303925,420928557037,3214,3220,3094,-120,-3.73,3158,-56,-1.74,3085,3230
غگل,گلوكوزان‌,4366,48507413,303846801900,6270,6220,6310,40,0.64,6260,-10,-0.16,6010,6510
ومعادن,توسعه‌معادن‌وفلزات‌,4340,44393899,231071371300,5360,5300,5120,-240,-4.48,5210,-150,-2.8,5070,5350
آريا,پليمر آريا ساسول,4300,3179794,246399635350,79650,78950,77050,-2600,-3.26,77500,-2150,-2.7,76250,79500
شپلي,پلي اكريل ايران,4156,50551661,565036517220,11210,11450,10880,-330,-2.94,11180,-30,-0.27,10880,11540
بورس,بورس اوراق بهادار تهران,4133,40027806,273309377480,7060,7070,6760,-300,-4.25,6830,-230,-3.26,6650,7100
ميدكو,توسعه معادن وص.معدني خاورميانه,4110,18710704,235179365750,12950,12810,12380,-570,-4.4,12570,-380,-2.93,12310,13210
خكاوه,سايپا ديزل,4005,42579408,864817914050,19890,20480,19820,-70,-0.35,20310,420,2.11,19300,20480
ولبهمن,شركت بهمن ليزينگ,3987,64210189,193673244214,3181,3182,2984,-197,-6.19,3016,-165,-5.19,2959,3182
بركت,گروه دارويي بركت,3973,17384356,232325448060,13730,13590,13120,-610,-4.44,13360,-370,-2.69,12950,13930
شبريز,پالايش نفت تبريز,3938,17226991,287841588790,17010,17200,16600,-410,-2.41,16710,-300,-1.76,16170,17280
خكرمان,سرمايه گذاري آرمان گستر پاريز,3910,145452706,722964563389,4833,4977,4977,144,2.98,4970,137,2.83,4863,4977
اسياتك,انتقال داده هاي آسياتك,3854,10850716,186404194550,17060,17240,17180,120,0.7,17180,120,0.7,16900,17550
كارا,صندوق س. كارا -د,3782,352355006,4639055200918,13145,13152,13168,23,0.17,13166,21,0.16,13151,13168
كيان,صندوق س. با درآمد ثابت كيان,3776,34823799,1390613454973,39877,39934,39932,55,0.14,39933,56,0.14,39932,39935
قثابت,قند ثابت‌ خراسان‌,3770,141711354,403242789720,2767,2905,2775,8,0.29,2846,79,2.86,2753,2905
اخابر,مخابرات ايران,3763,58920068,464195032760,8370,8300,7800,-570,-6.81,7880,-490,-5.85,7790,8330
خنصير,مهندسي‌نصيرماشين‌,3752,32242574,533629992020,15590,16380,16680,1090,6.99,16550,960,6.16,15830,16680
خمحركه,نيرو محركه‌,3682,39789896,246691582200,6250,6400,6230,-20,-0.32,6200,-50,-0.8,5970,6490
استقلال,استقلال,3677,13471497,28509346642,2080,2086,2117,37,1.78,2116,36,1.73,2086,2121
توان,صندوق س. اهرمي توان مفيد-س,3612,30225854,367936338798,12395,12428,12250,-145,-1.17,12173,-222,-1.79,12075,12489
شگويا,پتروشيمي تندگويان,3608,58867506,709730115250,12660,12290,12030,-630,-4.98,12060,-600,-4.74,12030,12390
فزر,پويا زركان آق دره,3518,17416874,590924503850,32300,32900,34550,2250,6.97,33950,1650,5.11,32300,34550
ياقوت,صندوق س ياقوت آگاه-ثابت,3449,28784890,484418297737,16824,16829,16832,8,0.05,16829,5,0.03,16828,16840
بوعلي,پتروشيمي بوعلي سينا,3427,6602945,224472691440,33700,32850,34040,340,1.01,34000,300,0.89,32850,34700
غسالم,سالمين‌,3401,54945225,260770254390,4766,4880,4670,-96,-2.01,4746,-20,-0.42,4500,5080
كدما,معدني‌ دماوند,3391,3113326,193322456990,64060,65000,60860,-3200,-5,62100,-1960,-3.06,60860,66300
ثبهساز,بهساز كاشانه تهران,3385,26821743,54997333236,2101,2159,2031,-70,-3.33,2050,-51,-2.43,1996,2159
ماديرا,صنايع ماديران,3354,140955196,550648848602,3759,3750,3946,187,4.97,3907,148,3.94,3650,3946
آگاس,صندوق س.هستي بخش آگاه-س,3335,5847842,579777703877,100504,100266,99095,-1409,-1.4,99144,-1360,-1.35,98600,100796
امين يكم,صندوق درآمد ثابت امين يكم فردا,3238,80835064,796624422816,10079,9900,9815,-264,-2.62,9855,-224,-2.22,9725,9979
چكاپا,گروه صنايع كاغذ پارس,3216,49423437,151691666299,3157,3145,3006,-151,-4.78,3069,-88,-2.79,3000,3180
وكبهمن,مديريت سرمايه گذاري كوثربهمن,3205,19214961,64204164528,3395,3399,3264,-131,-3.86,3341,-54,-1.59,3222,3480
ديران,ايران‌دارو,3205,14423252,224074308070,16110,16150,15310,-800,-4.97,15540,-570,-3.54,15310,16490
زبينا,كشاورزي و دامپروري بينالود,3167,61328583,228352189765,3906,3812,3750,-156,-3.99,3723,-183,-4.69,3633,3915
مديريت,س. و خدمات مديريت صند. ب كشوري,3167,25651272,106066718477,4060,4080,4117,57,1.4,4135,75,1.85,4080,4231
توسن,توسعه سامانه ي نرم افزاري نگين,3101,7818284,122797208070,16640,17070,15480,-1160,-6.97,15710,-930,-5.59,15480,17070
غگيلا,شيرپاستوريزه پگاه گيلان,3082,8998030,228207091800,24500,24950,26200,1700,6.94,25350,850,3.47,23500,26200
ختوقا,قطعات‌ اتومبيل‌ ايران‌,3035,45551891,221735655540,5043,5150,4800,-243,-4.82,4870,-173,-3.43,4700,5160
سآبيك,سيمان آبيك,2998,4014863,56668525300,14360,14280,14280,-80,-0.56,14110,-250,-1.74,13950,14340
شلرد,كود شيميايي اوره لردگان,2974,27616349,249756501260,9290,9050,9020,-270,-2.91,9040,-250,-2.69,9020,9260
گوهر,صندوق سكه طلاي كيان,2946,5216927,560518103328,102055,105030,111251,9196,9.01,107442,5387,5.28,102701,111790
گكوثر,هتل پارسيان كوثر اصفهان,2933,94578458,235998796267,2495,2590,2455,-40,-1.6,2495,0,0,2375,2590
غدشت,دشت‌ مرغاب‌,2920,6339794,243022551900,36940,37500,38780,1840,4.98,38330,1390,3.76,37020,38780
فسرب,ملي‌ سرب‌وروي‌ ايران‌,2805,95037414,188821668281,1972,2009,2004,32,1.62,1987,15,0.76,1940,2050
ددانا,داروسازي دانا,2792,3251066,118336218200,36750,36650,36750,0,0,36400,-350,-0.95,35250,37100
ثشاهد,سرمايه‌ گذاري‌ شاهد,2683,17752679,176165868350,9920,10110,9780,-140,-1.41,9920,0,0,9500,10240
غپينو,پارس‌ مينو,2652,44311346,157604206847,3723,3744,3537,-186,-5,3557,-166,-4.46,3470,3780
شسينا,صنايع‌شيميايي‌سينا,2642,51101838,125733881691,2486,2632,2398,-88,-3.54,2460,-26,-1.05,2350,2633
شاروم,پتروشيمي اروميه,2612,3505118,70158698650,20400,20400,20000,-400,-1.96,20000,-400,-1.96,19500,20800
حآسا,آسيا سير ارس,2595,17741150,193164500440,10650,10910,11390,740,6.95,10890,240,2.25,9950,11390
پارتا,مجتمع صنعتي آرتاويل تاير,2586,15733054,140036087080,8890,8450,9160,270,3.04,8900,10,0.11,8450,9320
نوين,بيمه نوين,2583,71411961,142801449798,2099,2100,1960,-139,-6.62,2000,-99,-4.72,1953,2144
فتوسا,توليد و توسعه سرب روي ايرانيان,2579,20692605,154509750010,7020,7300,7510,490,6.98,7470,450,6.41,7250,7510
ثالوند,سرمايه گذاري مسكن الوند,2578,23691588,278527770640,11140,11900,11860,720,6.46,11760,620,5.57,11270,11910
وپويا,سرمايه گذاري پويا,2567,74131300,202191553494,2723,2800,2662,-61,-2.24,2727,4,0.15,2662,2846
لكما,كارخانجات‌مخابراتي‌ايران‌,2554,118445982,145366767994,1239,1276,1202,-37,-2.99,1227,-12,-0.97,1202,1276
كيمياتك,آريان كيميا تك,2538,26085889,344672230240,12620,12700,13250,630,4.99,13210,590,4.68,12620,13250
سدبير,س. تدبيرگران فارس وخوزستان,2533,7360393,222341912100,28550,30450,30500,1950,6.83,30200,1650,5.78,28000,30500
غديس,پاكديس,2505,19627317,362611085990,19380,18420,18510,-870,-4.49,18470,-910,-4.7,18030,19380
فروي,ذوب روي اصفهان,2494,8527068,135672927340,15920,16300,15650,-270,-1.7,15910,-10,-0.06,15300,16740
خمهر,مهركام‌پارس‌,2462,78526347,214602586865,2863,2890,2720,-143,-4.99,2733,-130,-4.54,2720,2890
شاوان,پالايش نفت لاوان,2424,15799042,329064185650,21400,21500,20850,-550,-2.57,20850,-550,-2.57,20400,21500
وگردش,بانك گردشگري,2423,22225948,181612508350,8060,8290,8090,30,0.37,8170,110,1.36,7890,8300
خاذين,سايپاآذين‌,2406,60364255,160667122856,2784,2750,2645,-139,-4.99,2662,-122,-4.38,2645,2790
بكام,كارخانجات توليدي شهيد قندي,2402,58795849,157202535215,2622,2480,2649,27,1.03,2674,52,1.98,2439,2778
مثقال,صندوق س.پشتوانه طلاي زرين آگاه,2395,15228664,291362266336,17620,18711,19382,1762,10,19132,1512,8.58,18711,19382
وصنعت,سرمايه گذاري توسعه صنعت وتجارت,2382,41102267,87954345902,2281,2181,2122,-159,-6.97,2140,-141,-6.18,2122,2260
وغدير,سرمايه‌گذاري‌غدير(هلدينگ‌,2381,15673557,289504863770,18810,18700,18400,-410,-2.18,18470,-340,-1.81,18290,18890
پلاست,كارخانجات توليدي پلاستيران,2379,26312280,314797945530,11910,12260,11560,-350,-2.94,11960,50,0.42,11560,12260
زقيام,كشت و دام قيام اصفهان,2378,48258956,127686922045,2799,2800,2605,-194,-6.93,2646,-153,-5.47,2604,2800
فاسمين,كالسيمين‌,2371,9787685,243977307570,25440,25900,25000,-440,-1.73,24930,-510,-2,24500,25940
چدن,توليدي چدن سازان,2362,34803943,88130750585,2641,2640,2465,-176,-6.66,2532,-109,-4.13,2460,2704
چكارن,كارتن‌ ايران‌,2352,62983635,251951849675,4094,4160,4000,-94,-2.3,4000,-94,-2.3,3890,4250
ثنور,سرمايه گذاري كوه نور,2350,18469069,137505185340,7650,7470,7430,-220,-2.88,7450,-200,-2.61,7430,7600
ضسپا1211,اختيارخ خساپا-3250-1401/12/10,2341,912916,90606141000,137,110,94,-43,-31.39,99,-38,-27.74,85,125
زشگزا,شير و گوشت زاگرس شهركرد,2324,30201109,202084254060,7060,7110,6630,-430,-6.09,6690,-370,-5.24,6570,7150
ثرود,سرمايه‌گذاري مسكن زاينده رود,2324,22715896,252749042320,10530,10450,11260,730,6.93,11130,600,5.7,10450,11260
تپكو,توليدتجهيزات‌سنگين‌هپكو,2323,126720625,206164120182,1580,1627,1627,47,2.97,1627,47,2.97,1601,1627
وپارس,بانك‌پارسيان‌,2313,110395306,223190000588,2112,2098,2010,-102,-4.83,2022,-90,-4.26,2007,2098
فارس,صنايع پتروشيمي خليج فارس,2308,46080253,428852633320,9350,9220,9420,70,0.75,9310,-40,-0.43,9090,9420
آبادا,توليد نيروي برق آبادان,2273,4104311,48894813390,11890,11890,11630,-260,-2.19,11910,20,0.17,11580,12150
وطوبي,سرمايه گذاري اقتصاد شهر طوبي,2260,62460393,139846835881,2394,2310,2227,-167,-6.98,2239,-155,-6.47,2227,2387
خودكفا,اقتصادي و خودكفايي آزادگان,2235,29328901,229238196450,7640,7660,7660,20,0.26,7820,180,2.36,7640,7860
شفن,پتروشيمي فناوران,2216,23083190,138107583750,6140,6160,5950,-190,-3.09,5980,-160,-2.61,5870,6200
غصينو,صنعتي مينو,2206,10423254,137314576030,12700,13200,13090,390,3.07,13170,470,3.7,12940,13330
اردستان,سيمان اردستان,2201,326105,3424102500,10000,10500,10500,500,5,10010,10,0.1,10500,10500
سكه مركزي,سلف تمام سكه 001 مركزي,2153,468000,1015939477400,2084315,2175000,2188530,104215,5,2170811,86496,4.15,2130010,2188530
غبشهر,صنعتي‌ بهشهر,2152,48097894,145567210801,3048,3100,3027,-21,-0.69,3026,-22,-0.72,2985,3119
زملارد,كشاورزي و دامپروري ملارد شير,2150,1747472,23887017780,13700,13710,13450,-250,-1.82,13670,-30,-0.22,13220,14090
وبانك,سرمايه گذاري گروه توسعه ملي,2129,20593939,220639535610,10980,10950,10660,-320,-2.91,10710,-270,-2.46,10600,11000
كمرجان,بازرگاني و توليدي مرجان كار,2127,10713446,97807984230,9020,9390,9000,-20,-0.22,9130,110,1.22,8800,9480
درازك,دارويي‌ رازك‌,2110,11457245,187595369230,17130,17580,16280,-850,-4.96,16370,-760,-4.44,16280,17580
غكورش,صنعت غذايي كورش,2089,11219187,112638463930,10330,10400,9990,-340,-3.29,10040,-290,-2.81,9820,10400
رافزا,رايان هم افزا,2083,1811896,118320249550,65200,67200,65700,500,0.77,65300,100,0.15,63750,68000
غويتا,ويتانا,2082,20929313,117616692920,5720,5820,5550,-170,-2.97,5620,-100,-1.75,5400,6000
پتاير,ايران‌ تاير,2069,63889485,98860768849,1623,1630,1526,-97,-5.98,1547,-76,-4.68,1510,1638
كسرا,سراميك‌هاي‌صنعتي‌اردكان‌,2052,28642457,174327436300,6440,6400,5990,-450,-6.99,6090,-350,-5.43,5990,6550
فجهان,مجتمع جهان فولاد سيرجان,2032,10264240,32696239055,3261,3290,3221,-40,-1.23,3231,-30,-0.92,3150,3290
بپيوند,برق و انرژي پيوندگستر پارس,2026,2370397,27292221660,11850,11740,11330,-520,-4.39,11510,-340,-2.87,11280,11860
همراه,شركت ارتباطات سيار ايران,2017,22987617,194229444480,8790,8690,8360,-430,-4.89,8450,-340,-3.87,8360,8770
كرازي,كارخانجات‌توليدي‌شيشه‌رازي‌,2017,53970258,82593802901,1581,1564,1525,-56,-3.54,1530,-51,-3.23,1514,1600
سيتا,سرمايه گذاري سيمان تامين,2011,3350944,37320048830,11210,11200,11120,-90,-0.8,11150,-60,-0.54,10980,11350
دفارا,داروسازي‌ فارابي‌,2001,40722071,871452169400,20390,21400,21400,1010,4.95,21400,1010,4.95,20900,21400
خلنت,لنت‌ ترمزايران‌,1990,3247826,117201618350,36540,37950,35330,-1210,-3.31,36090,-450,-1.23,34720,38360
ثغرب,شركت سرمايه گذاري مسكن شمالغرب,1989,13608489,108656617890,7960,8190,7800,-160,-2.01,7980,20,0.25,7740,8190
چخزر,صنايع چوب خزر كاسپين,1983,1076908,38080317500,35850,36800,35000,-850,-2.37,35350,-500,-1.39,34550,36800
فگستر,گسترش صنايع روي ايرانيان,1972,11514148,87310306170,7840,7840,7600,-240,-3.06,7580,-260,-3.32,7390,7850
حريل,ريل پردازسير,1970,28518110,106698830299,3991,4070,3712,-279,-6.99,3741,-250,-6.26,3712,4070
خصدرا,صنعتي‌ دريايي‌ ايران‌,1966,62486493,144464819286,2368,2306,2297,-71,-3,2312,-56,-2.36,2297,2363
كلر,كلر پارس,1966,1836269,162163277100,92400,92100,88000,-4400,-4.76,88300,-4100,-4.44,86200,94100
لپارس,پارس‌ الكتريك‌,1960,1549279,125430006630,83830,83000,79640,-4190,-5,80960,-2870,-3.42,79640,84880
حكشتي,كشتيراني جمهوري اسلامي ايران,1945,9968565,289178481730,30440,29210,28920,-1520,-4.99,29010,-1430,-4.7,28920,29950
كي بي سي,شركت كي بي سي,1928,11428640,146828850590,13180,12800,12710,-470,-3.57,12850,-330,-2.5,12530,13400
تپسي,پيشگامان فن آوري و دانش آراميس,1925,34517786,177654322880,5041,5290,5080,39,0.77,5150,109,2.16,4910,5290
صبا,گروه مالي صبا تامين,1893,27642612,106795760606,4002,3999,3837,-165,-4.12,3874,-128,-3.2,3821,3999
پارس,پتروشيمي پارس,1884,57929270,139488403798,2467,2450,2415,-52,-2.11,2408,-59,-2.39,2372,2450
شاراك,پتروشيمي شازند,1882,5136510,167923212870,34160,33800,32600,-1560,-4.57,32690,-1470,-4.3,31770,33800
بجهرم,توسعه مولد نيروگاهي جهرم,1881,51586985,117642951702,2313,2314,2240,-73,-3.16,2280,-33,-1.43,2230,2329
كوير,توليدي فولاد سپيد فراب كوير,1880,51771483,180335522477,3627,3540,3446,-181,-4.99,3483,-144,-3.97,3446,3600
فباهنر,مس‌ شهيدباهنر,1850,6927287,218874595880,32530,32400,31990,-540,-1.66,31600,-930,-2.86,31000,32500
سشرق,سيمان‌ شرق‌,1845,12642785,127837333630,10400,10550,10000,-400,-3.85,10110,-290,-2.79,9820,10790
نهال,صندوق س. طلاي سرخ نوويرا,1844,10874703,156221707524,14161,14230,14453,292,2.06,14366,205,1.45,14172,14540
آكورد,صندوق س. آرمان آتي كوثر-د,1838,12177169,543446358311,44562,44628,44629,67,0.15,44628,66,0.15,44628,44629
خكار,ايركا پارت صنعت,1834,44907646,138400870953,3097,3100,3073,-24,-0.77,3082,-15,-0.48,2990,3174
شسپا,نفت سپاهان,1814,19338499,79446658373,4213,4240,4097,-116,-2.75,4123,-90,-2.14,4012,4240
ولصنم,ليزينگ‌صنعت‌ومعدن‌,1794,48399234,244689974447,4830,4871,4984,154,3.19,5056,226,4.68,4871,5168
ونوين,بانك‌اقتصادنوين‌,1791,45599236,168231015422,3736,3780,3689,-47,-1.26,3689,-47,-1.26,3640,3796
حفاري,حفاري شمال,1785,17700711,79332143786,4646,4563,4420,-226,-4.86,4482,-164,-3.53,4419,4592
افق,فروشگاههاي زنجيره اي افق كوروش,1780,16565019,251038250480,15730,15450,14950,-780,-4.96,15150,-580,-3.69,14950,15700
سپيدار,سپيدار سيستم آسيا,1771,552465,14349016600,26450,27200,25850,-600,-2.27,25950,-500,-1.89,25400,27200
آسيا,بيمه آسيا,1757,64079272,126315319070,2108,2110,1961,-147,-6.97,1971,-137,-6.5,1961,2110
دتوليد,داروسازي توليد دارو,1739,8550452,88871173070,10160,10380,10370,210,2.07,10390,230,2.26,10100,10700
توريل,توكاريل,1739,17788716,189901530570,10250,10760,10260,10,0.1,10680,430,4.2,9900,10760
خپويش,سازه‌ پويش‌,1735,13802773,279950230020,19330,19950,20290,960,4.97,20280,950,4.91,19950,20290
تاپكيش,تجارت الكترونيك پارسيان كيش,1734,13105909,130116359530,9380,9700,9990,610,6.5,9930,550,5.86,9180,10030
سيمرغ,سيمرغ,1734,4875342,127281559770,27560,28070,26030,-1530,-5.55,26110,-1450,-5.26,25690,28070
شيران,س. صنايع‌شيميايي‌ايران,1726,12137407,128949202450,10980,11000,10550,-430,-3.92,10620,-360,-3.28,10380,11350
ختور,رادياتور ايران‌,1716,14717761,91833048030,6320,6350,6130,-190,-3.01,6240,-80,-1.27,6050,6440
فولاي,صنايع فولاد آلياژي يزد,1706,38756642,202792275510,4810,5180,5310,500,10.4,5232,422,8.77,5100,5400
وهامون,سرمايه گذاري هامون صبا,1702,17070359,38228208203,2306,2340,2196,-110,-4.77,2239,-67,-2.91,2181,2340
فجوش,جوش‌ و اكسيژن‌ ايران‌,1700,48974211,117348505409,2468,2394,2394,-74,-3,2396,-72,-2.92,2394,2437
قاسم,قاسم ايران,1700,34608362,256868398900,7450,7570,7410,-40,-0.54,7420,-30,-0.4,7080,7620
بساما,بيمه سامان,1697,9059334,103735546510,11390,11160,11670,280,2.46,11450,60,0.53,10910,11800
كچاد,معدني‌وصنعتي‌چادرملو,1692,10048790,118361746790,12170,11930,11820,-350,-2.88,11780,-390,-3.2,11660,11980
خشرق,الكتريك‌ خودرو شرق‌,1681,10357939,183760118110,16940,17400,17780,840,4.96,17740,800,4.72,17100,17780
غپآذر,شير پگاه آذربايجان شرقي,1651,3318733,147741180650,42050,42000,44950,2900,6.9,44500,2450,5.83,42000,44950
فسوژ,سوژميران,1641,5048180,101067453420,19920,21290,19370,-550,-2.76,20020,100,0.5,19190,21310
قرن,پديده شيمي قرن,1637,3820981,78276095290,20760,20800,20260,-500,-2.41,20490,-270,-1.3,20210,20920
زكوثر,سرمايه گذاري كشاورزي كوثر,1631,5691390,93930201740,16310,16220,16290,-20,-0.12,16500,190,1.16,16210,16900
اپال,فرآوري معدني اپال كاني پارس,1621,4600987,80111541350,17600,17700,17290,-310,-1.76,17470,-130,-0.74,17200,17780
آريان,سرمايه گذاري پارس آريان,1614,26182097,117850832441,4594,4593,4457,-137,-2.98,4501,-93,-2.02,4457,4663
ولپارس,ليزينگ پارسيان,1611,4979107,21346102771,4519,4589,4203,-316,-6.99,4287,-232,-5.13,4203,4589
كاوه,فولاد كاوه جنوب كيش,1609,7415120,56475602820,7860,7750,7660,-200,-2.54,7720,-140,-1.78,7500,7800
حسير,ريل سير كوثر,1608,4999837,130376031600,27750,26850,26000,-1750,-6.31,26100,-1650,-5.95,25850,27300
تشتاد,صنايع توليدي اشتاد ايران‌,1608,17487360,100182456710,5680,5770,5850,170,2.99,5730,50,0.88,5510,5850
حفارس,حمل و نقل بين المللي خليج فارس,1607,14144970,217497395100,15670,16040,15400,-270,-1.72,15380,-290,-1.85,15080,16100
حبندر,دريايي و کشتيراني خط دريابندر,1597,3572116,52881955000,15160,15100,14710,-450,-2.97,14800,-360,-2.37,14710,15300
پيزد,مجتمع صنايع لاستيك يزد,1586,5769950,83406635940,13900,14170,14590,690,4.96,14460,560,4.03,13680,14590
ولغدر,ليزينگ‌خودروغدير,1576,25630193,110268136185,4579,4502,4259,-320,-6.99,4302,-277,-6.05,4259,4635
كزغال,زغال سنگ پروده طبس,1566,2785008,56163458750,20500,20900,20000,-500,-2.44,20150,-350,-1.71,19750,21000
حتوكا,حمل‌ونقل‌توكا,1566,9479077,72371316160,7650,7740,7800,150,1.96,7630,-20,-0.26,7400,7840
غالبر,لبنيات‌ كالبر,1556,5459924,141847502680,26850,26550,26440,-410,-1.53,25980,-870,-3.24,25510,27980
شبهرن,نفت‌ بهران‌,1552,6036689,120482604900,20220,20060,20240,20,0.1,19960,-260,-1.29,19620,20250
كگاز,شيشه‌ و گاز,1546,17268108,262733193090,14520,15240,15240,720,4.96,15210,690,4.75,14960,15240
قشكر,شكرشاهرود,1539,35826277,88954379408,2396,2497,2480,84,3.51,2483,87,3.63,2405,2515
شتوكا,توكا رنگ فولاد سپاهان,1538,12155734,211950276220,16340,17000,17480,1140,6.98,17440,1100,6.73,16400,17480
خفنر,فنرسازي‌خاور,1537,7484574,92877180660,13200,13100,12280,-920,-6.97,12410,-790,-5.98,12280,13430
خزر,فنرسازي‌زر,1528,15132327,81522214200,5530,5460,5290,-240,-4.34,5390,-140,-2.53,5200,5680
فسبزوار,پارس فولاد سبزوار,1522,1682091,40544184660,24630,24380,24140,-490,-1.99,24100,-530,-2.15,23690,24620
كهربا,صندوق س.پشتوانه سكه طلا كهربا,1518,14345503,283322506116,18382,19300,20220,1838,10,19750,1368,7.44,18901,20220
زر,صندوق س.پشتوانه سكه طلاي زر,1513,963254,95645796893,92672,95499,101815,9143,9.87,99294,6622,7.15,95499,101816
قشير,قند شيروان قوچان و بجنورد,1510,16970075,148911123830,8230,8700,8800,570,6.93,8770,540,6.56,8380,8800
آپ,آسان پرداخت پرشين,1504,11875604,86927218180,7510,7620,7280,-230,-3.06,7320,-190,-2.53,7190,7650
ولشرق,ليزينگ ايران و شرق,1497,20149637,73446440192,3835,3780,3567,-268,-6.99,3645,-190,-4.95,3567,3890
كرماشا,صنايع پتروشيمي كرمانشاه,1494,2198015,141707830390,62430,64370,63950,1520,2.43,64470,2040,3.27,63680,64970
شراز,پالايش نفت شيراز,1493,7074663,105568610750,15390,15490,14880,-510,-3.31,14920,-470,-3.05,14680,15490
كمينا,شيشه سازي مينا,1489,15078593,153771042920,10180,10480,10000,-180,-1.77,10200,20,0.2,9880,10480
بموتو,موتوژن‌,1483,16015309,47057257955,3094,3022,2916,-178,-5.75,2938,-156,-5.04,2880,3155
ضخود1205,اختيارخ خودرو-2000-1401/12/03,1475,194022,246050581000,1405,1406,1189,-216,-15.37,1268,-137,-9.75,1175,1498
سكرد,سيمان كردستان,1470,10394429,80267212430,7530,7650,7640,110,1.46,7720,190,2.52,7550,7900
فجر,فولاد اميركبيركاشان,1460,11825636,180321077240,16160,15990,15320,-840,-5.2,15250,-910,-5.63,15100,15990
غاذر,كشت‌وصنعت‌پياذر,1444,2364792,108270334210,45470,45400,45160,-310,-0.68,45780,310,0.68,44500,46700
ختراك,ريخته‌گري‌ تراكتورسازي‌ ايران‌,1440,15234553,216732711390,13790,14040,14470,680,4.93,14230,440,3.19,13720,14470
لبخند,صندوق س. لبخند فارابي-د,1438,100278817,1092387954630,10880,10893,10894,14,0.13,10894,14,0.13,10893,10894
ثعمرا,عمران و توسعه شاهد,1434,27179884,288202536570,9960,10650,10650,690,6.93,10600,640,6.43,10400,10650
خموتور,موتورسازان‌تراكتورسازي‌ايران‌,1424,17232290,121257616280,7050,7140,7190,140,1.99,7040,-10,-0.14,6750,7250
لطيف,محصولات كاغذي لطيف,1422,599447,35484185900,56250,58000,59500,3250,5.78,59200,2950,5.24,57100,60150
ثمسكن,سرمايه‌گذاري‌ مسكن‌,1410,41806247,190165905955,4848,4789,4509,-339,-6.99,4549,-299,-6.17,4509,4825
رتاپ,تجارت الكترونيك  پارسيان,1409,15653641,48865131237,3256,3313,3100,-156,-4.79,3122,-134,-4.12,3055,3313
البرز,بيمه البرز,1399,51478088,108856153216,2114,2119,2117,3,0.14,2115,1,0.05,2052,2193
حپترو,حمل و نقل پتروشيمي( سهامي عام,1390,2412694,99341059080,40140,41000,40160,20,0.05,41170,1030,2.57,39530,42140
غشهداب,كشت و صنعت شهداب ناب خراسان,1384,29772120,65850210927,2283,2262,2207,-76,-3.33,2212,-71,-3.11,2161,2290
سحرخيز,صندوق س. گروه زعفران سحرخيز,1365,6469025,128683367070,19739,19909,20090,351,1.78,19892,153,0.78,19675,20160
سبزوا,سيمان لار سبزوار,1362,18353707,98946919710,5760,5630,5380,-380,-6.6,5390,-370,-6.42,5360,5630
شفارس,صنايع‌ شيميايي‌ فارس‌,1361,40684306,57686922569,1425,1470,1404,-21,-1.47,1418,-7,-0.49,1381,1480
بپاس,بيمه پاسارگاد,1358,6269356,123040008250,20100,20000,19650,-450,-2.24,19650,-450,-2.24,19450,20000
پرسپوليس,پرسپوليس,1358,2780774,7008327781,2484,2533,2499,15,0.6,2508,24,0.97,2445,2533
قنيشا,قند  نيشابور,1352,23697390,69454588073,2952,3047,2876,-76,-2.57,2931,-21,-0.71,2850,3047
كماسه,تامين‌ ماسه‌ ريخته‌گري‌,1346,20971605,99113022352,4754,4910,4788,34,0.72,4726,-28,-0.59,4451,4910
وبوعلي,سرمايه‌گذاري‌بوعلي‌,1345,21152239,58939705847,2711,2900,2737,26,0.96,2786,75,2.77,2703,2900
دسانكو,داروسازي سبحان انكولوژي,1344,9616971,67987756990,7430,7480,7020,-410,-5.52,7070,-360,-4.85,6910,7490
شلعاب,لعابيران‌,1337,9390127,67801007740,7340,7350,7070,-270,-3.68,7220,-120,-1.63,7050,7510
فنورد,نوردوقطعات‌ فولادي‌,1336,6437008,102298200260,16470,16420,16010,-460,-2.79,15890,-580,-3.52,15650,16420
اتكاسا,بيمه اتكايي سامان,1333,5715545,24388916418,4234,4327,4210,-24,-0.57,4267,33,0.78,4193,4328
وسينا,بانك سينا,1329,70507460,219340135383,3293,3105,3119,-174,-5.28,3111,-182,-5.53,3063,3280
غمينو,شركت صنايع غذايي مينو شرق,1321,11651058,99537819590,8590,8700,8400,-190,-2.21,8540,-50,-0.58,8290,8900
بفجر,فجر انرژي خليج فارس,1310,3359283,70043397140,21640,21050,21000,-640,-2.96,21070,-570,-2.63,20580,21460
دكپسول,توليد ژلاتين كپسول ايران,1304,3576581,235043266050,70200,67750,65300,-4900,-6.98,65700,-4500,-6.41,65300,68000
خديزل,بهمن  ديزل,1302,15788709,112199086080,7060,7170,7060,0,0,7110,50,0.71,6910,7340
خرينگ,رينگ‌سازي‌مشهد,1297,3038322,88260166150,30080,29650,28580,-1500,-4.99,29050,-1030,-3.42,28580,31030
دلقما,دارويي‌ لقمان‌,1295,27992861,91489885995,3249,3270,3200,-49,-1.51,3268,19,0.58,3110,3404
شكام,صنايع شيميايي كيمياگران امروز,1287,15832228,126513487620,8370,8370,7980,-390,-4.66,7990,-380,-4.54,7960,8490
قمرو,قند مرودشت‌,1279,6735831,81909017380,12080,12600,12050,-30,-0.25,12160,80,0.66,11520,12600
سدور,سيمان‌ دورود,1273,9483887,86796490970,9510,9530,9040,-470,-4.94,9150,-360,-3.79,9040,9730
زدشت,كشت و صنعت دشت خرم دره,1265,4046637,125551164850,32500,34400,30250,-2250,-6.92,31050,-1450,-4.46,30250,34450
وخاور,بانك خاورميانه,1259,16511857,71305558652,4412,4336,4332,-80,-1.81,4318,-94,-2.13,4210,4408
تكمبا,كمباين‌ سازي‌ ايران‌,1255,12818517,82053759310,6800,6810,6330,-470,-6.91,6400,-400,-5.88,6330,6970
زنگان,صنعت روي زنگان,1245,1037989,70752149100,71400,70050,67450,-3950,-5.53,68150,-3250,-4.55,66450,71450
كروي,توسعه‌ معادن‌ روي‌ ايران‌,1240,3627721,105215235940,30070,30000,29300,-770,-2.56,29000,-1070,-3.56,28050,30070
زماهان,مجتمع توليد گوشت مرغ ماهان,1232,7149326,60010765550,8370,8540,8300,-70,-0.84,8390,20,0.24,8130,8680
ساوه,سيمان ساوه,1230,1724154,135788772950,75150,75750,78900,3750,4.99,78750,3600,4.79,75700,78900
دسبحان,سبحان دارو,1223,16432256,122305086070,7820,7830,7430,-390,-4.99,7440,-380,-4.86,7430,7830
وثنو,سرمايه گذاري ساختماني نوين,1221,29190622,65026426250,2203,2229,2220,17,0.77,2228,25,1.13,2150,2269
شگل,گلتاش‌,1212,16445462,95187789740,5920,5900,5700,-220,-3.72,5790,-130,-2.2,5570,5990
خريخت,صنايع‌ريخته‌گري‌ايران‌,1207,16848507,70824950305,4245,4370,4200,-45,-1.06,4204,-41,-0.97,4050,4400
وملي,گروه‌ صنعتي‌ ملي‌ (هلدينگ‌,1207,587315,87051964390,152620,151510,144990,-7630,-5,148220,-4400,-2.88,144990,155700
فنوال,نورد آلومينيوم‌,1205,9868758,70383545810,7560,7440,7080,-480,-6.35,7130,-430,-5.69,7040,7440
سصفها,سيمان‌اصفهان‌,1204,1139341,79312382960,70290,70140,68490,-1800,-2.56,69610,-680,-0.97,66780,70880
لسرما,سرما آفرين‌,1197,2902788,81401879760,27120,28000,27300,180,0.66,28040,920,3.39,27000,28470
كپشيرح,ح . پشم‌شيشه‌ايران‌,1196,13898208,69571190166,4886,4835,4897,11,0.23,5006,120,2.46,4835,5200
حآفرين,ريل پرداز نو آفرين,1175,19130271,83303930197,4519,4519,4376,-143,-3.16,4355,-164,-3.63,4294,4619
غدام,خوراك‌  دام‌ پارس‌,1169,1622439,80229660290,49760,51400,49280,-480,-0.96,49450,-310,-0.62,48070,51400
كطبس,ذغال‌سنگ‌ نگين‌ ط‌بس‌,1163,3727452,60928890260,17070,16500,16160,-910,-5.33,16350,-720,-4.22,15950,17300
دزهراوي,داروسازي‌زهراوي‌,1159,22630304,120033736290,5110,5365,5250,140,2.74,5304,194,3.8,5112,5365
كبافق,معادن‌ بافق‌,1159,3340605,111561101980,33900,33460,32940,-960,-2.83,33400,-500,-1.47,32450,35480
ولكار,ليزينگ كارآفرين,1153,1627901,13948996700,8740,8590,8510,-230,-2.63,8580,-160,-1.83,8500,8810
وهنر,گروه توسعه هنر ايران,1152,28181406,82467964503,2996,3070,2917,-79,-2.64,2926,-70,-2.34,2907,3085
سمايه,بانك سرمايه,1148,13430999,75724218040,5480,5640,5640,160,2.92,5640,160,2.92,5580,5640
زكشت,كشاورزي مكانيزه اصفهان كشت,1143,2399898,73088655800,31650,32800,29450,-2200,-6.95,30450,-1200,-3.79,29450,32950
كاذر,فرآورده‌هاي‌نسوزآذر,1142,23213708,126200423520,5312,5500,5300,-12,-0.23,5440,128,2.41,5170,5570
چكاوه,صنايع‌كاغذسازي‌كاوه‌,1141,7955166,100081947220,12060,12660,12660,600,4.98,12580,520,4.31,12150,12660
وزمين,بانك ايران زمين,1136,4629661,34263023860,7550,7400,7400,-150,-1.99,7400,-150,-1.99,7400,7550
وسپه,سرمايه‌گذاري‌ سپه‌,1135,21970503,106542974924,4974,4901,4850,-124,-2.49,4849,-125,-2.51,4823,4901
آوند,صندوق س. آوند مفيد-د,1128,59976790,661688171867,11017,11032,11033,16,0.15,11032,15,0.14,11032,11033
كارين,صندوق س نگين سامان-ثابت,1127,34665716,346858753828,10176,10005,10006,-170,-1.67,10006,-170,-1.67,10005,10007
سخوز,سيمان خوزستان,1125,8397078,276171487690,32190,34440,32800,610,1.89,32890,700,2.17,32800,34440
پارسيان,بيمه پارسيان,1124,12342269,44899215641,3839,3810,3571,-268,-6.98,3638,-201,-5.24,3571,3880
خراسان,پتروشيمي خراسان,1120,767833,87400044110,112430,115000,113730,1300,1.16,113830,1400,1.25,113010,116000
وتوس,توسعه‌شهري‌توس‌گستر,1120,17838969,187146568260,9840,10490,10520,680,6.91,10490,650,6.61,9990,10520
ونيرو,سرمايه‌گذاري‌نيرو,1117,25937201,69460074624,2833,2879,2635,-198,-6.99,2678,-155,-5.47,2635,2879
شصدف,صنعتي دوده فام,1114,1881178,66448233350,35400,35800,35150,-250,-0.71,35300,-100,-0.28,33950,36350
فسازان,غلتك سازان سپاهان,1107,15787694,64222031706,4073,4130,3963,-110,-2.7,4068,-5,-0.12,3911,4241
واحصا,احياء صنايع خراسان,1105,1321447,86366521600,63500,65350,65400,1900,2.99,65350,1850,2.91,64650,65400
قزوين,كارخانجات‌ قند قزوين‌,1105,13555692,90859629390,6590,6850,6630,40,0.61,6700,110,1.67,6400,6910
نطرين,عطرين نخ قم,1102,5769773,44695814470,7730,8000,7650,-80,-1.03,7750,20,0.26,7440,8040
دماوند,توليد نيروي برق دماوند,1099,3582094,76458509800,20900,21250,21100,200,0.96,21350,450,2.15,20700,21850
سشمال,سيمان‌ شمال‌,1097,9700830,120348692260,12020,12820,12240,220,1.83,12410,390,3.24,11930,12860
خچرخش,چرخشگر,1088,3994134,90546837750,22910,22940,22980,70,0.31,22670,-240,-1.05,21900,23990
ومدير,گ.مديريت ارزش سرمايه ص ب كشوري,1083,6839846,29262128665,4347,4282,4268,-79,-1.82,4278,-69,-1.59,4255,4360
تماوند,تامين سرمايه دماوند,1082,15151329,93182019920,6140,6200,6110,-30,-0.49,6150,10,0.16,5940,6330
وگستر,گسترش سرمايه گذاري ايرانيان,1062,16918329,86067968560,5210,5200,5250,40,0.77,5090,-120,-2.3,4930,5310
مبين,مبين انرژي خليج فارس,1050,2532225,80783874630,32960,32310,31670,-1290,-3.91,32220,-740,-2.25,31330,33140
غپاك,لبنيات‌ پاك‌,1047,6537014,86651028800,13390,13700,13410,20,0.15,13260,-130,-0.97,13010,13700
وسكاب,س.ص.بازنشستگي كاركنان بانكها,1047,15503867,48919413969,3198,3250,3140,-58,-1.81,3155,-43,-1.34,3105,3279
بنو,بيمه تجارت نو,1045,10130126,42297108978,4333,4292,4117,-216,-4.98,4175,-158,-3.65,4117,4332
وصنا,گروه‌صنايع‌بهشهرايران‌,1044,19218533,54354944768,3016,2929,2815,-201,-6.66,2828,-188,-6.23,2805,2929
وتوكا,سرمايه‌گذاري‌توكافولاد(هلدينگ,1042,6958546,65561533480,10010,10080,9330,-680,-6.79,9420,-590,-5.89,9310,10080
وپست,پست بانك ايران,1039,13657631,80065209810,6000,5920,5900,-100,-1.67,5860,-140,-2.33,5740,6090
وبهمن,سرمايه‌گذاري‌بهمن‌,1026,12602134,51414351537,4084,4050,4018,-66,-1.62,4080,-4,-0.1,3961,4250
شدوص,دوده‌ صنعتي‌ پارس‌,1022,6845250,87934715940,12620,12550,12830,210,1.66,12850,230,1.82,12370,13170
شكربن,كربن‌ ايران‌,1022,19293530,72040322837,3851,3851,3799,-52,-1.35,3734,-117,-3.04,3660,3891
فنفت,صنايع تجهيزات نفت,1020,3647338,128604319250,34300,35000,35300,1000,2.92,35250,950,2.77,35000,35300
جم پيلن,پتروشيمي جم پيلن,1017,498354,70596783390,143140,140000,140210,-2930,-2.05,142080,-1060,-0.74,139740,145090
تاصيكو,سرمايه گذاري صدرتامين,1010,8385825,102900902470,12440,12220,12150,-290,-2.33,12290,-150,-1.21,11910,12400
اطلس,صندوق س.توسعه اطلس مفيد-س,1009,514239,163516213340,322461,327499,318191,-4270,-1.32,317977,-4484,-1.39,315000,327499
غشاذر,پگاه‌آذربايجان‌غربي‌,1000,6796834,48582681100,7080,7020,7040,-40,-0.56,7150,70,0.99,6910,7370
مفاخر,توسعه فناوري اطلاعات خوارزمي,998,6911214,56622962380,8670,8520,8070,-600,-6.92,8190,-480,-5.54,8070,8700
تجلي,تجلي توسعه معادن و فلزات,996,26781016,40341767798,1566,1534,1491,-75,-4.79,1506,-60,-3.83,1489,1555
اپرداز,آتيه داده پرداز,988,8397023,43893053780,5420,5470,5150,-270,-4.98,5230,-190,-3.51,5150,5590
وحكمت,بيمه حكمت صبا,986,38595608,72648361827,1831,1885,1883,52,2.84,1882,51,2.79,1820,1885
دبالك,مواد اوليه دارويي البرز بالك,981,6897655,62353996330,9650,9500,8980,-670,-6.94,9040,-610,-6.32,8980,9500
خفولا,خدمات فني فولاد يزد,980,1278615,63365089450,50050,51350,49750,-300,-0.6,49550,-500,-1,48550,51350
بخاور,بيمه زندگي خاورميانه,977,17185661,50928782157,2853,2910,2923,70,2.45,2963,110,3.86,2860,3040
وملل,اعتباري ملل,976,21564636,78466493284,3487,3600,3661,174,4.99,3639,152,4.36,3510,3661
شغدير,پتروشيمي غدير,975,1498818,100477781900,68650,67810,67030,-1620,-2.36,67040,-1610,-2.35,66510,68120
غچين,كشت‌ و صنعت‌ چين‌ چين,968,32585162,196160569280,5742,6020,6020,278,4.84,6020,278,4.84,6000,6020
ثپرديس,سرمايه گذاري مسكن پرديس,966,10087327,59433088860,5930,6050,5720,-210,-3.54,5890,-40,-0.67,5690,6170
وحافظ,بيمه حافظ,964,19927942,66857031561,3438,3498,3335,-103,-3,3355,-83,-2.41,3335,3498
زاگرس,پتروشيمي زاگرس,963,1356770,176900255400,132700,133550,129250,-3450,-2.6,130400,-2300,-1.73,128500,133950
شاملا,معدني‌ املاح‌  ايران‌,950,19440095,230768466700,12480,12310,11860,-620,-4.97,11870,-610,-4.89,11860,12470
قشرين,قند شيرين خراسان,941,13992362,128286747550,8940,9180,9200,260,2.91,9170,230,2.57,8720,9200
پاسا,ايران‌ياساتايرورابر,940,9287320,98094356010,11090,10610,10540,-550,-4.96,10560,-530,-4.78,10540,10950
خكمك,كمك‌فنرايندامين‌,939,3362150,81057629540,24770,25690,24010,-760,-3.07,24110,-660,-2.66,23540,25690
دامين,داروسازي‌ امين‌,938,11205393,40961901142,3744,3640,3650,-94,-2.51,3656,-88,-2.35,3544,3830
شصفها,پتروشيمي‌ اصفهان‌,935,1832033,293237643050,157000,160100,160100,3100,1.97,160050,3050,1.94,157700,160100
تاپيكو,س. نفت و گاز و پتروشيمي تأمين,925,7245794,95991874740,13560,13500,13050,-510,-3.76,13300,-260,-1.92,13050,13500
چفيبر,فيبر ايران‌,920,11465563,64923902890,5400,5670,5670,270,5,5660,260,4.81,5570,5670
نفيس,صندوق س.پشتوانه طلاي صبا,916,10670923,133882608552,12010,12201,13045,1035,8.62,12546,536,4.46,12201,13100
شفا,سرمايه گذاري شفادارو,911,7279487,138100044160,18130,18200,18740,610,3.36,18970,840,4.63,18200,19030
قهكمت,قندهكمتان‌,911,7501869,66765802260,8680,9000,8750,70,0.81,8900,220,2.53,8690,9030
هم وزن,صندوق س. شاخصي كيان-س,908,12980925,158490920361,12514,12490,12148,-366,-2.92,12210,-304,-2.43,12060,12580
شنفت,نفت‌ پارس‌,908,6544791,52289707540,8260,8510,7910,-350,-4.24,7990,-270,-3.27,7740,8510
كامياب,صندوق س. كامياب آشنا-د,904,30897537,430997464449,13923,13949,13950,27,0.19,13949,26,0.19,13949,13950
ستران,سيمان‌ تهران‌,897,2008957,72263295160,34960,36000,35750,790,2.26,35970,1010,2.89,35560,36490
شپترو,پتروشيمي آبادان,897,22044998,41538746777,1881,1937,1838,-43,-2.29,1884,3,0.16,1835,1937
فرآور,فرآوري‌موادمعدني‌ايران‌,892,2237932,62442730900,29220,29400,27620,-1600,-5.48,27900,-1320,-4.52,27290,29590
رانفور,خدمات‌انفورماتيك‌,890,11240292,50547050153,4633,4733,4412,-221,-4.77,4527,-106,-2.29,4371,4740
پارند,صندوق س. پارند پايدار سپهر,883,30448260,307230343650,10075,10090,10091,16,0.16,10090,15,0.15,10090,10091
كهمدا,شيشه‌ همدان‌,882,5695063,64998356860,11160,11120,11400,240,2.15,11410,250,2.24,11120,11720
تملت,تامين سرمايه بانك ملت,881,12635527,41340563029,3299,3305,3200,-99,-3,3272,-27,-0.82,3192,3409
كيميا,معدني كيمياي زنجان گستران,880,11981207,92519672420,8050,8080,7840,-210,-2.61,7720,-330,-4.1,7650,8160
غبهنوش,بهنوش‌ ايران‌,872,1087376,63194443860,60320,60500,58470,-1850,-3.07,58120,-2200,-3.65,57310,62000
فروس,فروسيليس‌ ايران‌,872,9880904,66070391490,6980,6800,6820,-160,-2.29,6690,-290,-4.15,6500,6890
ساينا,صنايع بهداشتي ساينا,865,1471715,45581414950,32050,32900,30900,-1150,-3.59,30950,-1100,-3.43,29850,33450
زشريف,كشت وصنعت شريف آباد,860,7051462,35927285190,5140,5370,4860,-280,-5.45,5100,-40,-0.78,4860,5370
وتوصا,گروه س توسعه صنعتي ايران,858,5094662,43456812280,8720,8680,8370,-350,-4.01,8530,-190,-2.18,8320,8900
ضستا1108,اختيارخ شستا-1300-1401/11/05,858,403252,701223000,5,6,2,-3,-60,2,-3,-60,1,6
شپاكسا,پاكسان‌,855,20216564,42885877586,2201,2240,2100,-101,-4.59,2121,-80,-3.63,2051,2240
فايرا,آلومينيوم‌ايران‌,852,12796484,76508847950,5890,5940,6000,110,1.87,5960,70,1.19,5900,6060
سرو,صندوق س سروسودمند مدبران-سهام,850,1373739,128780412730,95790,96250,93500,-2290,-2.39,93740,-2050,-2.14,92800,96310
سپاها,سيمان‌سپاهان‌,850,6944805,85271005900,11810,12540,12270,460,3.9,12280,470,3.98,11960,12540
كمنگنز,معادن‌منگنزايران‌,846,5072693,59063877920,12120,12150,11680,-440,-3.63,11640,-480,-3.96,11280,12150
خفناور,مهندسي صنعتي روان فن آور,840,2715326,67750592900,24350,24800,25050,700,2.87,24950,600,2.46,24500,25050
هرمز,فولاد هرمزگان جنوب,839,7217642,94923951900,13720,13200,13150,-570,-4.15,13250,-470,-3.43,13040,13360
زنجان,صنايع كشاورزي وكود زنجان,833,15956600,42221324904,2681,2739,2690,9,0.34,2646,-35,-1.31,2621,2740
رمپنا,گروه مپنا (سهامي عام),831,10013066,119391446230,12110,12110,11930,-180,-1.49,11920,-190,-1.57,11820,12220
كفپارس,فرآورده‌هاي‌ نسوز پارس‌,830,14318962,62437281295,4516,4500,4390,-126,-2.79,4360,-156,-3.45,4261,4571
ضسپا1205,اختيارخ خساپا-2000-1401/12/10,824,166336,72938953000,615,588,450,-165,-26.83,439,-176,-28.62,400,588
وهور,مديريت انرژي اميد  تابان هور,821,24989295,39595048683,1623,1610,1575,-48,-2.96,1591,-32,-1.97,1542,1690
فلوله,لوله‌وماشين‌سازي‌ايران‌,817,41152814,93046512454,2154,2261,2261,107,4.97,2261,107,4.97,2261,2261
بمپنا,توليد برق عسلويه  مپنا,815,13473545,89056976600,6930,6930,6620,-310,-4.47,6610,-320,-4.62,6590,6930
كپشير,پشم‌شيشه‌ايران‌,815,8540085,72115714020,8110,8190,8510,400,4.93,8440,330,4.07,7760,8510
پكوير,كوير تاير,815,5477649,31613833670,6000,6000,5730,-270,-4.5,5770,-230,-3.83,5640,6000
سبهان,سيمان‌ بهبهان‌,805,725183,40325607940,55860,57950,55000,-860,-1.54,55610,-250,-0.45,53080,58640
فزرين,زرين معدن آسيا,803,10069289,71458031590,7320,7150,7010,-310,-4.23,7100,-220,-3.01,6830,7350
سفارس,سيمان فارس و خوزستان,799,3656685,77136607390,21520,22300,21160,-360,-1.67,21090,-430,-2,20760,22300
ملت,بيمه ملت,796,25738857,43534205310,1709,1718,1709,0,0,1691,-18,-1.05,1660,1720
ثجوان,تامين مسكن جوانان,784,13456657,69940322750,5090,5240,5100,10,0.2,5200,110,2.16,4940,5240
خمحور,توليدمحورخودرو,783,8411459,35675002743,4260,4360,4167,-93,-2.18,4241,-19,-0.45,4115,4388
تپمپي,پمپ‌ سازي‌ ايران‌,781,3186514,77923355880,23300,24920,24300,1000,4.29,24450,1150,4.94,23510,24930
دجابر,داروسازي‌ جابرابن‌حيان‌,780,4009329,55016624860,13600,13990,13500,-100,-0.74,13720,120,0.88,13300,13990
زگلدشت,كشت و دام گلدشت نمونه اصفهان,778,4983052,87889711680,18260,19130,17000,-1260,-6.9,17640,-620,-3.4,16990,19130
پاكشو,گروه صنعتي پاكشو,775,5733872,36090293680,6500,6520,6300,-200,-3.08,6440,-60,-0.92,6200,6520
دلر,داروسازي‌ اكسير,772,3692233,87818032720,24590,25000,23590,-1000,-4.07,23780,-810,-3.29,23370,25390
واتي,سرمايه‌ گذاري‌ آتيه‌ دماوند,761,10419255,110613289330,11040,11010,10700,-340,-3.08,10620,-420,-3.8,10310,11060
غشهد,شهد ايران ‌,760,6853455,47785836230,7320,7000,6960,-360,-4.92,6970,-350,-4.78,6960,7200
كباده,توليد خاك نسوزاستقلال آباده,758,2711865,47464980430,17970,18480,17440,-530,-2.95,17500,-470,-2.62,17440,18480
مداران,داده‌پردازي‌ايران‌,754,4160504,30325812740,7260,7250,7200,-60,-0.83,7290,30,0.41,7150,7450
ساربيل,سيمان آرتا اردبيل,746,1143552,51820104240,45940,45590,46240,300,0.65,45320,-620,-1.35,44040,47000
وپترو,سرمايه‌گذاري صنايع پتروشيمي‌,746,6067843,97357917550,16460,16300,15670,-790,-4.8,16040,-420,-2.55,15560,16450
ريشمك,توليد و صادرات ريشمك,745,1595209,35593135850,23200,23700,22200,-1000,-4.31,22300,-900,-3.88,21900,23700
وتعاون,بيمه تعاون,741,19656748,36909141891,1957,1998,1860,-97,-4.96,1878,-79,-4.04,1860,1998
آباد,توريستي ورفاهي آبادگران ايران,740,1147413,32057432130,28760,29310,27360,-1400,-4.87,27940,-820,-2.85,27330,29320
بكهنوج,توليد برق ماهتاب كهنوج,739,20727158,29631297539,1441,1425,1440,-1,-0.07,1430,-11,-0.76,1412,1469
سنير,سيمان‌ سفيد ني‌ريز,739,1400545,51931138010,35370,36390,37130,1760,4.98,37080,1710,4.83,36390,37130
پخش,پخش البرز,737,1599530,82051855250,50900,51150,52250,1350,2.65,51300,400,0.79,50050,52400
رنيك,جنرال مكانيك,732,11963595,181052905680,15110,15590,15430,320,2.12,15130,20,0.13,14970,15590
درهآور,دارويي ره آورد تامين,732,1193182,79411358500,65750,68000,66050,300,0.46,66550,800,1.22,65150,68000
وآوا,سرمايه گذاري آوا نوين,730,7911876,26447121551,3442,3304,3310,-132,-3.83,3343,-99,-2.88,3268,3487
ونفت,سرمايه‌گذاري‌ صنعت‌ نفت‌,725,7545560,33565216822,4491,4540,4430,-61,-1.36,4448,-43,-0.96,4351,4598
غنيلي,مجتمع توليدي نيلي صنعت كرمان,722,17006832,84130705880,4829,5070,5070,241,4.99,4947,118,2.44,4780,5070
زفكا,كشت و دامداري فكا,722,8000498,107888092270,13740,13820,13230,-510,-3.71,13490,-250,-1.82,12900,14000
ثتران,سرمايه گذاري مسكن تهران,721,37556945,171823320764,4360,4578,4578,218,5,4575,215,4.93,4260,4578
غپونه,نوش پونه مشهد,718,2647780,43817576650,15800,16580,16590,790,5,16550,750,4.75,16100,16590
سفاسي,شركت فارسيت اهواز,714,8370268,34685391406,4054,4175,4090,36,0.89,4144,90,2.22,3965,4175
ارفع,شركت آهن و فولاد ارفع,704,2708372,48179799880,18140,18040,18130,-10,-0.06,17940,-200,-1.1,17400,18230
اميد,تامين سرمايه اميد,704,7528607,40201226750,5500,5400,5270,-230,-4.18,5340,-160,-2.91,5250,5490
فخاس,فولاد خراسان,700,3319359,37988767730,11290,11500,11340,50,0.44,11350,60,0.53,11000,11820
غفارس,شير پاستوريزه پگاه فارس,698,8655693,77737143650,9260,9550,8810,-450,-4.86,8980,-280,-3.02,8800,9550
شبصير,توليدات پتروشيمي قائد بصير,697,562627,68560676900,125550,124900,121700,-3850,-3.07,121850,-3700,-2.95,121000,124900
پكرمان,گروه‌ صنعتي‌ بارز,696,3537641,67562643800,18200,18780,19100,900,4.95,19100,900,4.95,18710,19110
ضستا6004,اختيارخ شستا-865-1402/06/08,692,147955,53006557000,393,401,360,-33,-8.4,358,-35,-8.91,340,401
آرام,صندوق س شاخصي آرام مفيد,690,3441246,40413812640,11950,12090,11670,-280,-2.34,11740,-210,-1.76,11610,12090
ثبات,صندوق س. ثبات ويستا -د,689,35315966,471797275632,13335,13359,13359,24,0.18,13359,24,0.18,13359,13360
كسرام,پارس‌ سرام‌,685,5474819,36174369410,6390,6680,6510,120,1.88,6610,220,3.44,6410,6700
جوين,كشت و صنعت جوين,681,5596859,33040662000,6060,6070,5880,-180,-2.97,5900,-160,-2.64,5880,6070
غگلپا,شير پاستوريزه پگاه گلپايگان,680,924206,58341267950,66050,66050,63050,-3000,-4.54,63150,-2900,-4.39,61500,66750
طخود1205,اختيارف خودرو-2000-1401/12/03,677,269848,6309532000,30,26,24,-6,-20,23,-7,-23.33,20,30
سرچشمه,سرمايه گذاري مس سرچشمه,675,9724589,43910420056,4527,4580,4568,41,0.91,4515,-12,-0.27,4460,4580
شفارا,پتروشيمي فارابي,674,29672707,164295463380,5387,5540,5540,153,2.84,5540,153,2.84,5300,5540
وآرين,شركت توسعه اقتصادي آرين,670,18902927,27931003701,1505,1544,1460,-45,-2.99,1478,-27,-1.79,1460,1544
حخزر,كشتيراني درياي خزر,668,4911466,141641244300,28000,29150,28400,400,1.43,28850,850,3.04,28100,29400
ورازي,بيمه رازي,667,21614134,33117679639,1575,1546,1528,-47,-2.98,1532,-43,-2.73,1528,1561
غگرجي,بيسكويت‌  گرجي‌,667,13778432,25873373473,1941,1980,1870,-71,-3.66,1878,-63,-3.25,1844,1987
غشوكو,شوكو پارس,665,4721883,45640055170,9710,9900,9420,-290,-2.99,9670,-40,-0.41,9420,9900
آ س پ,آ.س.پ,665,6134685,39178474580,6690,6690,6290,-400,-5.98,6390,-300,-4.48,6230,6690
خعمرا,توسعه و عمران شهرستان نائين,665,5629968,33892627420,5860,6030,6030,170,2.9,6020,160,2.73,5900,6030
فجام,جام‌دارو,664,5535118,32004708790,5590,5760,5710,120,2.15,5780,190,3.4,5640,5860
وپسا,س. پتروشيمي ساختمان  خليج فارس,662,13746283,25484905133,1901,1940,1844,-57,-3,1854,-47,-2.47,1844,1940
تفارس,تامين سرمايه خليج فارس,659,8543710,49417503770,5950,5800,5780,-170,-2.86,5780,-170,-2.86,5780,5820
اوان,مبين وان كيش,658,3484137,52762629390,15760,15780,15120,-640,-4.06,15140,-620,-3.93,14980,15990
ولتجار,واسپاري تجار ايرانيان,656,15676997,42918905132,2711,2792,2718,7,0.26,2738,27,1,2640,2792
رفاه,فروشگاه هاي زنجيره اي رفاه,654,635003,190684165400,297650,306550,289000,-8650,-2.91,300300,2650,0.89,289000,306550
ضستا1205,اختيارخ شستا-1000-1401/12/03,653,131913,16258188000,157,151,119,-38,-24.2,123,-34,-21.66,103,151
غشصفا,شيرپاستوريزه‌پگاه‌اصفهان‌,649,1418461,32782714700,23550,23800,23220,-330,-1.4,23110,-440,-1.87,22000,24000
تبرك,گروه كارخانجات صنعتي تبرك,648,3587738,36763425420,10070,10200,10200,130,1.29,10250,180,1.79,10010,10450
حتايد,تايدواترخاورميانه,644,7947990,43705358920,5650,5720,5420,-230,-4.07,5500,-150,-2.65,5290,5720
حآساح,ح.آسيا سير ارس,641,5884366,36626327580,6190,6190,6400,210,3.39,6220,30,0.48,5830,6420
فن آوا,گروه فن آوا,640,6527963,42226476830,6610,6440,6520,-90,-1.36,6470,-140,-2.12,6420,6610
نتوس,پشم‌ بافي‌ توس,636,3235453,28711340090,9050,9280,8870,-180,-1.99,8870,-180,-1.99,8780,9280
شرنگي,شيميايي رنگين,632,728404,32047198000,45300,44150,43950,-1350,-2.98,44000,-1300,-2.87,43950,45250
بزاگرس,نيروگاه زاگرس كوثر,632,5877657,28166798045,4857,4790,4675,-182,-3.75,4792,-65,-1.34,4615,4983
اعتلا,شركت سرمايه گذاري اعتلاء البرز,631,10291822,55413718350,5630,5500,5350,-280,-4.97,5380,-250,-4.44,5350,5670
وفتخار,سرمايه گذاري افتخار سهام,629,7660080,27201145368,3655,3615,3546,-109,-2.98,3551,-104,-2.85,3546,3615
شجم,صنايع پتروشيمي تخت جمشيد,627,4746734,42132301970,8810,8810,8700,-110,-1.25,8880,70,0.79,8550,8990
ثامان,سامان‌ گستراصفهان‌,625,3183629,52779218540,15820,16610,16610,790,4.99,16580,760,4.8,16130,16610
ومهان,گروه توسعه مالي مهر آيندگان,624,15210938,85788946450,5730,5580,5670,-60,-1.05,5640,-90,-1.57,5540,5820
ولملت,واسپاري ملت,619,5313371,26777140820,5180,5350,5000,-180,-3.47,5040,-140,-2.7,4850,5350
سيلام,سيمان‌ ايلام‌,615,8175406,97227282000,11970,12100,11690,-280,-2.34,11890,-80,-0.67,11380,12100
غشان,شيرپاستوريزه‌پگاه‌خراسان‌,605,4848442,36839772090,7870,7560,7360,-510,-6.48,7600,-270,-3.43,7360,7990
كترام,توليدي‌ كاشي‌ تكسرام‌,605,4925092,43309104240,9150,9300,8700,-450,-4.92,8790,-360,-3.93,8700,9300
سبجنو,سيمان‌ بجنورد,602,1412811,61130254210,41460,41700,43530,2070,4.99,43270,1810,4.37,41120,43530
ثفارس,عمران‌وتوسعه‌فارس‌,600,12167432,103166388240,8680,8550,8480,-200,-2.3,8480,-200,-2.3,8280,8550
سرود,سيمان‌شاهرود,597,1636399,43418675600,26030,26780,26300,270,1.04,26530,500,1.92,26000,26960
دالبر,البرزدارو,596,3938366,30231301570,7830,7480,7600,-230,-2.94,7680,-150,-1.92,7470,8090
سصوفي,سيمان‌ صوفيان‌,592,2726636,66117663880,24560,24400,24070,-490,-2,24250,-310,-1.26,23910,25430
شكلر,نيروكلر,589,1943900,56562413100,28670,29600,29060,390,1.36,29100,430,1.5,28530,29690
شوينده,مديريت صنعت شوينده ت.ص.بهشهر,588,1474506,27645257940,19370,19010,18540,-830,-4.28,18750,-620,-3.2,18500,19370
زمگسا,كشاورزي‌ ودامپروي‌ مگسال‌,581,2079623,69883757170,35220,35220,33460,-1760,-5,33600,-1620,-4.6,33460,35220
وسديد,گروه ‌صنعتي‌سديد,578,32070218,83478777454,2528,2603,2603,75,2.97,2603,75,2.97,2603,2603
ومعلم,بيمه معلم,576,9544452,18265184566,1974,1972,1876,-98,-4.96,1914,-60,-3.04,1876,2000
كحافظ,كاشي‌ وسراميك‌ حافظ‌,575,7908669,50388585740,6390,6480,6270,-120,-1.88,6370,-20,-0.31,6110,6490
فيروزا,صندوق ارمغان فيروزه آسيا-ثابت,570,13737845,444614578134,32316,32364,32364,48,0.15,32364,48,0.15,32364,32365
ساذري,آذريت‌,568,5346311,43250681410,7870,8100,8100,230,2.92,8090,220,2.8,7710,8100
كفرا,فراورده‌ هاي‌ نسوزايران‌,568,3211920,28035976700,9080,8730,8690,-390,-4.3,8730,-350,-3.85,8630,9020
جم,پتروشيمي جم,566,2434021,90637477790,38710,38000,37620,-1090,-2.82,37320,-1390,-3.59,36800,38930
ثاخت,بين‌المللي‌توسعه‌ساختمان,565,27393394,77984328225,2833,2820,2836,3,0.11,2847,14,0.49,2820,2897
والبر,سرمايه‌ گذاري‌ البرز(هلدينگ‌,564,6137019,38478265240,6330,6310,6170,-160,-2.53,6270,-60,-0.95,6140,6470
دابور,داروسازي‌ ابوريحان‌,558,4791284,95119704710,20860,20750,19820,-1040,-4.99,19850,-1010,-4.84,19820,20750
قجام,فرآوردههاي غذايي وقندتربت‌جام‌,557,15679638,131209237510,8600,8370,8350,-250,-2.91,8370,-230,-2.67,8350,8580
شخارك,پتروشيمي‌ خارك‌,556,949479,38257573690,40780,41390,40040,-740,-1.81,40590,-190,-0.47,39500,41800
حگردش,ريل گردش ايرانيان,555,28204223,153995057580,5310,5460,5460,150,2.82,5460,150,2.82,5460,5460
دتماد,توليدمواداوليه‌داروپخش‌,554,1354499,52654279590,39500,39450,38570,-930,-2.35,38870,-630,-1.59,38400,39790
زرفام,صندوق س.پشتوانه طلا زرفام آشنا,552,1791340,29508177094,15339,15630,16870,1531,9.98,16473,1134,7.39,15630,16872
وثوق,سرمايه گذاري وثوق امين,550,1606142,36759242300,22950,23600,22950,0,0,22950,0,0,22300,23600
ضسپا1206,اختيارخ خساپا-2200-1401/12/10,546,106283,34771281000,465,475,314,-151,-32.47,327,-138,-29.68,230,475
وجامي,سرمايه گذاري جامي,544,12083724,49773290109,4244,4338,4117,-127,-2.99,4119,-125,-2.95,4117,4338
فافزا,فولاد افزا سپاهان,542,989372,41670150950,41950,43200,41700,-250,-0.6,42100,150,0.36,40700,43200
قپيرا,فرآورده‌هاي‌غدايي‌وقندپيرانشهر,541,2639722,24333502790,9440,9590,9000,-440,-4.66,9220,-220,-2.33,8800,9690
غبهار,كشت وصنعت بهاران گلبهار خراسان,540,2826875,44972396630,15460,15710,15920,460,2.98,15910,450,2.91,15530,15920
پدرخش,درخشان‌ تهران‌,539,4938764,62775444920,12210,12470,12820,610,5,12710,500,4.1,12310,12820
ونيكي,سرمايه‌گذاري‌ ملي‌ايران‌,538,3873802,26284945870,7020,6900,6830,-190,-2.71,6960,-60,-0.85,6690,6990
كپارس,كاشي‌ پارس‌,538,4446837,39068704520,8890,9070,8780,-110,-1.24,8790,-100,-1.12,8560,9070
ضسپا1204,اختيارخ خساپا-1900-1401/12/10,535,104357,52318335000,667,640,520,-147,-22.04,501,-166,-24.89,400,640
سكارون,سيمان كارون,528,502807,30318685100,59000,59050,60550,1550,2.63,60300,1300,2.2,59000,60750
قشهد,شهد,527,2254131,36702967220,16060,16290,16410,350,2.18,16280,220,1.37,16050,16520
آفاق,صندوق س نوع دوم افق آتي-ثابت,525,21172167,211868565023,10176,10007,10007,-169,-1.66,10007,-169,-1.66,10006,10007
واميد,گروه مديريت سرمايه گذاري اميد,523,3283441,42785238940,13400,13210,13060,-340,-2.54,13260,-140,-1.04,12840,13500
ثنام,س ساختماني ب نام آوران مهندسي,523,4600212,33404129720,7080,7290,7150,70,0.99,7260,180,2.54,7080,7290
فافق,صنايع مس افق كرمان,521,4646305,24684786460,5258,5390,5310,52,0.99,5310,52,0.99,5130,5400
ثباغ,شهر سازي و خانه سازي باغميشه,509,2886058,27493260720,9470,9500,9500,30,0.32,9530,60,0.63,9100,9890
لخانه,لوازم‌ خانگي‌ پارس‌,509,5696254,109586896110,18680,19240,19240,560,3,19240,560,3,18860,19240
سپر,صندوق س سپر سرمايه بيدار- ثابت,507,8893984,147655252171,16580,16602,16601,21,0.13,16602,22,0.13,16601,16604
نيرو,نيرو سرمايه,506,825688,27029231050,33100,34000,32600,-500,-1.51,32750,-350,-1.06,32150,34050
كسعدي,كاشي‌ سعدي‌,505,3239298,36013383130,11610,11410,11030,-580,-5,11120,-490,-4.22,11030,11540
ثعتما,س. ساختماني اعتماد گستر,503,2320188,31772414410,13670,14080,13700,30,0.22,13690,20,0.15,13260,14080
ضدي203,اختيارخ دي-600-14020217,503,84680,30513824000,396,377,357,-39,-9.85,360,-36,-9.09,342,417
دكوثر,داروسازي‌ كوثر,503,20875282,139238130940,6240,6670,6670,430,6.89,6670,430,6.89,6670,6670
غگلستا,شير پاستوريزه پگاه گلستان,501,1527855,25098959500,17160,16770,16310,-850,-4.95,16430,-730,-4.25,16160,17000
ولراز,ليزينگ رازي,500,1557929,42360568750,26750,27500,26900,150,0.56,27200,450,1.68,26200,27550
دتوزيع,توزيع دارو پخش,498,1344708,44514854700,32550,34000,34000,1450,4.45,33100,550,1.69,32250,34000
واحيا,م .صنايع و معادن احياء سپاهان,498,8700190,139273648380,15550,16010,16010,460,2.96,16010,460,2.96,15800,16010
بالاس,مهندسي ساختمان تاسيسات راه آهن,496,1621580,58486431100,34400,35950,36100,1700,4.94,36050,1650,4.8,34750,36100
دعبيد,لابراتوارداروسازي‌  دكترعبيدي‌,493,2071641,29173574310,14600,15000,14260,-340,-2.33,14400,-200,-1.37,13870,15000
خوساز,محورسازان‌ايران‌خودرو,492,2107194,46057822640,20900,21940,21940,1040,4.98,21860,960,4.59,21640,21940
وسبحان,سرمايه گذاري سبحان,492,13636992,30742895812,2302,2280,2247,-55,-2.39,2254,-48,-2.09,2210,2320
دارو,كارخانجات‌داروپخش‌,489,1307030,27856183180,21940,22490,21490,-450,-2.05,21310,-630,-2.87,20920,22490
سفانو,سيمان فارس نو,487,1747561,106954669420,57560,58570,61580,4020,6.98,61200,3640,6.32,58570,61580
درازي,پخش رازي,486,2506922,63462899950,26400,26200,25000,-1400,-5.3,25300,-1100,-4.17,24600,27500
داراب,پتروشيمي داراب,484,10888359,11569963167,1084,1116,1052,-32,-2.95,1063,-21,-1.94,1052,1116
كفرآور,فرآورده هاي سيمان شرق,479,2384030,34687951510,14170,14580,14590,420,2.96,14550,380,2.68,14220,14590
ساروم,سيمان‌اروميه‌,473,942802,28358801600,30090,30130,29490,-600,-1.99,30080,-10,-0.03,29490,31190
فاهواز,نورد و لوله اهواز,471,7330716,33118123401,4607,4600,4517,-90,-1.95,4518,-89,-1.93,4515,4650
كلوند,كاشي‌ الوند,464,1695519,58245982650,35340,35340,34000,-1340,-3.79,34350,-990,-2.8,33810,35340
كشرق,صنعتي و معدني شمال شرق شاهرود,462,285576,31472349950,107300,107450,110750,3450,3.22,110200,2900,2.7,107300,113950
بميلا,توسعه سرمايه گذاري ميلاد پارس,459,6300141,61011212410,9950,10190,9660,-290,-2.91,9680,-270,-2.71,9660,10190
وبشهر,توسعه‌ صنايع‌ بهشهر(هلدينگ,458,4313275,31652014200,7790,7600,7410,-380,-4.88,7470,-320,-4.11,7250,7650
تيپيكو,سرمايه گذاري دارويي تامين,454,2965555,76990132130,25840,26240,25990,150,0.58,25930,90,0.35,25100,26500
سخزر,سيمان‌ خزر,451,1192633,34992264950,29260,30000,29700,440,1.5,29340,80,0.27,28220,30680
داوه,داروسازي آوه سينا,450,2236644,19621030000,9050,9270,8540,-510,-5.64,8770,-280,-3.09,8500,9270
كاسپين,داروسازي كاسپين تامين,450,2429114,39094819820,16760,16990,16320,-440,-2.63,16090,-670,-4,15930,17100
زيتون,صندوق س زيتون نماد پايا- مختلط,449,4395504,63119256570,14560,14530,14340,-220,-1.51,14360,-200,-1.37,14280,14580
پرديس,سرمايه گذاري پرديس,446,14256096,53916879002,3818,3898,3800,-18,-0.47,3782,-36,-0.94,3752,3900
ثشرق,سرمايه گذاري مسكن شمال شرق,442,5047599,24942598691,4808,4940,4947,139,2.89,4941,133,2.77,4800,5048
ضسپا1207,اختيارخ خساپا-2400-1401/12/10,440,112964,26421981000,343,281,220,-123,-35.86,234,-109,-31.78,185,297
ضستا1206,اختيارخ شستا-1100-1401/12/03,439,116110,10274651000,103,92,82,-21,-20.39,88,-15,-14.56,70,113
پلاسك,پلاسكوكار,438,5390239,23615701771,4589,4510,4360,-229,-4.99,4381,-208,-4.53,4360,4550
ركيش,كارت اعتباري ايران كيش,437,4396906,14008839910,3212,3272,3168,-44,-1.37,3188,-24,-0.75,3100,3298
شپارس,بين‌ المللي‌ محصولات‌  پارس‌,432,8493236,58008801880,6510,6830,6830,320,4.92,6830,320,4.92,6830,6830
داسوه,داروسازي‌ اسوه‌,430,1139601,53919225680,46150,47600,47890,1740,3.77,47310,1160,2.51,44510,48380
وايران,ليزينگ ايرانيان,429,5625738,24892455432,4559,4699,4321,-238,-5.22,4425,-134,-2.94,4280,4699
فوكا,فولاد كاويان,424,3374875,45740684810,13940,14070,13530,-410,-2.94,13550,-390,-2.8,13530,14070
كخاك,صنايع‌خاك‌چيني‌ايران‌,420,2759734,41429247810,15740,15290,15000,-740,-4.7,15010,-730,-4.64,14960,16000
سخاش,سيمان‌خاش‌,419,308629,21952616590,70210,70340,70280,70,0.1,71130,920,1.31,70200,71980
كيان2,صندوق س. با درآمد ثابت كيان,419,41900000,41900000,39877,1,1,-39876,-100,1,-39876,-100,1,1
وتوسم,سرمايه‌گذاري‌توسعه‌ملي‌,412,2715401,14256957060,5346,5310,5280,-66,-1.23,5260,-86,-1.61,5170,5390
وكادو,تكادو,411,2998496,56912840610,18440,18980,18990,550,2.98,18980,540,2.93,18700,18990
واعتبار,سرمايه گذاري اعتبار ايران,411,17407817,50686559936,2989,3024,2913,-76,-2.54,2912,-77,-2.58,2854,3024
ثنوسا,نوسازي‌وساختمان‌تهران‌,403,15267940,77560895324,4794,5150,5020,226,4.71,5080,286,5.97,4918,5190
كنور,توسعه معدني و صنعتي صبانور,400,1293206,21727756730,17400,17380,16800,-600,-3.45,17250,-150,-0.86,16550,17380
پسهند,صنايع‌ لاستيكي‌  سهند,398,695970,27188811880,38320,39600,39160,840,2.19,39070,750,1.96,37920,39600
تابا,تابان نيرو سپاهان,397,1379976,35987847600,26700,27500,26050,-650,-2.43,26100,-600,-2.25,25900,27500
حاريا,كشتيراني آريا,395,3346965,19895337310,5890,6000,5780,-110,-1.87,5940,50,0.85,5780,6000
دسبحا,گروه دارويي سبحان,394,2091282,21889085690,10880,11000,10370,-510,-4.69,10570,-310,-2.85,10130,11090
آساميد,صندوق س.مشترك آسمان اميد -د,388,14041482,239521493315,17029,17058,17058,29,0.17,17058,29,0.17,17058,17059
نمرينو,ايران‌ مرينوس‌,384,390932,43022068370,104940,110180,110180,5240,4.99,110050,5110,4.87,105410,110180
تايرا,تراكتورسازي‌ايران‌,384,700438,19901343970,28450,28510,28000,-450,-1.58,28430,-20,-0.07,27810,29500
وسرمد,بيمه  سرمد,382,7561389,13471528882,1826,1841,1772,-54,-2.96,1782,-44,-2.41,1772,1841
ودي,بيمه  دي,381,4108263,20171393505,4910,4820,4861,-49,-1,4910,0,0,4800,5074
ضخود1211,اختيارخ خودرو-3250-1401/12/03,377,51716,19251194000,444,440,357,-87,-19.59,372,-72,-16.22,300,457
شرانل,نفت ايرانول,376,927865,56927138650,61200,61800,61450,250,0.41,61350,150,0.25,60500,61800
كوثر,بيمه كوثر,375,7237366,35767561576,4967,5050,4881,-86,-1.73,4942,-25,-0.5,4770,5080
اتكاي,بيمه اتكايي ايرانيان,375,4982883,31978603180,6670,6570,6340,-330,-4.95,6420,-250,-3.75,6340,6730
قتربت,قند تربت حيدريه,371,807185,16052164940,19950,19470,19790,-160,-0.8,19890,-60,-0.3,19400,20430
فولاژ,فولاد آلياژي ايران,369,2256352,24245824580,10660,10660,10670,10,0.09,10680,20,0.19,10400,10850
وتوشه,سرمايه‌ گذاري‌ پارس‌ توشه‌,368,3634461,20933376620,5980,5900,5680,-300,-5.02,5760,-220,-3.68,5630,5940
تصميم,صندوق س با درآمد ثابت تصميم,363,3168311,72336462357,22790,22832,22832,42,0.18,22831,41,0.18,22831,22832
افرا,افرانت,359,2203837,50770509600,21600,22650,23100,1500,6.94,23050,1450,6.71,22650,23100
ضشنا1106,اختيارخ شپنا-7000-1401/11/19,351,33133,31367809000,1070,1100,891,-179,-16.73,947,-123,-11.5,850,1100
دشيري,شيرين دارو,350,192849,20415546450,105900,103050,105900,0,0,105850,-50,-0.05,103050,109050
وآفري,بيمه كارآفرين,347,6800291,19008149929,2728,2800,2809,81,2.97,2795,67,2.46,2751,2809
بسويچ,پارس‌سويچ‌,340,7668097,37524436960,5143,5130,4890,-253,-4.92,4890,-253,-4.92,4890,5130
بالبر,كابل‌ البرز,337,177805,12075207050,71090,73000,67540,-3550,-4.99,68410,-2680,-3.77,67540,73000
بهپاك,صنعتي بهپاك,335,3008544,21178476670,7200,7290,6980,-220,-3.06,7040,-160,-2.22,6840,7290
حسينا,توسعه خدمات دريايي وبندري سينا,332,1974256,21597968620,11190,11150,10970,-220,-1.97,10940,-250,-2.23,10700,11300
ثزاگرس,سرمايه گذاري توسعه عمران زاگرس,329,1317836,39973187700,29500,30350,30000,500,1.69,30350,850,2.88,29400,30350
فروسيل,فروسيليسيم خمين,324,2438135,44031321850,18600,18800,18000,-600,-3.23,18060,-540,-2.9,17670,18810
وآفر,سرمايه گذاري ارزش آفرينان,324,901311,24583160750,27200,27800,27200,0,0,27250,50,0.18,26500,27800
هجرت,پخش هجرت,323,1668884,50767297050,30950,30950,30800,-150,-0.48,30400,-550,-1.78,29750,31100
كساوه,صنايع‌ كاشي‌ و سراميك‌ سينا,322,1103606,57976879520,51740,52970,53010,1270,2.45,52530,790,1.53,52000,53500
فراز,صندوق س.سهام فراز داريك-س,321,5400578,97596770530,18067,18270,18067,0,0,18072,5,0.03,18067,18270
فبيرا,بسته‌ بندي‌ ايران‌,320,8184335,17168354953,2161,2110,2097,-64,-2.96,2098,-63,-2.92,2097,2196
كپرور,فرآوري زغال سنگ پروده طبس,316,1907901,18134275850,9670,9750,9400,-270,-2.79,9500,-170,-1.76,9210,9750
تكنار,مجتمع معادن مس تكنار,310,262774,16148611900,62050,63400,60800,-1250,-2.01,61450,-600,-0.97,60500,63800
دسانكوح,ح . داروسازي سبحان انكولوژي,309,2761033,14446380764,5540,5410,5153,-387,-6.99,5232,-308,-5.56,5153,5500
وفتخارح,ح . سرمايه گذاري افتخار سهام,307,15211839,27000542516,1765,1720,1817,52,2.95,1775,10,0.57,1713,1817
بايكا,كارخانجات كابلسازي ‌ايران‌,305,637590,11602681600,18170,18700,18200,30,0.17,18200,30,0.17,17650,18710
رابين,صندوق س. توسعه افق رابين-د,303,83189999,831899990000,10000,10000,10000,0,0,10000,0,0,10000,10000
ما,بيمه  ما,302,2574378,8727552651,3343,3510,3373,30,0.9,3370,27,0.81,3215,3510
ضجار2022,اختيارخ وتجارت-1500-1402/02/20,301,31685,18657704000,645,675,577,-68,-10.54,589,-56,-8.68,550,675
وارس,سرمايه گذاري ارس صبا,300,1659910,28632202170,17480,17710,17030,-450,-2.57,17250,-230,-1.32,16960,17710
حبندرح,ح.دريايي وكشتيراني خط دريابندر,298,1353107,14629218200,10830,10650,10700,-130,-1.2,10810,-20,-0.18,10650,10950
سغرب,سيمان‌غرب‌,296,1543476,38152892170,25700,25420,25000,-700,-2.72,24720,-980,-3.81,24500,25420
مدير,ص.س.مديريت ثروت ص.بازنشستگي-س,288,2609336,31480513643,12087,12210,12000,-87,-0.72,12065,-22,-0.18,11910,12300
كاريس,صندوق س.سپند كاريزما-س,288,1716577,29854984833,17527,17480,17377,-150,-0.86,17392,-135,-0.77,17257,17699
ماني,صندوق س. با درآمد ثابت ماني,285,8978427,120118398367,13358,13379,13378,20,0.15,13379,21,0.16,13378,13380
فردا,صندوق س آواي فرداي زاگرس-ثابت,284,10475150,157844390072,15043,15068,15070,27,0.18,15068,25,0.17,15068,15070
باران,بيمه زندگي باران,283,3912354,15558580243,3985,4076,3928,-57,-1.43,3977,-8,-0.2,3891,4076
فغدير,آهن و فولاد غدير ايرانيان,279,1150034,18717141160,16450,16580,16210,-240,-1.46,16280,-170,-1.03,16040,16970
گنج,صندوق س. طلا كيميا زرين كاردان,276,1689733,31436872448,17247,18497,18955,1708,9.9,18605,1358,7.87,17916,18971
كصدف,كاشي صدف سرام استقلال آباده,274,1338780,35079718350,26100,26750,26450,350,1.34,26200,100,0.38,25350,26800
گوهران,سرمايه گذاري توسعه گوهران اميد,268,1434370,7017582374,4924,4900,4900,-24,-0.49,4909,-15,-0.3,4866,4977
غگزح,ح . گز سكه,265,13000000,20878000000,1530,1606,1606,76,4.97,1606,76,4.97,1606,1606
ويسا,سرمايه گذاري ايساتيس پويا,265,1319462,8369918750,6500,6650,6310,-190,-2.92,6370,-130,-2,6310,6650
نخل,صندوق س.خليج فارس-د,265,39795575,398235620090,10179,10007,10008,-171,-1.68,10007,-172,-1.69,10006,10009
تسه1400,امتيازتسهيلات مسكن سال1400,263,2991,3498086119,1201375,1173070,1200000,-1375,-0.11,1169537,-31838,-2.65,1141307,1210000
وامير,گروه صنعتي و معدني امير,261,273919,83186159300,294950,303750,303750,8800,2.98,303700,8750,2.97,299700,303750
لوتوس,تامين سرمايه لوتوس پارسيان,259,2241166,11222011098,4988,4990,5000,12,0.24,4992,4,0.08,4938,5070
سمازن,سيمان‌مازندران‌,256,625225,10302927160,16760,16880,16490,-270,-1.61,16580,-180,-1.07,16200,16930
سقاين,سيمان‌ قائن‌,256,210443,11015177100,53480,53000,52300,-1180,-2.21,52630,-850,-1.59,51760,54490
دپارس,پارس‌ دارو,255,475353,19974961050,42190,43000,41600,-590,-1.4,42020,-170,-0.4,41170,43690
ضستا0105,اختيارخ شستا-1100-1402/01/09,254,66247,7375475000,142,120,104,-38,-26.76,111,-31,-21.83,98,120
ضستا1106,اختيارخ شستا-1100-1401/11/05,252,89720,1784405000,38,37,20,-18,-47.37,20,-18,-47.37,15,37
تسه0011,امتيازتسهيلات مسكن بهمن 1400,243,2431,2898176689,1196680,1136847,1256044,59364,4.96,1192175,-4505,-0.38,1136847,1256514
آساس,صندوق س.آسمان آرماني سهام-س,242,113672,28689727931,253043,254998,250777,-2266,-0.9,252390,-653,-0.26,248000,254998
كقزوي,شيشه‌ قزوين‌,242,4284517,81063061640,18370,18920,18920,550,2.99,18920,550,2.99,18920,18920
تپولا,مهندسي مرآت پولاد,242,1024805,20760686890,19690,20240,20280,590,3,20260,570,2.89,19900,20280
ارزش,صندوق س ارزش آفرين بيدار-سهام,240,1933511,26715301810,13900,13930,13790,-110,-0.79,13820,-80,-0.58,13740,14080
سدشت,صنايع سيمان دشتستان,238,452050,14021721050,29610,30970,31090,1480,5,30870,1260,4.26,30120,31090
غمهرا,توليدي‌مهرام‌,238,1530896,11789255980,7780,7600,7700,-80,-1.03,7720,-60,-0.77,7540,7880
ضخاو1207,اختيارخ وخاور-5000-1401/12/01,238,36906,4128469000,151,160,108,-43,-28.48,112,-39,-25.83,90,160
حگهر,حمل و نقل گهرترابر سيرجان,237,2477429,28173723680,10860,11100,11400,540,4.97,11370,510,4.7,11050,11560
سفار,سيمان‌فارس‌,234,319470,29710710000,88580,93000,93000,4420,4.99,93000,4420,4.99,93000,93000
ضسپا1209,اختيارخ خساپا-2800-1401/12/10,233,61504,8950325000,203,172,144,-59,-29.06,146,-57,-28.08,122,175
سفارود,كارخانه فارسيت درود,233,917768,12491906430,13370,13630,13610,240,1.8,13610,240,1.8,13360,13630
هامرز2,صندوق س اعتماد هامرز-ثابت,230,23000000,23000000,10081,1,1,-10080,-99.99,1,-10080,-99.99,1,1
وصندوق,سرمايه‌گذاري‌صندوق‌بازنشستگي‌,228,1666329,24625061230,14840,14980,14780,-60,-0.4,14830,-10,-0.07,14550,14980
بنيرو,نيروترانس‌,226,1732145,5530414938,3212,3130,3199,-13,-0.4,3205,-7,-0.22,3130,3300
سهرمز,سيمان‌هرمزگان‌,225,410927,11462376320,28140,27500,28090,-50,-0.18,27950,-190,-0.68,27500,28460
دكيمي,كيميدارو,223,2102974,71143610420,31620,33830,33830,2210,6.99,33830,2210,6.99,33830,33830
فبستم,صنايع ‌بسته‌بندي‌ مشهد,223,592691,8161961110,14160,14220,13740,-420,-2.97,13830,-330,-2.33,13740,14390
تكشا,گسترش‌صنايع‌وخدمات‌كشاورزي‌,222,832648,22339945840,25560,26830,26830,1270,4.97,26830,1270,4.97,26830,26830
ومشان,س. فني و مهندسي مشانير,220,313791,33463752200,109600,106350,106350,-3250,-2.97,106650,-2950,-2.69,106350,110000
ضسپا1208,اختيارخ خساپا-2600-1401/12/10,220,47345,9074980000,268,227,179,-89,-33.21,192,-76,-28.36,162,230
اوصتا,صندوق انديشه ورزان صباتامين -د,217,96841051,2531235703051,26090,26138,26139,49,0.19,26138,48,0.18,26138,26139
آوند2,صندوق س. آوند مفيد-د,216,21600000,21600000,11017,1,1,-11016,-99.99,1,-11016,-99.99,1,1
ضسپا1210,اختيارخ خساپا-3000-1401/12/10,211,68806,7986626000,159,157,131,-28,-17.61,116,-43,-27.04,92,159
ثاژن,سخت آژند,211,1571420,7976293620,5059,5160,5080,21,0.42,5080,21,0.42,4960,5160
گپارس,امور رفاهي كارگزاران پارس,208,87373,11660161200,130750,134650,134650,3900,2.98,133450,2700,2.07,129500,134650
ضجار2026,اختيارخ وتجارت-1900-1402/02/20,204,30895,10602282000,412,400,340,-72,-17.48,343,-69,-16.75,301,400
كاج,صندوق س. نوع دوم نو ويرا -د,198,35395131,374503374869,10561,10581,10581,20,0.19,10581,20,0.19,10580,10581
فيروزه,صندوق شاخص30 شركت فيروزه- سهام,195,1294059,27101812530,21500,21500,20700,-800,-3.72,20940,-560,-2.6,20100,21700
دشيمي,شيمي‌ داروئي‌ داروپخش‌,192,5153812,130543844440,24140,25340,23480,-660,-2.73,25330,1190,4.93,23470,25340
خاتم,صندوق س خاتم ايساتيس پويا-ثابت,192,2122314,32662671787,15372,15390,15390,18,0.12,15390,18,0.12,15390,15391
سپيدما,صندوق س. سپيد دماوند-د,191,31788864,457105573408,14362,14379,14380,18,0.13,14379,17,0.12,14379,14380
شساخت,مهندسي و ساختمان صنايع نفت,191,362278,13729818300,38950,38250,37800,-1150,-2.95,38550,-400,-1.03,37800,38950
كاردان,صندوق س تجارت شاخصي كاردان,189,80410,20181778330,257970,257000,250120,-7850,-3.04,250990,-6980,-2.71,245080,258000
خليبل,ماليبل سايپا,188,739923,19829936400,26050,26800,26800,750,2.88,26800,750,2.88,26800,26800
زعف0210پ20,زعفران0210نگين وحدت جام(پ),188,87014,26301995471,295717,295000,300400,4683,1.58,302273,6556,2.22,295000,320629
گوهر2,صندوق سكه طلاي كيان,185,1850000,1850000,102055,1,1,-102054,-100,1,-102054,-100,1,1
دهدشت,صنايع پتروشيمي دهدشت,185,2128160,25033711740,12110,11800,11750,-360,-2.97,11760,-350,-2.89,11750,11920
ضستا0106,اختيارخ شستا-1200-1402/01/09,185,64855,6602097000,105,109,98,-7,-6.67,102,-3,-2.86,87,113
ضستا1107,اختيارخ شستا-1200-1401/11/05,182,94722,610393000,13,18,5,-8,-61.54,6,-7,-53.85,4,18
سغدير,توسعه سرمايه و صنعت غدير,182,1671821,11635707440,7010,7270,6890,-120,-1.71,6980,-30,-0.43,6850,7270
ضجار2020,اختيارخ وتجارت-1300-1402/02/20,180,14008,9725669000,773,761,680,-93,-12.03,694,-79,-10.22,670,761
وپخش,داروپخش‌ (هلدينگ‌,179,532954,21210102710,40340,40020,40450,110,0.27,40140,-200,-0.5,39000,40450
كگهر,سنگ آهن گهرزمين,177,161426,7181321450,45250,46250,43950,-1300,-2.87,45200,-50,-0.11,43600,46250
ساروج,بين المللي ساروج بوشهر,176,400251,10421144600,26250,25800,26400,150,0.57,26100,-150,-0.57,25400,26700
مارون,پتروشيمي مارون,176,78780,14344205100,177700,177850,182850,5150,2.9,178300,600,0.34,177850,183000
هامرز,صندوق س اعتماد هامرز-ثابت,176,12629013,127553538521,10081,10100,10101,20,0.2,10100,19,0.19,10100,10101
اخزا101,اسناد خزانه-م1بودجه01-040326,176,638400,352688940000,551680,551090,554990,3310,0.6,552460,780,0.14,551010,554990
سجام,مجتمع سيمان غرب آسيا,175,2184130,5023436796,2325,2330,2310,-15,-0.65,2312,-13,-0.56,2260,2380
دروز,داروسازي‌ روزدارو,174,483001,10096750270,21260,21500,20870,-390,-1.83,21020,-240,-1.13,20590,21500
آوا,صندوق س.سهام آواي معيار-س,174,1986523,18543505390,9446,9412,9466,20,0.21,9335,-111,-1.18,9300,9467
سلام,صندوق س سلام فارابي-سهام,174,2037651,22718100280,11430,11390,11100,-330,-2.89,11150,-280,-2.45,11030,11390
سپ,پرداخت الكترونيك سامان كيش,170,283676,4736018680,17010,16700,16630,-380,-2.23,16990,-20,-0.12,16550,16900
تسه0010,امتيازتسهيلات مسكن دي1400,169,2133,2567164611,1199974,1190000,1200005,31,0,1203546,3572,0.3,1171055,1259972
شكف,كف,169,132362,5518837400,40900,41700,41700,800,1.96,41700,800,1.96,41000,41700
ضخود1206,اختيارخ خودرو-2200-1401/12/03,168,28345,31290146000,1196,1220,1070,-126,-10.54,1104,-92,-7.69,1030,1240
گوهرانح,ح . س. توسعه گوهران اميد,168,2501907,6881012395,2713,2719,2680,-33,-1.22,2750,37,1.36,2621,2846
جهرم,پتروشيمي جهرم,168,5771632,5448420608,917,944,944,27,2.94,931,14,1.53,944,944
تسه0009,امتيازتسهيلات مسكن آذر 1400,166,1928,2303578691,1185397,1137010,1201000,15603,1.32,1194802,9405,0.79,1137010,1244666
ساراب,سيمان‌ داراب‌,166,543785,12473192580,23290,23350,23100,-190,-0.82,22990,-300,-1.29,22190,23390
آرمان,بيمه آرمان,164,3010971,15934066080,5450,5300,5300,-150,-2.75,5290,-160,-2.94,5290,5300
وسنا,سرمايه گذاري نيروگاهي ايران,161,977693,9216976100,9670,9500,9380,-290,-3,9500,-170,-1.76,9380,9690
فكمند,گسترش قطعه سازي كمند,161,1577531,68701475050,42300,43550,43550,1250,2.96,43550,1250,2.96,43550,43550
ضهرم1205,اختيارخ اهرم-11000-1401/12/22,160,3710,13759711000,4324,4300,3590,-734,-16.98,3709,-615,-14.22,3453,4300
دفرا,فرآورده‌هاي‌ تزريقي‌ ايران‌,157,428167,11935898110,26940,28280,27720,780,2.9,27660,720,2.67,27010,28280
وسالت,بانك قرض الحسنه رسالت,157,151917,10725340200,72750,70600,70600,-2150,-2.96,70600,-2150,-2.96,70600,70600
وامين,س. امين توان آفرين ساز,156,308770,3577084620,11300,11630,11630,330,2.92,11320,20,0.18,11310,11630
تاتمس,كارخانجات صنعتي وتوليدي اتمسفر,155,61729,7020237200,113300,115450,113000,-300,-0.26,113750,450,0.4,111150,115500
فخاسح,ح . فولاد خراسان,155,2113206,21107014000,9980,10000,9850,-130,-1.3,9990,10,0.1,9680,10100
كازرو,پتروشيمي كازرون,154,2563216,31429793490,12600,12410,12250,-350,-2.78,12260,-340,-2.7,12230,12550
تسه0006,امتيازتسهيلات مسكن شهريور1400,153,2015,2377183609,1189461,1130110,1200000,10539,0.89,1179744,-9717,-0.82,1130110,1248555
رشد,صندوق س.رشد پايدار آبان-د,150,3068897,30734717813,10196,10013,10021,-175,-1.72,10015,-181,-1.78,10012,10021
رايكا,صندوق س نوع دوم رايكا- ثابت	,149,5584144,59227092656,10591,10607,10606,15,0.14,10606,15,0.14,10606,10607
سباقر,سيمان باقران,145,1819074,26139029710,13960,14350,14370,410,2.94,14370,410,2.94,14350,14370
تسه0008,امتيازتسهيلات مسكن آبان1400,143,1345,1615681626,1187717,1132159,1210000,22283,1.88,1201250,13533,1.14,1132159,1247102
شپاس,نفت پاسارگاد,142,2385687,45351909870,18110,19010,19010,900,4.97,19010,900,4.97,19010,19010
تسه0001,امتيازتسهيلات مسكن فروردين1400,137,1311,1612167927,1227879,1230001,1243042,15163,1.23,1229724,1845,0.15,1190022,1250000
ممسني,پتروشيمي ممسني,135,2420942,31267280770,13300,13350,12910,-390,-2.93,12920,-380,-2.86,12910,13350
شكبير,پتروشيمي اميركبير,134,402791,33423954500,84550,84250,82050,-2500,-2.96,84000,-550,-0.65,82050,85850
وشمال,س. چشم انداز توسعه شمال,131,303223,6322199550,20490,20850,20850,360,1.76,20850,360,1.76,20850,20850
پشاهن,توليدي پلاستيك‌ شاهين,128,230681,15640171800,65850,67800,67800,1950,2.96,67800,1950,2.96,67800,67800
تسه9912,امتياز تسهيلات مسكن اسفند99,127,1402,1710900034,1218300,1230000,1240253,21953,1.8,1220328,2028,0.17,1183099,1244676
ضستا6003,اختيارخ شستا-765-1402/06/08,125,18515,7546475000,465,431,410,-55,-11.83,408,-57,-12.26,388,449
وكار,بانك‌ كارآفرين‌,124,1178850,3860374285,3246,3320,3270,24,0.74,3248,2,0.06,3270,3320
حپارسا,توسعه حمل و نقل ريلي پارسيان,123,261691,12748257200,48850,49900,49500,650,1.33,48750,-100,-0.2,47700,50000
اخزا002,اسنادخزانه-م2بودجه00-031024,122,164700,101692751000,614760,613000,617600,2840,0.46,617440,2680,0.44,612520,618390
زعف0210پ05,زعفران0210نگين زرين(پ),122,64635,19692792734,298897,300000,303114,4217,1.41,304677,5780,1.93,300000,310000
ضخود3072,اختيارخ خودرو-3500-1402/03/03,121,19888,12020964000,671,690,638,-33,-4.92,604,-67,-9.99,550,690
وسين,بيمه سينا,120,4387441,9029353578,1999,2058,2058,59,2.95,2051,52,2.6,2058,2058
سامانح,ح. بانك سامان,119,3668176,5454577712,1444,1487,1487,43,2.98,1487,43,2.98,1487,1487
دريا,صندوق س درياي آبي فيروزه-سهام,119,518598,6029385040,11660,11650,11610,-50,-0.43,11630,-30,-0.26,11380,12120
تسه0007,امتيازتسهيلات مسكن مهر1400,118,835,987294472,1192456,1136836,1200000,7544,0.63,1182389,-10067,-0.84,1136836,1252078
قصفها,قنداصفهان‌,118,127667,12330078860,91990,96580,96580,4590,4.99,95580,3590,3.9,96580,96580
انار,صندوق س.انارنماد ارزش-درسهام,118,388922,5242982510,13520,13590,13350,-170,-1.26,13480,-40,-0.3,13310,13650
تسه9911,امتياز تسهيلات مسكن بهمن99,118,1116,1333480190,1186261,1180014,1203019,16758,1.41,1194875,8614,0.73,1170011,1210000
ولقمان,سرمايه گذاري لقمان,118,1399593,6567617104,4726,4612,4651,-75,-1.59,4704,-22,-0.47,4610,4735
ضستا1207,اختيارخ شستا-1200-1401/12/03,118,28068,1453607000,59,60,53,-6,-10.17,52,-7,-11.86,40,61
پاداش,صندوق س. ارزش پاداش-د,117,3329287,34117379209,10235,10247,10248,13,0.13,10248,13,0.13,10247,10248
سخند,صندوق س.سپهرخبرگان نفت-د,116,899392,8096245494,8938,8901,9000,62,0.69,9002,64,0.72,8901,9052
كارين2,صندوق س نگين سامان-ثابت,114,11303392,11303392,10176,1,1,-10175,-99.99,1,-10175,-99.99,1,1
قاروم,قند اروميه,114,18313,2472055750,133400,136050,133850,450,0.34,133800,400,0.3,132150,136050
ضخود1212,اختيارخ خودرو-3500-1401/12/03,114,20677,6130638000,310,369,289,-21,-6.77,296,-14,-4.52,210,369
فيروزه2,صندوق شاخص30 شركت فيروزه- سهام,111,1100358,1100358,21500,1,1,-21499,-100,1,-21499,-100,1,1
فنرژي,گسترش صنايع انرژي آذرآب,110,475872,8470521600,18160,17800,17800,-360,-1.98,17800,-360,-1.98,17800,17800
كهرام,توليدي گرانيت بهسرام,107,84780,4892738850,58850,57700,57700,-1150,-1.95,57700,-1150,-1.95,57700,57950
عميلگرد2,سلف ميلگرد آتيه خاورميانه2,107,1063247,1999999504410,1881030,1881030,1881030,0,0,1881030,0,0,1881030,1881030
ضستا1204,اختيارخ شستا-900-1401/12/03,107,13315,2239466000,208,226,190,-18,-8.65,168,-40,-19.23,150,226
تسه0002,امتيازتسهيلاتمسكن ارديبهشت1400,106,734,904469550,1227725,1240000,1243336,15611,1.27,1232247,4522,0.37,1220000,1243440
ضخود1208,اختيارخ خودرو-2600-1401/12/03,105,6317,4923005000,852,910,717,-135,-15.85,779,-73,-8.57,700,910
ضخود1210,اختيارخ خودرو-3000-1401/12/03,104,12844,6407773000,568,521,430,-138,-24.3,499,-69,-12.15,428,594
سلام2,صندوق س سلام فارابي-سهام,100,1000000,1000000,11430,1,1,-11429,-99.99,1,-11429,-99.99,1,1
تسه0003,امتيازتسهيلات مسكن خرداد1400,98,729,881437516,1227216,1230011,1240010,12794,1.04,1209105,-18111,-1.48,1165856,1240021
صنم,ص.س.صندوق در صندوق صنم,94,806068,10578775429,13142,13349,13250,108,0.82,13124,-18,-0.14,12970,13349
ضخاور1103,اختيارخ خاور-2200-14011109,92,7294,11014076000,1584,1552,1520,-64,-4.04,1510,-74,-4.67,150,1552
ددام,داروسازي زاگرس فارمد پارس,91,391939,4185908520,10180,10680,10680,500,4.91,10310,130,1.28,10680,10680
سيدكو,سرمايه گذاري توسعه صنايع سيمان,91,589927,5869255180,10090,10200,9780,-310,-3.07,10060,-30,-0.3,9780,10330
تسه0005,امتيازتسهيلات مسكن مرداد 1400,91,634,752214152,1185482,1130002,1200000,14518,1.22,1186458,976,0.08,1130002,1244000
سيستم,همكاران سيستم,90,530821,4092362050,7650,7850,7700,50,0.65,7660,10,0.13,7650,7890
ضسپا3027,اختيارخ خساپا-2600-1402/03/24,89,14087,5811653000,561,358,400,-161,-28.7,413,-148,-26.38,354,619
كيا,كيا الكترود شرق,88,1359137,11290546791,7926,8200,8320,394,4.97,8307,381,4.81,8150,8322
فسديد,لوله‌وتجهيزات‌ سديد - ورشكسته,88,64776,4070482450,62250,62850,62850,600,0.96,62850,600,0.96,62700,62850
ضصاد1124,اختيارخ وبصادر-1400-1401/11/19,85,17547,9103608000,583,470,540,-43,-7.38,519,-64,-10.98,470,620
ساحل,صندوق س.اوراق دولت خليج فارس-د,85,4474618,49102852323,10955,10974,10974,19,0.17,10974,19,0.17,10973,10974
ثاصفا,شركت‌ ساختمان‌ اصفهان‌,84,165179,2632961310,15550,16010,15500,-50,-0.32,15650,100,0.64,15500,16010
فلامي,لاميران‌,84,622829,13362188840,20980,21310,21470,490,2.34,21390,410,1.95,21300,21990
فسا,پتروشيمي فسا,83,3407672,3240696072,924,951,951,27,2.92,933,9,0.97,951,951
ثتوسا,س.توسعه و عمران استان اردبيل,82,289529,5628443760,18880,19440,19440,560,2.97,19220,340,1.8,19440,19440
سهگمت,سيمان‌هگمتان‌,82,360742,14289414170,39450,39740,39660,210,0.53,39600,150,0.38,39500,39760
ضخود1204,اختيارخ خودرو-1900-1401/12/03,81,13449,18058274000,1496,1500,1240,-256,-17.11,1343,-153,-10.23,1210,1500
تسه0004,امتيازتسهيلات مسكن تير1400,81,677,807689189,1209996,1149500,1240000,30004,2.48,1193042,-16954,-1.4,1149500,1240000
زعف0210پ18,زعفران0210نگين بهرامن(پ),80,37152,11197157526,297455,299998,304798,7343,2.47,301388,3933,1.32,299684,306999
فلات,گروه صنايع معادن فلات ايرانيان,79,414559,10882173750,25500,26250,26250,750,2.94,26250,750,2.94,26250,26250
ضملت3020,اختيارخ وبملت-2227-1402/03/28,76,7244,8527620000,1053,1125,1190,137,13.01,1177,124,11.78,1123,1239
يارا,صندوق س. آريا-د,76,1701231,21735638925,12753,12776,12777,24,0.19,12776,23,0.18,12776,12777
دارا,صندوق س. دارا الگوريتم-د,75,4911711,49142743251,10163,10006,10005,-158,-1.55,10005,-158,-1.55,10005,10006
ضشنا2025,اختيارخ شپنا-5859-1402/02/24,75,2827,5016361000,1860,2270,1790,-70,-3.76,1774,-86,-4.62,226,2270
ضجار2027,اختيارخ وتجارت-2000-1402/02/20,74,7308,2276484000,379,350,249,-130,-34.3,312,-67,-17.68,249,360
طخود1207,اختيارف خودرو-2400-1401/12/03,74,12731,556675000,54,50,40,-14,-25.93,44,-10,-18.52,35,50
داريك,صندوق س.اعتماد داريك-د,72,1500788,21681376754,14436,14447,14446,10,0.07,14447,11,0.08,14446,14448
زعف0210پ16,زعفران0210نگين بيرجند(پ),71,28844,8659510063,297921,303996,300000,2079,0.7,300219,2298,0.77,298806,303996
تداوم,صندوق تداوم اطمينان تمدن-ثابت,70,2685895,27093435634,10071,10087,10089,18,0.18,10087,16,0.16,10087,10089
دسينا,داروسازي‌ سينا,70,2080769,19829728570,9080,9530,9530,450,4.96,9530,450,4.96,9530,9530
ضدي215,اختيارخ دي-1400-14020217,70,9515,939329000,103,101,89,-14,-13.59,99,-4,-3.88,89,101
ضستا1203,اختيارخ شستا-800-1401/12/03,70,11576,2932634000,306,315,245,-61,-19.93,253,-53,-17.32,230,316
سمتاز,سيمان ممتازان كرمان,69,414274,14746855350,34600,35600,35600,1000,2.89,35600,1000,2.89,35300,35600
ضستا6006,اختيارخ شستا-1065-1402/06/08,69,6405,1631721000,290,290,262,-28,-9.66,255,-35,-12.07,238,300
تكنو,تكنوتار,68,1248854,13150432620,10030,10530,10530,500,4.99,10450,420,4.19,10530,10530
ترمه,صندوق سرمايه گذاري ترمه-سهام	,68,74329,800367660,10990,11050,10730,-260,-2.37,10770,-220,-2,10600,11050
اخزا001,اسنادخزانه-م1بودجه00-030821,68,352800,227312663000,641830,640820,644000,2170,0.34,644310,2480,0.39,640820,645000
برن0204پ01,برنج طارم0204تجارت مازندران(پ),66,3852,3204001587,838664,858000,832000,-6664,-0.79,831776,-6888,-0.82,830000,858000
كساپا,سايپاشيشه‌,64,746031,18367283220,23450,24620,24620,1170,4.99,24620,1170,4.99,24620,24620
شگامرن,مجتمع پترو صنعت گامرون,64,20869,7258838701,331982,348581,348581,16599,5,347829,15847,4.77,339713,348581
اخزا103,اسناد خزانه-م3بودجه01-040520,64,107000,56989128000,531830,532000,530360,-1470,-0.28,532610,780,0.15,528530,533500
شزنگ,تجهيزنيروي‌زنگان‌,62,55688,3962201200,69800,71150,71150,1350,1.93,70850,1050,1.5,71150,71150
ضستا6005,اختيارخ شستا-965-1402/06/08,62,4945,1415562000,332,320,300,-32,-9.64,286,-46,-13.86,210,334
سكرما,سيمان‌ كرمان‌,62,250148,4415194490,17740,17330,17750,10,0.06,17710,-30,-0.17,17330,18430
لبخند2,صندوق س. لبخند فارابي-د,60,6000000,6000000,10880,1,1,-10879,-99.99,1,-10879,-99.99,1,1
ضخاور1104,اختيارخ خاور-2400-14011109,60,7956,10348396000,1423,1302,1300,-123,-8.64,1301,-122,-8.57,1300,1340
ضدي202,اختيارخ دي-550-14020217,60,8368,3274200000,425,425,395,-30,-7.06,391,-34,-8,377,430
ضسپا1203,اختيارخ خساپا-1800-1401/12/10,59,6293,3733944000,786,700,615,-171,-21.76,593,-193,-24.55,540,700
ضستا6010,اختيارخ شستا-1465-1402/06/08,58,4052,593475000,164,183,154,-10,-6.1,146,-18,-10.98,131,183
فاما,صنعتي‌ آما,57,930689,6915019270,6950,7430,7430,480,6.91,7160,210,3.02,7430,7430
اخزا005,اسنادخزانه-م5بودجه00-030626,56,139500,93305188000,666310,666620,666640,330,0.05,668850,2540,0.38,666620,670000
فالوم,آلومتك‌,56,400883,3784335520,9170,9440,9440,270,2.94,9270,100,1.09,9440,9440
ضخود1207,اختيارخ خودرو-2400-1401/12/03,55,3043,2729363000,1007,1000,910,-97,-9.63,897,-110,-10.92,791,1000
ضستا6007,اختيارخ شستا-1165-1402/06/08,55,5803,1135320000,288,279,218,-70,-24.31,196,-92,-31.94,167,279
ضستا0107,اختيارخ شستا-1300-1402/01/09,54,9020,747458000,89,81,75,-14,-15.73,83,-6,-6.74,75,100
زعف0210پ09,زعفران0210نگين نوين(پ)	,54,41359,12466168056,297810,298501,301060,3250,1.09,301414,3604,1.21,298000,306000
ضهرم1207,اختيارخ اهرم-13000-1401/12/22,54,5196,12175597000,2564,2700,2350,-214,-8.35,2343,-221,-8.62,2100,2700
اخزا006,اسنادخزانه-م6بودجه00-030723,53,315500,206919354000,653190,653000,655310,2120,0.32,655850,2660,0.41,653000,656980
صايند,صندوق س. گنجينه آينده روشن-د,53,228917,2315539513,10102,10100,10125,23,0.23,10115,13,0.13,10092,10133
خبنيان,بنيان ديزل,53,290127,3052136040,10840,10520,10520,-320,-2.95,10840,0,0,10520,10520
گنگين,اقتصادي نگين گردشگري ايرانيان,52,1674143,62738343150,36950,38050,36750,-200,-0.54,37450,500,1.35,36150,38050
اخزا0022,اسنادخزانه-م2بودجه00-031024,51,1625,1000112080,614760,611120,616400,1640,0.27,615450,690,0.11,611120,618000
زرين,صندوق س. سهام زرين كوروش-س,51,171759,2565327373,15152,15020,14713,-439,-2.9,14936,-216,-1.43,14707,15020
ضسپا3025,اختيارخ خساپا-2200-1402/03/24,50,3998,2785546000,836,722,680,-156,-18.66,697,-139,-16.63,617,800
ولانا,شركت ليزينگ آريا دانا,49,174428,4116500800,22950,23600,23600,650,2.83,23200,250,1.09,23600,23600
آتيمس,صندوق س.آرمان آتيه درخشان مس-س,48,16346,3661290185,227097,226200,222629,-4468,-1.97,223987,-3110,-1.37,222240,226200
ضخاور1107,اختيارخ خاور-3000-14011109,47,3845,2782465000,808,808,720,-88,-10.89,724,-84,-10.4,700,850
هپارس029,اختيارف ت­ وپارس-2000-02/09/08,46,398308,398308,1,1,1,0,0,1,0,0,1,1
آسام,صندوق س.آرمان سپهر آشنا-م,45,55372,917209821,16397,16500,16726,329,2.01,16565,168,1.02,16400,16727
طلا2,صندوق س.پشتوانه طلاي لوتوس,45,4500000,4500000,147483,1,1,-147482,-100,1,-147482,-100,1,1
اخزا007,اسنادخزانه-م7بودجه00-030912,45,92600,58886611000,632620,633000,635400,2780,0.44,635920,3300,0.52,633000,653100
پلوله,گازلوله‌,45,376709,11225928200,28950,29800,29800,850,2.94,29800,850,2.94,29800,29800
ضستا1105,اختيارخ شستا-1000-1401/11/05,44,8167,625515000,115,72,71,-44,-38.26,77,-38,-33.04,65,86
ارمغان,ص سرمايه گذاري ارمغان ايرانيان,43,692753,6975642203,10056,10070,10079,23,0.23,10069,13,0.13,10069,10081
دحاوي,الحاوي,43,385653,4230613410,10660,10970,10970,310,2.91,10790,130,1.22,10970,10970
سنوين,سرمايه گذاري اقتصاد نوين,43,548389,3186140090,5650,5810,5810,160,2.83,5700,50,0.88,5810,5810
افق ملت,صندوق س در سهام افق ملت,42,10090,1765075110,175510,176000,174000,-1510,-0.86,174930,-580,-0.33,174000,176000
وآتوس,توسعه س. كشاورزي آرين توسكا,42,118005,16455797250,135400,139450,139450,4050,2.99,139450,4050,2.99,139450,139450
ضخود3070,اختيارخ خودرو-3000-1402/03/03,42,862,764597000,915,910,830,-85,-9.29,887,-28,-3.06,812,1000
رماس,صندوق س.راهبرد ممتازابن سينا-س,40,80461,1050109709,13425,12500,13001,-424,-3.16,13051,-374,-2.79,12500,13358
زعف0210پ19,زعفران0210نگين تروند قاينات(پ),40,8098,2434751050,298785,301000,300000,1215,0.41,300661,1876,0.63,300000,301515
ضدي207,اختيارخ دي-800-14020217,39,3024,656970000,276,250,201,-75,-27.17,217,-59,-21.38,200,250
لپيام,گسترش صنايع پيام,39,137981,3580606950,25200,25950,25950,750,2.98,25450,250,0.99,25950,25950
ضهاي3000,اختيارخ هاي وب-1845-1402/03/03,39,750,872315396,1218,1202,1140,-78,-6.4,1073,-145,-11.9,1008,1215
اخزا009,اسناد خزانه-م9بودجه00-031101,38,209500,128842157000,610740,612510,615150,4410,0.72,615000,4260,0.7,612510,615180
زعف0210پ08,زعفران0210نگين روستا(پ),38,17512,5296909733,298753,304490,302500,3747,1.25,302473,3720,1.25,300000,304490
ضخود1209,اختيارخ خودرو-2800-1401/12/03,38,3181,1909300000,702,940,594,-108,-15.38,600,-102,-14.53,515,940
ضجار2025,اختيارخ وتجارت-1800-1402/02/20,36,4786,1851804000,451,380,332,-119,-26.39,387,-64,-14.19,332,450
آرمانح,ح.بيمه آرمان,35,119471,478627025,3964,3846,4030,66,1.66,4006,42,1.06,3846,4082
شتولي,تولي‌پرس‌,34,98402,1600016520,15950,16260,16260,310,1.94,16050,100,0.63,16260,16260
وملت,سرمايه گذاري ملت,34,569808,1252437984,2155,2198,2198,43,2,2166,11,0.51,2198,2198
ضسپا3026,اختيارخ خساپا-2400-1402/03/24,34,5983,3116333000,650,506,523,-127,-19.54,521,-129,-19.85,404,540
ضخود1214,اختيارخ خودرو-4000-1401/12/03,34,3252,423214000,126,179,120,-6,-4.76,130,4,3.17,101,179
اخزا0052,اسنادخزانه-م5بودجه00-030626,33,1300,867259820,666310,664820,665370,-940,-0.14,667120,810,0.12,664820,669000
ضهرم1209,اختيارخ اهرم-15000-1401/12/22,33,2398,2582704000,1326,1300,1000,-326,-24.59,1077,-249,-18.78,800,1300
ضهرم1208,اختيارخ اهرم-14000-1401/12/22,33,2300,3659850000,1824,1692,1560,-264,-14.47,1591,-233,-12.77,1361,1800
نگين,ص.س. زمين و ساختمان نگين شهرري,32,14010,1108628630,78390,79290,79360,970,1.24,79130,740,0.94,78300,79360
الماس,صندوق س.امين تدبيرگران فردا-س,32,223715,31096929703,141427,139002,139000,-2427,-1.72,139002,-2425,-1.71,139000,141981
برليان,صندوق سرمايه گذاري برليان-سهام,31,139945,1505763480,11040,10860,10750,-290,-2.63,10760,-280,-2.54,10530,11000
زعف0210پ23,زعفران0210نگين مدبرتوس(پ)	,31,7247,2168898555,295082,298551,299332,4250,1.44,299282,4200,1.42,298040,301179
زعف0210پ11,زعفران0210نگين سحرخيز(پ),31,30924,9915130152,318438,320620,320629,2191,0.69,320629,2191,0.69,320620,320629
سيناد,صندوق س.سپهرسودمند سينا-د,31,2097485,20989872884,10172,10008,10007,-165,-1.62,10007,-165,-1.62,10007,10008
اگ020719,گام بانك صادرات ايران0207,31,15117,12302100197,813406,813406,816250,2844,0.35,813792,386,0.05,813000,816500
ضستا6008,اختيارخ شستا-1265-1402/06/08,31,9975,2223045000,225,210,225,0,0,223,-2,-0.89,193,225
ضترا3024,اختيارخ شتران-4000-1402/03/28,30,808,944404000,1405,1251,1200,-205,-14.59,1169,-236,-16.8,1100,1450
شسم,توليد سموم‌ علف‌ كش,29,4336,1340040800,303000,309050,309050,6050,2,304600,1600,0.53,309050,309050
ضشنا1108,اختيارخ شپنا-8000-1401/11/19,28,3242,1284475000,399,500,331,-68,-17.04,396,-3,-0.75,301,500
ضچكا1208,اختيارخ چكاپا-3250-1401/12/07,28,1420,297669000,310,230,200,-110,-35.48,210,-100,-32.26,200,230
اخزا010,اسناد خزانه-م10بودجه00-031115,28,55500,33793566700,606915,607980,608101,1186,0.2,608893,1978,0.33,607980,609500
ضستا6001,اختيارخ شستا-565-1402/06/08,27,491,286053000,633,625,588,-45,-7.11,583,-50,-7.9,571,625
بتك,كارخانجات كابل سازي‌ تك‌,27,1436,532468800,378350,370800,370800,-7550,-2,377550,-800,-0.21,370800,370800
وثخوز,سرمايه گذاري و توسعه خوزستان,27,121797,3787886700,30200,31100,31100,900,2.98,30550,350,1.16,31100,31100
اخزا004,اسنادخزانه-م4بودجه00-030522,26,97800,66941684000,682320,679510,684200,1880,0.28,684480,2160,0.32,679510,684900
زعف0210پ25,زعفران0210نگين زرپران (پ),26,2527,758479000,299687,298500,307000,7313,2.44,300150,463,0.15,298000,307000
وبازار,صندوق س شاخصي بازارآشنا,25,126581,1777971530,14280,14100,14000,-280,-1.96,14050,-230,-1.61,13850,14400
ضستا6002,اختيارخ شستا-665-1402/06/08,25,931,464754000,575,550,500,-75,-13.04,499,-76,-13.22,490,554
ضسپا1200,اختيارخ خساپا-1500-1401/12/10,25,1361,1257204000,1145,998,940,-205,-17.9,924,-221,-19.3,701,998
لبوتان,گروه‌صنعتي‌بوتان‌,25,90794,1112320750,12480,12650,12230,-250,-2,12460,-20,-0.16,12220,12650
ضستا1208,اختيارخ شستا-1300-1401/12/03,25,5704,132628000,47,30,25,-22,-46.81,23,-24,-51.06,20,30
طخود1206,اختيارف خودرو-2200-1401/12/03,25,2479,65661000,37,34,23,-14,-37.84,26,-11,-29.73,20,34
ضستا6009,اختيارخ شستا-1365-1402/06/08,25,1820,274988000,232,250,153,-79,-34.05,151,-81,-34.91,125,250
صنوين,صندوق سرمايه‌گذاري صنوين-مختلط,24,4012,555242230,137870,138230,138230,360,0.26,138400,530,0.38,138230,139950
ثروتم,صندوق س. ثروت آفرين پارسيان-س,24,153784,16853004380,111035,111106,108898,-2137,-1.92,109589,-1446,-1.3,107865,111106
ضهرم1204,اختيارخ اهرم-10000-1401/12/22,23,140,663697000,5238,5200,4790,-448,-8.55,4741,-497,-9.49,4250,5200
ضفلا7020,اختيارخ فولاد-1653-1402/07/26,22,11024,53696000000,4000,4000,4000,0,0,4871,871,21.78,4000,5050
ضخاور110,اختيارخ خاور-3500-14020116,22,917,883216000,957,999,820,-137,-14.32,963,6,0.63,820,999
گنجينه,صندوق س. گنجينه داريوش-د,22,5030559,50349506581,10180,10008,10023,-157,-1.54,10009,-171,-1.68,10007,10023
اخزا003,اسنادخزانه-م3بودجه00-030418,22,30400,21250357000,697940,698000,696880,-1060,-0.15,699020,1080,0.15,696880,700980
اخزا1012,اسناد خزانه-م1بودجه01-040326,22,1014,548942240,551680,551000,540010,-11670,-2.12,541360,-10320,-1.87,524110,551620
فردا2,صندوق س آواي فرداي زاگرس-ثابت,21,18712389,18712389,15043,1,1,-15042,-99.99,1,-15042,-99.99,1,1
ضستا1104,اختيارخ شستا-900-1401/11/05,21,2791,388187000,201,290,148,-53,-26.37,139,-62,-30.85,130,290
سكه0312پ01,تمام سكه طرح جديد0312 رفاه,21,6700,13826073100,2060311,2063593,2063593,3282,0.16,2063593,3282,0.16,2063593,2063593
بازده,صندوق س. بازده ثابت-د,21,1189686,12345223613,10358,10376,10378,20,0.19,10377,19,0.18,10376,10378
داريوش,صندوق س. ثروت داريوش -س,21,196134,2468022320,12635,12510,12500,-135,-1.07,12583,-52,-0.41,12400,12675
ضسپا1202,اختيارخ خساپا-1700-1401/12/10,21,1193,877670000,951,900,700,-251,-26.39,736,-215,-22.61,690,900
زعف0210پ22,زعفران0210نگين گليران(پ),20,14618,4667957427,306558,319450,315000,8442,2.75,319329,12771,4.17,315000,320629
ضخود3068,اختيارخ خودرو-2600-1402/03/03,20,210,244971000,1150,1300,1140,-10,-0.87,1167,17,1.48,1140,1300
ضخود3074,اختيارخ خودرو-4000-1402/03/03,20,1454,698580000,507,500,450,-57,-11.24,480,-27,-5.33,450,510
ضجار2023,اختيارخ وتجارت-1600-1402/02/20,19,2024,962704000,530,550,470,-60,-11.32,476,-54,-10.19,451,550
آگاس2,صندوق س.هستي بخش آگاه-س,19,2500000,2500000,100504,1,1,-100503,-100,1,-100503,-100,1,1
ضترا1142,اختيارخ شتران-2781-1401/11/19,18,424,992020070,1304,1450,1430,126,9.66,1446,142,10.89,1430,1549
شليا,شركت مواد ويژه ليا,18,264779,11067762200,40600,41800,41800,1200,2.96,41800,1200,2.96,41800,41800
ضهاي3006,اختيارخ هاي وب-2998-1402/03/03,18,485,185693536,399,340,344,-55,-13.78,353,-46,-11.53,340,400
طهاي3009,اختيارف هاي وب-3690-1402/03/03,18,202,155638552,615,660,990,375,60.98,711,96,15.61,660,990
طخود1204,اختيارف خودرو-1900-1401/12/03,17,968,12929000,19,16,12,-7,-36.84,13,-6,-31.58,3,15
ضدي206,اختيارخ دي-750-14020217,17,779,196451000,290,297,242,-48,-16.55,252,-38,-13.1,241,297
ضسرو1015,اختيارخ سرو-68000-1402/10/06,17,341,143852500,44878,43890,42800,-2078,-4.63,42185,-2693,-6,39904,43890
اخزا0042,اسنادخزانه-م4بودجه00-030522,17,605,412921450,682320,680000,680110,-2210,-0.32,682510,190,0.03,680000,683710
طهاي3006,اختيارف هاي وب-2998-1402/03/03,17,486,127145612,200,240,250,50,25,241,41,20.5,220,250
ضستا0103,اختيارخ شستا-900-1402/01/09,17,535,133565000,276,270,235,-41,-14.86,250,-26,-9.42,235,280
اخزا903,اسنادخزانه-م3بودجه99-011110,16,13500,13396614000,990970,990980,993000,2030,0.2,992340,1370,0.14,990980,993000
مرواريد,صندوق س. مرواريد بها بازار-س,16,122710,1393718630,11376,11410,11120,-256,-2.25,11358,-18,-0.16,11120,11410
اخزا0072,اسنادخزانه-م7بودجه00-030912,16,491,310600040,632620,633000,635910,3290,0.52,632590,-30,0,632000,635910
ضشنا2027,اختيارخ شپنا-6696-1402/02/24,15,584,664612000,1153,1199,1100,-53,-4.6,1138,-15,-1.3,1050,1199
ضخود3067,اختيارخ خودرو-2400-1402/03/03,15,702,894379000,1279,1280,1239,-40,-3.13,1274,-5,-0.39,1238,1282
ضهاي3001,اختيارخ هاي وب-2030-1402/03/03,15,912,1076361052,99,1100,1001,902,911.11,1089,990,1000,1000,1100
زعف0210پ10,زعفران0210نگين طلاي سرخ(پ),15,9800,3142164200,316575,320629,320629,4054,1.28,320629,4054,1.28,320629,320629
ضهاي3010,اختيارخ هاي وب-4152-1402/03/03,15,791,155751288,216,299,180,-36,-16.67,182,-34,-15.74,170,299
ضشنا1105,اختيارخ شپنا-6500-1401/11/19,15,489,675745000,1513,1390,1250,-263,-17.38,1382,-131,-8.66,1250,1400
ضصاد1126,اختيارخ وبصادر-1600-1401/11/19,15,1050,353737000,392,380,320,-72,-18.37,337,-55,-14.03,309,386
ضسپا3020,اختيارخ خساپا-1600-1402/03/24,15,1753,2068555000,1301,1300,1170,-131,-10.07,1180,-121,-9.3,1162,1300
ضصاد1123,اختيارخ وبصادر-1300-1401/11/19,15,934,598673000,674,637,638,-36,-5.34,641,-33,-4.9,575,699
اگ020418,گام بانك تجارت0204,14,134400,119999040000,870000,892850,892850,22850,2.63,892850,22850,2.63,892850,892850
ضملت1143,اختيارخ وبملت-2400-1401/11/24,14,945,1207110000,1236,1100,1200,-36,-2.91,1277,41,3.32,1100,1400
اخزا0012,اسنادخزانه-م1بودجه00-030821,14,435,279376080,641830,641830,642010,180,0.03,642240,410,0.06,641620,643610
ضخود3073,اختيارخ خودرو-3750-1402/03/03,14,1472,908380000,637,650,540,-97,-15.23,617,-20,-3.14,540,650
ضترا1145,اختيارخ شتران-3710-1401/11/19,13,245,238566010,635,650,635,0,0,602,-33,-5.2,500,650
سكه0112پ03,تمام سكه طرح جديد0112سامان,13,3000,6190779000,2060311,2063593,2063593,3282,0.16,2063593,3282,0.16,2063593,2063593
اخزا0062,اسنادخزانه-م6بودجه00-030723,13,728,472707230,653190,621210,653210,20,0,649320,-3870,-0.59,621210,653210
ضشنا1109,اختيارخ شپنا-9000-1401/11/19,13,431,66854000,230,197,60,-170,-73.91,155,-75,-32.61,55,200
ضخود0112,اختيارخ خودرو-3750-1402/01/09,13,2300,611000000,1,270,250,249,24900,266,265,26500,250,270
طسپا1203,اختيارف خساپا-1800-1401/12/10,13,1744,40453000,26,24,23,-3,-11.54,23,-3,-11.54,23,24
كاج2,صندوق س. نوع دوم نو ويرا -د,13,12100000,12100000,10561,1,1,-10560,-99.99,1,-10560,-99.99,1,1
ضصاد1125,اختيارخ وبصادر-1500-1401/11/19,12,582,263723000,481,374,430,-51,-10.6,453,-28,-5.82,374,497
ضخاور1105,اختيارخ خاور-2600-14011109,12,285,324172000,1131,1200,1085,-46,-4.07,1137,6,0.53,1084,1200
ضسپا3029,اختيارخ خساپا-3000-1402/03/24,12,1185,444812000,355,549,399,44,12.39,375,20,5.63,277,549
اخزا008,اسنادخزانه-م8بودجه00-030919,12,60000,37954283000,630270,632600,632500,2230,0.35,632570,2300,0.36,630620,632800
امين يكم2,صندوق درآمد ثابت امين يكم فردا,12,10016026,10016026,10079,1,1,-10078,-99.99,1,-10078,-99.99,1,1
هيوا,صندوق س. ثروت هيوا-س,12,79398,924171897,11687,11702,11688,1,0.01,11640,-47,-0.4,11500,11764
پادا,صندوق س.پاداش سرمايه پارس-س,12,42463,5518628500,129320,130110,130000,680,0.53,129963,643,0.5,127100,131088
ضستر1109,اختيارخ خگستر-3750-1401/11/26,11,247,246500000,1287,1050,900,-387,-30.07,998,-289,-22.46,900,1050
نشان,صندوق س. نشان هامرز-د,11,186169,2155838847,11561,11580,11581,20,0.17,11580,19,0.16,11580,11581
ضفلا1174,اختيارخ فولاد-5500-1401/11/26,11,539,422865000,1289,757,800,-489,-37.94,785,-504,-39.1,740,800
ثنا,صندوق س.زرين نهال ثنا-س,11,17621,205320700,11658,11800,11500,-158,-1.36,11652,-6,-0.05,11500,11800
ضسلا7005,اختيارخ سلام-11000-1402/07/19,11,917,2323412000,2602,2720,2501,-101,-3.88,2534,-68,-2.61,2501,2720
ضهرم1206,اختيارخ اهرم-12000-1401/12/22,11,188,425942000,3231,1003,2400,-831,-25.72,2266,-965,-29.87,1003,2650
كورز,ورزيران‌,10,274,138849500,492000,506750,506750,14750,3,492200,200,0.04,506750,506750
اخزا0032,اسنادخزانه-م3بودجه00-030418,10,400,279043240,697940,690000,697200,-740,-0.11,697610,-330,-0.05,690000,699010
ضترا1144,اختيارخ شتران-3401-1401/11/19,10,162,195863754,915,850,780,-135,-14.75,747,-168,-18.36,700,850
طستا1104,اختيارف شستا-900-1401/11/05,10,2234,3434000,2,2,1,-1,-50,2,0,0,1,2
ويستا,صندوق س. ويستا -س,9,77284,1022655032,13842,13520,13196,-646,-4.67,13232,-610,-4.41,13196,13520
تاراز2,صندوق س آواي تاراز زاگرس-سهام,9,440000,440000,13490,1,1,-13489,-99.99,1,-13489,-99.99,1,1
طشنا1106,اختيارف شپنا-7000-1401/11/19,9,332,46150000,117,160,129,12,10.26,139,22,18.8,100,170
گام020815,گواهي اعتبار مولد سپه0208,9,800000,637256000000,795320,796570,796570,1250,0.16,796570,1250,0.16,796570,796570
اطلس2,صندوق س.توسعه اطلس مفيد-س,9,44000,44000,322461,1,1,-322460,-100,1,-322460,-100,1,1
ضسلا7000,اختيارخ سلام-7000-1402/07/19,9,136,870566000,6517,6512,6350,-167,-2.56,6401,-116,-1.78,6350,6512
ضخود1203,اختيارخ خودرو-1800-1401/12/03,9,217,288937000,1582,1378,1301,-281,-17.76,1332,-250,-15.8,1301,1378
ضپلا1207,اختيارخ پالايش-90000-01/12/16,9,693,208701400,32000,32001,30000,-2000,-6.25,30116,-1884,-5.89,30000,32001
ضهاي3009,اختيارخ هاي وب-3690-1402/03/03,9,305,67858400,247,200,239,-8,-3.24,205,-42,-17,200,239
برن0203پ02,برنج فجر0203 تجارت مازندران(پ),9,373,213287550,571250,574000,570000,-1250,-0.22,571816,566,0.1,565000,574000
ضصاد3026,اختيارخ وبصادر-2000-1402/03/17,9,285,112362000,480,400,390,-90,-18.75,394,-86,-17.92,390,400
تملي107,تسهيلات مسكن ب.ملي-مهر1401,9,102,89158288,919996,874102,874098,-45898,-4.99,874101,-45895,-4.99,874098,874102
ضستا1103,اختيارخ شستا-800-1401/11/05,9,1738,387490000,313,240,207,-106,-33.87,223,-90,-28.75,201,240
بذر,صندوق س بذر اميد آفرين-سهام,9,5399,696375610,129770,129000,127020,-2750,-2.12,128980,-790,-0.61,127020,130500
سنفت009,سلف موازي استاندارد سنفت009,9,704190,1503100596900,1953056,2134510,2134510,181454,9.29,2134510,181454,9.29,2134510,2134510
ضپلا1206,اختيارخ پالايش-80000-01/12/16,9,1488,606762120,38953,41499,39900,947,2.43,40777,1824,4.68,39900,41500
اخزا0082,اسنادخزانه-م8بودجه00-030919,8,297,187322690,630270,629990,630960,690,0.11,630720,450,0.07,629320,631610
ضشنا1107,اختيارخ شپنا-7500-1401/11/19,8,294,175700000,687,750,500,-187,-27.22,598,-89,-12.95,460,750
ضكاريس206,اختيارخ كاريس-17000-14020205,8,195,357751000,2340,2120,1410,-930,-39.74,1835,-505,-21.58,1410,2120
ضترا1147,اختيارخ شتران-4327-1401/11/19,8,165,65792734,316,281,300,-16,-5.06,246,-70,-22.15,151,300
ضخاور1100,اختيارخ خاور-1600-14011109,8,274,595300000,2200,2200,2200,0,0,2173,-27,-1.23,2000,2200
ضخود2036,اختيارخ خودرو-4000-1402/02/13,8,421,126300000,1,300,300,299,29900,300,299,29900,300,300
ضجار2028,اختيارخ وتجارت-2200-1402/02/20,8,233,53788000,337,240,250,-87,-25.82,231,-106,-31.45,220,348
ضستا0104,اختيارخ شستا-1000-1402/01/09,8,1900,318450000,260,198,150,-110,-42.31,168,-92,-35.38,150,198
طستر1113,اختيارف خگستر-5500-1401/11/26,8,7456,7254688000,1,973,973,972,97200,973,972,97200,973,973
ضپلا1210,اختيارخ پالايش-120000-01/12/16,8,3105,251010000,10100,11000,8000,-2100,-20.79,8084,-2016,-19.96,8000,11000
اخزا0102,اسناد خزانه-م10بودجه00-031115,8,436,257727440,606915,606000,589220,-17695,-2.92,591120,-15795,-2.6,578860,606000
گنجين,صندوق س. گنجينه يكم آويد-د,8,498342,8724974904,17484,17508,17508,24,0.14,17508,24,0.14,17508,17514
ضسرو1016,اختيارخ سرو-74000-1402/10/06,8,539,208015980,39495,39600,38600,-895,-2.27,38593,-902,-2.28,37900,39600
ضستا6000,اختيارخ شستا-465-1402/06/08,8,139,98580000,748,750,715,-33,-4.41,709,-39,-5.21,678,750
اخزا0092,اسناد خزانه-م9بودجه00-031101,7,419,253506360,610740,581640,613520,2780,0.46,605030,-5710,-0.93,581640,613520
اوج,صندوق س.اوج دماوند-س,7,6236,70348807,11428,11356,11243,-185,-1.62,11281,-147,-1.29,11243,11357
مكرج112,مشاركت شهرداري كرج-3ماهه18%,7,70000,70000000000,1000000,1000000,1000000,0,0,1000000,0,0,1000000,1000000
اخزا909,اسنادخزانه-م9بودجه99-020316,7,1300,1186426000,911120,912490,914000,2880,0.32,912640,1520,0.17,912490,914000
اگ020318,گام بانك تجارت0203,7,36000,32188680000,892000,894130,894130,2130,0.24,894130,2130,0.24,894130,894130
ضملت1144,اختيارخ وبملت-2600-1401/11/24,7,167,159054000,1129,920,999,-130,-11.51,952,-177,-15.68,900,999
ضسپا1201,اختيارخ خساپا-1600-1401/12/10,7,163,126917000,1053,1000,702,-351,-33.33,779,-274,-26.02,701,1000
ضملت1148,اختيارخ وبملت-3500-1401/11/24,6,453,133986000,324,280,284,-40,-12.35,296,-28,-8.64,280,310
ضخود1213,اختيارخ خودرو-3750-1401/12/03,6,251,46000000,196,160,190,-6,-3.06,183,-13,-6.63,160,190
سكه0111پ05,تمام سكه طرح جديد0111آينده,6,1000,2063593000,2060311,2063593,2063593,3282,0.16,2063593,3282,0.16,2063593,2063593
ثبات2,صندوق س. ثبات ويستا -د,6,57300000,57300000,13335,1,1,-13334,-99.99,1,-13334,-99.99,1,1
اعتماد2,صندوق س.اعتماد آفرين پارسيان-د,6,41800000,41800000,51050,1,1,-51049,-100,1,-51049,-100,1,1
اخزا910,اسنادخزانه-م10بودجه99-020807,6,3700,3066707000,827600,828550,828320,720,0.09,828840,1240,0.15,828230,829000
درسا,صندوق سرمايه گذاري درسا - سهام,6,14213,177206560,12820,12680,12490,-330,-2.57,12470,-350,-2.73,12460,12680
ضفلا1173,اختيارخ فولاد-5000-1401/11/26,6,43,56767000,1485,1290,1340,-145,-9.76,1320,-165,-11.11,1290,1350
اخزا1032,اسناد خزانه-م3بودجه01-040520,6,181,96262150,531830,532990,530310,-1520,-0.29,531840,10,0,530310,532990
اراد107,مرابحه عام دولت107-ش.خ030724,5,700000,633451250000,927000,904750,930000,3000,0.32,904930,-22070,-2.38,904750,930000
طفلا1172,اختيارف فولاد-4500-1401/11/26,5,533,16736000,35,29,24,-11,-31.43,31,-4,-11.43,22,35
ضترا1143,اختيارخ شتران-3090-1401/11/19,5,17,29528500,1151,1150,1000,-151,-13.12,1074,-77,-6.69,1000,1200
ضخود0113,اختيارخ خودرو-4000-1402/01/09,5,401,108235000,275,275,235,-40,-14.55,270,-5,-1.82,235,275
پاداش2,صندوق س. ارزش پاداش-د,5,32000000,32000000,10235,1,1,-10234,-99.99,1,-10234,-99.99,1,1
سپيدما4,صندوق س. سپيد دماوند-د,5,361653000,5200264077000,14362,14379,14378,16,0.11,14379,17,0.12,14378,14380
ضصاد3025,اختيارخ وبصادر-1900-1402/03/17,5,83,29540000,505,450,170,-335,-66.34,356,-149,-29.5,170,450
ضهاي3003,اختيارخ هاي وب-2399-1402/03/03,5,470,483881340,506,835,1000,494,97.63,950,444,87.75,835,1000
ضخود1200,اختيارخ خودرو-1500-1401/12/03,5,16,25299000,1929,1201,1612,-317,-16.43,1581,-348,-18.04,1201,1615
ضخود1202,اختيارخ خودرو-1700-1401/12/03,5,40,53700000,1632,1341,1343,-289,-17.71,1342,-290,-17.77,1341,1343
ضهرم7012,اختيارخ اهرم-18000-1402/07/23,5,294,1173999000,1,3980,4000,3999,399900,3993,3992,399200,3980,4000
طستا1105,اختيارف شستا-1000-1401/11/05,5,350,3400000,30,6,18,-12,-40,10,-20,-66.67,6,18
تاراز,صندوق س آواي تاراز زاگرس-سهام,5,11972,161195350,13490,13630,13240,-250,-1.85,13460,-30,-0.22,13240,13630
ضخاور1102,اختيارخ خاور-2000-14011109,5,93,164740000,1857,1750,1990,133,7.16,1771,-86,-4.63,1750,1990
ضهاي3005,اختيارخ هاي وب-2768-1402/03/03,5,213,115694236,907,679,500,-407,-44.87,501,-406,-44.76,500,679
ضصاد1127,اختيارخ وبصادر-1700-1401/11/19,4,90,18215000,366,210,202,-164,-44.81,202,-164,-44.81,201,210
ضهرم1203,اختيارخ اهرم-9000-1401/12/22,4,68,389000000,6102,5500,6000,-102,-1.67,5721,-381,-6.24,5500,6000
ضبساما305,اختيارخ بساما-12000-14020310,4,78,69580000,922,900,900,-22,-2.39,892,-30,-3.25,890,900
اخزا821,اسنادخزانه-م21بودجه98-020906,4,1400,1139760000,813210,814360,814010,800,0.1,814110,900,0.11,814010,814360
اخزا911,اسنادخزانه-م11بودجه99-020906,4,3400,2770965000,815340,810010,815300,-40,0,814990,-350,-0.04,810010,815310
ضهاي3004,اختيارخ هاي وب-2583-1402/03/03,4,500,331638960,776,600,699,-77,-9.92,612,-164,-21.13,600,699
ضچكا1207,اختيارخ چكاپا-3000-1401/12/07,4,420,129690000,406,369,280,-126,-31.03,309,-97,-23.89,280,369
سنفت010,سلف موازي استاندارد سنفت010,4,253000,499203661000,2007518,1973137,1973137,-34381,-1.71,1973137,-34381,-1.71,1973137,1973137
اخزا908,اسنادخزانه-م8بودجه99-020606,4,100500,86682393000,861860,862510,863490,1630,0.19,862510,650,0.08,862510,863490
ضخود1108,اختيارخ خودرو-2400-1401/11/12,4,200,194000000,971,990,950,-21,-2.16,970,-1,-0.1,950,990
ضخود1109,اختيارخ خودرو-2600-1401/11/12,4,205,160005000,760,790,601,-159,-20.92,781,21,2.76,601,790
ضكاريس207,اختيارخ كاريس-18000-14020205,4,140,185100000,1706,1300,1350,-356,-20.87,1322,-384,-22.51,1300,1350
ضخود3071,اختيارخ خودرو-3250-1402/03/03,4,121,104450000,819,880,780,-39,-4.76,863,44,5.37,780,880
ضجار2024,اختيارخ وتجارت-1700-1402/02/20,4,71,31760000,490,450,450,-40,-8.16,447,-43,-8.78,420,450
ضدي212,اختيارخ دي-1100-14020217,4,270,37200000,160,160,100,-60,-37.5,138,-22,-13.75,100,160
ضجار2018,اختيارخ وتجارت-1100-1402/02/20,4,128,116310000,948,975,860,-88,-9.28,909,-39,-4.11,860,975
اخزا9032,اسنادخزانه-م3بودجه99-011110,4,129,127840090,990970,991000,991000,30,0,991010,40,0,991000,991090
سپر4,صندوق س سپر سرمايه بيدار- ثابت,4,12306000,204195804000,16580,16580,16634,54,0.33,16593,13,0.08,16580,16634
دريا2,صندوق س درياي آبي فيروزه-سهام,4,256843,256843,11660,1,1,-11659,-99.99,1,-11659,-99.99,1,1
ثهام,صندوق س ثروت هامرز-سهام,4,3950,53533100,14050,13580,13420,-630,-4.48,13550,-500,-3.56,13420,13580
ضسپا3019,اختيارخ خساپا-1500-1402/03/24,4,519,648339000,1450,1250,1249,-201,-13.86,1249,-201,-13.86,1200,1250
سپرمي,پرميت‌,4,1111,36496350,33500,32850,32850,-650,-1.94,33500,0,0,32850,32850
گام020613,گواهي اعتبار مولد رفاه0206	,4,40000,33320000000,830000,833000,833000,3000,0.36,833000,3000,0.36,833000,833000
طشنا1105,اختيارف شپنا-6500-1401/11/19,4,23,1250000,42,50,70,28,66.67,54,12,28.57,30,70
سحرخيز2,صندوق س. گروه زعفران سحرخيز,4,2585000,2585000,19739,1,1,-19738,-99.99,1,-19738,-99.99,1,1
اراد24,مرابحه عام دولت2-ش.خ ساير0212,4,750000,699300000000,940000,932400,932400,-7600,-0.81,932400,-7600,-0.81,932400,932400
تملي104,تسهيلات مسكن ب.ملي-تير 1401,3,100,82000000,826349,820000,820000,-6349,-0.77,820000,-6349,-0.77,820000,820000
اراد99,مرابحه عام دولت99-ش.خ050723,3,490000,490000000000,1000000,1000000,1000000,0,0,1000000,0,0,1000000,1000000
ضخود1111,اختيارخ خودرو-3000-1401/11/12,3,5,2119000,499,499,400,-99,-19.84,424,-75,-15.03,400,499
اخزا914,اسنادخزانه-م14بودجه99-021025,3,11900,9372909000,788790,787550,787690,-1100,-0.14,787640,-1150,-0.15,787550,787690
ضسلا1207,اختيارخ سلام-11000-1401/12/22,3,352,325248000,1239,999,999,-240,-19.37,924,-315,-25.42,911,999
ضسپا3024,اختيارخ خساپا-2000-1402/03/24,3,311,263595000,1100,849,845,-255,-23.18,848,-252,-22.91,845,849
ضدار1208,اختيارخ ص.دارا-130000-01/12/16,3,1040,114200000,10500,10500,11000,500,4.76,10981,481,4.58,10500,11000
ضدي201,اختيارخ دي-500-14020217,3,107,49941000,478,421,470,-8,-1.67,467,-11,-2.3,420,470
ضسرو1021,اختيارخ سرو-120000-1402/10/06,3,42,4601010,13166,10100,11000,-2166,-16.45,10955,-2211,-16.79,10001,11000
ضخود0109,اختيارخ خودرو-3000-1402/01/09,3,20,9380000,900,510,420,-480,-53.33,469,-431,-47.89,420,510
ضخود1201,اختيارخ خودرو-1600-1401/12/03,3,82,131360000,1880,1600,1615,-265,-14.1,1602,-278,-14.79,1575,1615
طهرم1205,اختيارف اهرم-11000-1401/12/22,3,36,14068000,353,388,488,135,38.24,391,38,10.76,388,488
ضهاي3007,اختيارخ هاي وب-3229-1402/03/03,3,152,54210840,236,330,329,93,39.41,329,93,39.41,329,330
اخزا905,اسنادخزانه-م5بودجه99-020218,3,5500,5113514000,929100,930580,928550,-550,-0.06,929730,630,0.07,928550,930580
ضستر1111,اختيارخ خگستر-4500-1401/11/26,3,25,12475000,619,499,499,-120,-19.39,499,-120,-19.39,499,499
كارا2,صندوق س. كارا -د,3,176000000,176000000,13145,1,1,-13144,-99.99,1,-13144,-99.99,1,1
هم وزن2,صندوق س. شاخصي كيان-س,3,2800000,2800000,12514,1,1,-12513,-99.99,1,-12513,-99.99,1,1
ضملت1145,اختيارخ وبملت-2800-1401/11/24,3,16,9662000,837,316,850,13,1.55,604,-233,-27.84,316,850
ضترا3026,اختيارخ شتران-5000-1402/03/28,3,11,10780000,1001,980,980,-21,-2.1,980,-21,-2.1,980,980
ضملت1150,اختيارخ وبملت-4000-1401/11/24,3,20,1850000,130,90,100,-30,-23.08,92,-38,-29.23,90,100
سكه0211پ02,تمام سكه طرح جديد0211ملت,3,500,1031796500,2060311,2063593,2063593,3282,0.16,2063593,3282,0.16,2063593,2063593
رشد2,صندوق س.رشد پايدار آبان-د,3,130040,130040,10196,1,1,-10195,-99.99,1,-10195,-99.99,1,1
گام020656,گواهي اعتبار مولد سامان0206,3,240000,199680000000,830000,832000,832000,2000,0.24,832000,2000,0.24,832000,832000
اخزا904,اسنادخزانه-م4بودجه99-011215,3,5500,5345405000,970000,970810,972000,2000,0.21,971890,1890,0.19,970810,972000
تملي707,تسهيلات مسكن ب. ملي-مهر97,3,8,5270600,693500,658825,658825,-34675,-5,658825,-34675,-5,658825,658825
ضشنا2031,اختيارخ شپنا-10044-1402/02/24,3,154,84698000,1,550,550,549,54900,550,549,54900,549,550
اگ020555,گام بانك اقتصاد نوين0205,3,3100,2640231120,851892,850111,855000,3108,0.36,851687,-205,-0.02,850110,855000
ضفلا7026,اختيارخ فولاد-3144-1402/07/26,3,1107,2767500000,2500,2500,2500,0,0,2500,0,0,2500,2500
ضخود1113,اختيارخ خودرو-3500-1401/11/12,3,510,50100000,145,100,10,-135,-93.1,98,-47,-32.41,10,100
ضهرم7006,اختيارخ اهرم-11000-1402/07/23,3,6,42000000,6998,7000,7000,2,0.03,7000,2,0.03,7000,7000
ضدي209,اختيارخ دي-900-14020217,3,40,6800000,1,170,170,169,16900,170,169,16900,170,170
ضصاد1128,اختيارخ وبصادر-1800-1401/11/19,3,75,9470000,200,100,150,-50,-25,126,-74,-37,100,180
ضهرم7010,اختيارخ اهرم-15000-1402/07/23,2,545,2616000000,5474,4800,4800,-674,-12.31,4800,-674,-12.31,4800,4800
ضملت3023,اختيارخ وبملت-2784-1402/03/28,2,3,3060000,1,1020,1020,1019,101900,1020,1019,101900,1020,1020
ضدي200,اختيارخ دي-450-14020217,2,21,9455000,509,455,450,-59,-11.59,450,-59,-11.59,450,455
ضترا1149,اختيارخ شتران-5000-1401/11/19,2,100,10000000,117,100,100,-17,-14.53,100,-17,-14.53,100,100
ثمين,صندوق س. ثروت افزون ثمين-س,2,800,10840000,13676,13500,13600,-76,-0.56,13550,-126,-0.92,13500,13600
طهرم7000,اختيارف اهرم-6500-1402/07/23,2,2,321000,335,150,171,-164,-48.96,160,-175,-52.24,150,171
ضسپا3021,اختيارخ خساپا-1700-1402/03/24,2,51,55600000,1,1090,1100,1099,109900,1090,1089,108900,1090,1100
ضفلا7025,اختيارخ فولاد-2813-1402/07/26,2,51,127300000,2300,2300,2500,200,8.7,2496,196,8.52,2300,2500
ضملت3024,اختيارخ وبملت-2969-1402/03/28,2,2,944000,1,444,500,499,49900,472,471,47100,444,500
ضخود0111,اختيارخ خودرو-3500-1402/01/09,2,52,19760000,490,380,380,-110,-22.45,380,-110,-22.45,380,380
ضدار1211,اختيارخ ص.دارا-160000-01/12/16,2,50,500000,873,1000,1000,127,14.55,1000,127,14.55,1000,1000
سمتا011,سلف موازي استاندارد سمتا011,2,4010,39221166310,9908272,9919431,9780493,-127779,-1.29,9780839,-127433,-1.29,9780493,9919431
ضستا1102,اختيارخ شستا-700-1401/11/05,2,36,12150000,399,350,305,-94,-23.56,337,-62,-15.54,305,350
ضخود1110,اختيارخ خودرو-2800-1401/11/12,2,51,10571000,570,571,200,-370,-64.91,207,-363,-63.68,200,571
تملي803,تسهيلات مسكن ب. ملي-خرداد98,2,2,1370850,717000,689700,681150,-35850,-5,685425,-31575,-4.4,681150,689700
ضسلا1206,اختيارخ سلام-10000-1401/12/22,2,40,63500000,1785,1610,1520,-265,-14.85,1587,-198,-11.09,1520,1610
ضستا1202,اختيارخ شستا-700-1401/12/03,2,117,45513000,436,389,389,-47,-10.78,389,-47,-10.78,389,389
ضسلا1205,اختيارخ سلام-9000-1401/12/22,2,271,719630000,2670,2530,2700,30,1.12,2655,-15,-0.56,2530,2700
طهرم1208,اختيارف اهرم-14000-1401/12/22,2,10,11905000,1600,1181,1200,-400,-25,1190,-410,-25.63,1181,1200
ضپلا1208,اختيارخ پالايش-100000-01/12/16,2,940,187217850,22800,21000,19911,-2889,-12.67,19917,-2883,-12.64,19911,21000
ضخود3069,اختيارخ خودرو-2800-1402/03/03,2,2,1941000,891,1050,891,0,0,970,79,8.87,891,1050
فيروزا2,صندوق ارمغان فيروزه آسيا-ثابت,2,66600000,66600000,32316,1,1,-32315,-100,1,-32315,-100,1,1
نهال2,صندوق س. طلاي سرخ نوويرا,2,1500000,1500000,14161,1,1,-14160,-99.99,1,-14160,-99.99,1,1
ضفلا1175,اختيارخ فولاد-6000-1401/11/26,2,65,19435000,456,299,299,-157,-34.43,299,-157,-34.43,299,299
ولملتح,ح . واسپاري ملت,2,26191,105502200,4200,4200,4020,-180,-4.29,4028,-172,-4.1,4020,4200
صايند2,صندوق س. گنجينه آينده روشن-د,2,2000000,2000000,10102,1,1,-10101,-99.99,1,-10101,-99.99,1,1
اوصتا2,صندوق انديشه ورزان صباتامين -د,2,11473591,11473591,26090,1,1,-26089,-100,1,-26089,-100,1,1
داريك2,صندوق س.اعتماد داريك-د,2,1700000,1700000,14436,1,1,-14435,-99.99,1,-14435,-99.99,1,1
ضجار2021,اختيارخ وتجارت-1400-1402/02/20,2,57,35557000,699,651,620,-79,-11.3,624,-75,-10.73,620,651
اراد1034,مرابحه عام دولت103-ش.خ050821,2,10776400,8745430038000,1020000,814346,808725,-211275,-20.71,811535,-208465,-20.44,808725,814346
غگز,گز سكه,2,3557,7028632,1882,1976,1976,94,4.99,1976,94,4.99,1976,1976
فماك,ماداكتو استيل كرد,2,10300,173740400,17755,16868,16868,-887,-5,16868,-887,-5,16868,16868
گنگين2,اقتصادي نگين گردشگري ايرانيان,2,5000000,184750000000,36950,36950,36950,0,0,36950,0,0,36950,36950
افران2,صندوق س افرا نماد پايدار-ثابت,2,94400000,94400000,18901,1,1,-18900,-99.99,1,-18900,-99.99,1,1
هماي2,صندوق س هماي آگاه-ثابت,2,115000000,115000000,10175,1,1,-10174,-99.99,1,-10174,-99.99,1,1
ضتوسن709,اختيارخ توسن-24600-14020716,2,2,420000,618,20,400,-218,-35.28,210,-408,-66.02,20,400
ضدي211,اختيارخ دي-1000-14020217,2,50,6500000,170,130,130,-40,-23.53,130,-40,-23.53,130,130
اراد50,مرابحه عام دولت5-ش.خ0302,2,30000,30000000000,1000000,1000000,1000000,0,0,1000000,0,0,1000000,1000000
ضهرم7005,اختيارخ اهرم-10000-1402/07/23,2,86,559200000,7765,6500,6700,-1065,-13.72,6502,-1263,-16.27,6500,6700
كيان4,صندوق س. با درآمد ثابت كيان,2,33250000,1327542770000,39877,39920,39947,70,0.18,39926,49,0.12,39920,39947
اخزا8212,اسنادخزانه-م21بودجه98-020906,2,21,17098200,813210,814200,814200,990,0.12,814200,990,0.12,814200,814200
ضصاد1122,اختيارخ وبصادر-1200-1401/11/19,2,100,70000000,780,700,700,-80,-10.26,700,-80,-10.26,700,700
ضهاي3008,اختيارخ هاي وب-3460-1402/03/03,2,101,33181240,304,399,310,6,1.97,303,-1,-0.33,303,310
تملي708,تسهيلات مسكن ب. ملي-آبان97,2,2,1245500,655526,622750,622750,-32776,-5,622750,-32776,-5,622750,622750
صباايده01,مرابحه ايده پردازصبادانا050929,1,5000,4750000000,1000000,950000,950000,-50000,-5,950000,-50000,-5,950000,950000
نفيس2,صندوق س.پشتوانه طلاي صبا,1,1725030,1725030,12010,1,1,-12009,-99.99,1,-12009,-99.99,1,1
كهربا2,صندوق س.پشتوانه سكه طلا كهربا,1,3000000,3000000,18382,1,1,-18381,-99.99,1,-18381,-99.99,1,1
وپخش2,داروپخش‌ (هلدينگ‌,1,550000,22187000000,40340,40340,40340,0,0,40340,0,0,40340,40340
اراد65,مرابحه عام دولتي65-ش.خ0210,1,5000,4795350000,929290,959070,959070,29780,3.2,959070,29780,3.2,959070,959070
سكه0310پ04,تمام سكه طرح جديد 0310 صادرات,1,300,619077900,2060311,2063593,2063593,3282,0.16,2063593,3282,0.16,2063593,2063593
ضستا0101,اختيارخ شستا-700-1402/01/09,1,50,23000000,446,460,460,14,3.14,460,14,3.14,460,460
وكادو2,تكادو,1,2000000,37800000000,18440,18900,18900,460,2.49,18900,460,2.49,18900,18900
سپنتا031,سلف موازي پنتان پتروكنگان031,1,100,198268400,1979529,1982684,1982684,3155,0.16,1982684,3155,0.16,1982684,1982684
ضسلا7006,اختيارخ سلام-12000-1402/07/19,1,10,18000000,1989,1800,1800,-189,-9.5,1800,-189,-9.5,1800,1800
اخزا907,اسنادخزانه-م7بودجه99-020704,1,6000,5076420000,845510,846070,846070,560,0.07,846070,560,0.07,846070,846070
ضسلا7003,اختيارخ سلام-9000-1402/07/19,1,2,7780000,3600,3890,3890,290,8.06,3890,290,8.06,3890,3890
ضترا3020,اختيارخ شتران-3000-1402/03/28,1,1,2250000,1,2250,2250,2249,224900,2250,2249,224900,2250,2250
ضسرو1014,اختيارخ سرو-62000-1402/10/06,1,500,235500000,48874,47100,47100,-1774,-3.63,47100,-1774,-3.63,47100,47100
صگل05092,صكوك اجاره كگل0509-بدون ضامن	,1,500000,500000000000,1000000,1000000,1000000,0,0,1000000,0,0,1000000,1000000
اخزا9114,اسنادخزانه-م11بودجه99-020906,1,175258,142581145900,815340,813550,813550,-1790,-0.22,813550,-1790,-0.22,813550,813550
قاسم4,قاسم ايران,1,9550000,70861000000,7450,7420,7420,-30,-0.4,7420,-30,-0.4,7420,7420
اگ020618,گام بانك تجارت0206,1,10,8409960,834949,840996,840996,6047,0.72,840996,6047,0.72,840996,840996
تملي801,تسهيلات مسكن ب. ملي-فروردين98,1,15,8930430,626696,595362,595362,-31334,-5,595362,-31334,-5,595362,595362
زرفام2,صندوق س.پشتوانه طلا زرفام آشنا,1,100000,100000,15339,1,1,-15338,-99.99,1,-15338,-99.99,1,1
اوصتا4,صندوق انديشه ورزان صباتامين -د,1,69807485,1824697850415,26090,26139,26139,49,0.19,26139,49,0.19,26139,26139
فملي2,ملي‌ صنايع‌ مس‌ ايران‌,1,11050000,86190000000,7860,7800,7800,-60,-0.76,7800,-60,-0.76,7800,7800
صجم607,صكوك مرابحه جم607-6ماهه 18%,1,5000,5200000000,991000,1040000,1040000,49000,4.94,1040000,49000,4.94,1040000,1040000
دماوند2,توليد نيروي برق دماوند,1,4000000,85000000000,20900,21250,21250,350,1.67,21250,350,1.67,21250,21250
اراد112,مرابحه عام دولت112-ش.خ 040408,1,200000,182400000000,913750,912000,912000,-1750,-0.19,912000,-1750,-0.19,912000,912000
سمتا022,سلف موازي استاندارد سمتا022,1,100,104224700,1040794,1042247,1042247,1453,0.14,1042247,1453,0.14,1042247,1042247
عقيق,صندوق سرمايه گذاري عقيق-سهام,1,10,535500,54000,53550,53550,-450,-0.83,53550,-450,-0.83,53550,53550
ضحفا1208,اختيارخ حفارس-16000-1401/12/24,1,50,65000000,1400,1300,1300,-100,-7.14,1300,-100,-7.14,1300,1300
كارين4,صندوق س نگين سامان-ثابت,1,100000000,1000500000000,10176,10005,10005,-171,-1.68,10005,-171,-1.68,10005,10005
آوا2,صندوق س.سهام آواي معيار-س,1,1500000,1500000,9446,1,1,-9445,-99.99,1,-9445,-99.99,1,1
خراسان2,پتروشيمي خراسان,1,230000,26105000000,112430,113500,113500,1070,0.95,113500,1070,0.95,113500,113500
سپر2,صندوق س سپر سرمايه بيدار- ثابت,1,5000000,5000000,16580,1,1,-16579,-99.99,1,-16579,-99.99,1,1
اراد1052,مرابحه عام دولت105-ش.خ030503,1,1000,954660000,986000,954660,954660,-31340,-3.18,954660,-31340,-3.18,954660,954660
اخزا9142,اسنادخزانه-م14بودجه99-021025,1,2,1575100,788790,787550,787550,-1240,-0.16,787550,-1240,-0.16,787550,787550
اخزا9102,اسنادخزانه-م10بودجه99-020807,1,7,5704720,827600,814960,814960,-12640,-1.53,814960,-12640,-1.53,814960,814960
سمگا2,گروه سرمايه گذاري ميراث فرهنگي,1,6000000,42600000000,7180,7100,7100,-80,-1.11,7100,-80,-1.11,7100,7100
فباهنر2,مس‌ شهيدباهنر,1,900000,28341000000,32530,31490,31490,-1040,-3.2,31490,-1040,-3.2,31490,31490
بازده2,صندوق س. بازده ثابت-د,1,1000000,1000000,10358,1,1,-10357,-99.99,1,-10357,-99.99,1,1
گام0206132,گواهي اعتبار مولد رفاه0206	,1,100,84900000,830000,849000,849000,19000,2.29,849000,19000,2.29,849000,849000
تابان03,اجاره تابان سپهر14021206,1,5000,4794000000,946100,958800,958800,12700,1.34,958800,12700,1.34,958800,958800
سمتا021,سلف موازي استاندارد سمتا021,1,100,103987200,1038422,1039872,1039872,1450,0.14,1039872,1450,0.14,1039872,1039872
زيتون2,صندوق س زيتون نماد پايا- مختلط,1,100000,100000,14560,1,1,-14559,-99.99,1,-14559,-99.99,1,1
پالايش2,صندوق پالايشي يكم-سهام,1,11000000,11000000,117230,1,1,-117229,-100,1,-117229,-100,1,1
اراد242,مرابحه عام دولت2-ش.خ ساير0212,1,3900,3636360000,940000,932400,932400,-7600,-0.81,932400,-7600,-0.81,932400,932400
اخزا9044,اسنادخزانه-م4بودجه99-011215,1,170000,165217900000,970000,971870,971870,1870,0.19,971870,1870,0.19,971870,971870
ضترا3021,اختيارخ شتران-3250-1402/03/28,1,1,2100000,1,2100,2100,2099,209900,2100,2099,209900,2100,2100
شراز2,پالايش نفت شيراز,1,3550000,52895000000,15390,14900,14900,-490,-3.18,14900,-490,-3.18,14900,14900
زير0203پ01,زيره سبز 0203 كيميابذر(پ),1,50,76250000,1500000,1525000,1525000,25000,1.67,1525000,25000,1.67,1525000,1525000
ضخود0110,اختيارخ خودرو-3250-1402/01/09,1,40,19880000,780,497,497,-283,-36.28,497,-283,-36.28,497,497
ضصاد3027,اختيارخ وبصادر-2200-1402/03/17,1,10,3000000,379,300,300,-79,-20.84,300,-79,-20.84,300,300
ضفلا1176,اختيارخ فولاد-6500-1401/11/26,1,80,20000000,600,250,250,-350,-58.33,250,-350,-58.33,250,250
طملي1171,اختيارف فملي-6000-1401/11/12,1,10,150000,23,15,15,-8,-34.78,15,-8,-34.78,15,15
ضهرم7007,اختيارخ اهرم-12000-1402/07/23,1,1,8000000,5465,8000,8000,2535,46.39,8000,2535,46.39,8000,8000
سنفت021,سلف موازي نفت.س صادر اروند 021,1,100,237223800,2368931,2372238,2372238,3307,0.14,2372238,3307,0.14,2372238,2372238
كارا4,صندوق س. كارا -د,1,37960000,499819320000,13145,13167,13167,22,0.17,13167,22,0.17,13167,13167
افران4,صندوق س افرا نماد پايدار-ثابت,1,5280000,99955680000,18901,18931,18931,30,0.16,18931,30,0.16,18931,18931
صبا51,اجاره صبا تامين دماوند14050809,1,65000,65000000000,1000000,1000000,1000000,0,0,1000000,0,0,1000000,1000000
ثمين2,صندوق س. ثروت افزون ثمين-س,1,6600000,6600000,13676,1,1,-13675,-99.99,1,-13675,-99.99,1,1
سمتا024,سلف موازي متانول بوشهر 024,1,100,102055600,1019133,1020556,1020556,1423,0.14,1020556,1423,0.14,1020556,1020556
گام0204562,گواهي اعتبار مولد سامان0204,1,96,84960000,857000,885000,885000,28000,3.27,885000,28000,3.27,885000,885000
شپديس2,پتروشيمي پرديس,1,200000,31560000000,156380,157800,157800,1420,0.91,157800,1420,0.91,157800,157800
اخزا1014,اسناد خزانه-م1بودجه01-040326,1,257937,142845510600,551680,553800,553800,2120,0.38,553800,2120,0.38,553800,553800
اراد55,مرابحه عام دولت5-ش.خ 0209,1,5000,4810150000,935000,962030,962030,27030,2.89,962030,27030,2.89,962030,962030
اعتماد4,صندوق س.اعتماد آفرين پارسيان-د,1,15650000,800059300000,51050,51122,51122,72,0.14,51122,72,0.14,51122,51122
تملي709,تسهيلات مسكن ب. ملي-آذر97,1,20,13704220,721274,685211,685211,-36063,-5,685211,-36063,-5,685211,685211
سمتا025,سلف موازي متانول بوشهر 025,1,100,116051900,1158901,1160519,1160519,1618,0.14,1160519,1618,0.14,1160519,1160519
اراد72,مرابحه عام دولت72-ش.خ0311,1,50000,46336500000,926470,926730,926730,260,0.03,926730,260,0.03,926730,926730
متا0201,آتي متانول-1402/01/17,1,100,90930000,909200,909300,909300,100,0.01,909300,100,0.01,909300,909300
ضترا3022,اختيارخ شتران-3500-1402/03/28,1,1,1900000,1733,1900,1900,167,9.64,1900,167,9.64,1900,1900
ضستا0108,اختيارخ شستا-1400-1402/01/09,1,5,280000,64,56,56,-8,-12.5,56,-8,-12.5,56,56
ضترا3023,اختيارخ شتران-3750-1402/03/28,1,1,1700000,1,1700,1700,1699,169900,1700,1699,169900,1700,1700
نسب0201,آتي نفتاي سبك-1402/01/17,1,100,171005000,1697800,1710050,1710050,12250,0.72,1710050,12250,0.72,1710050,1710050
ضخود3062,اختيارخ خودرو-1700-1402/03/03,1,1,2100000,2115,2100,2100,-15,-0.71,2100,-15,-0.71,2100,2100
طستا1106,اختيارف شستا-1100-1401/11/05,1,1,60000,70,60,60,-10,-14.29,60,-10,-14.29,60,60
ضهرم7008,اختيارخ اهرم-13000-1402/07/23,1,2,9400000,5000,4700,4700,-300,-6,4700,-300,-6,4700,4700
ضهرم7001,اختيارخ اهرم-7000-1402/07/23,1,1,8000000,8000,8000,8000,0,0,8000,0,0,8000,8000
گام020756,گواهي اعتبار مولد سامان0207,1,5000,4180000000,813620,836000,836000,22380,2.75,836000,22380,2.75,836000,836000
سمتا031,سلف موازي متانول مرجان 031,1,100,96569000,964411,965690,965690,1279,0.13,965690,1279,0.13,965690,965690
ضدي210,اختيارخ دي-950-14020217,1,100,15000000,194,150,150,-44,-22.68,150,-44,-22.68,150,150
سمتا023,سلف موازي استاندارد سمتا023,1,100,104622900,1044771,1046229,1046229,1458,0.14,1046229,1458,0.14,1046229,1046229
تملي706,تسهيلات مسكن ب. ملي-شهريور97,1,8,5312288,698985,664036,664036,-34949,-5,664036,-34949,-5,664036,664036
طتوسن1104,اختيارف توسن-20400-14011117,1,2,12944800,4200,4400,4400,200,4.76,4400,200,4.76,4400,4400
ضصاد3019,اختيارخ وبصادر-1300-1402/03/17,1,100,111000000,1000,1110,1110,110,11,1110,110,11,1110,1110
متا0203,آتي متانول-1402/03/17,1,100,90980000,909700,909800,909800,100,0.01,909800,100,0.01,909800,909800
اخزا9082,اسنادخزانه-م8بودجه99-020606,1,88,72051760,861860,818770,818770,-43090,-5,818770,-43090,-5,818770,818770
ضدار1206,اختيارخ ص.دارا-110000-01/12/16,1,10,2000000,16000,20000,20000,4000,25,20000,4000,25,20000,20000
ضسپا3023,اختيارخ خساپا-1900-1402/03/24,1,5,4550000,1300,910,910,-390,-30,910,-390,-30,910,910
اگ020659,گام بانك سينا0206,1,400,333500000,838000,833750,833750,-4250,-0.51,833750,-4250,-0.51,833750,833750
ضترا3025,اختيارخ شتران-4500-1402/03/28,1,1,1220000,1,1220,1220,1219,121900,1220,1219,121900,1220,1220
نسب0203,آتي نفتاي سبك-1402/03/17,1,100,172002000,1690900,1720020,1720020,29120,1.72,1720020,29120,1.72,1720020,1720020
صينا205,صكوك منفعت سينا دارو-3ماهه 19%,1,5,4923750,982268,984750,984750,2482,0.25,984750,2482,0.25,984750,984750
ضصاد1121,اختيارخ وبصادر-1100-1401/11/19,1,6,5040000,900,840,840,-60,-6.67,840,-60,-6.67,840,840
ضترا3029,اختيارخ شتران-6500-1402/03/28,1,1,500000,1,500,500,499,49900,500,499,49900,500,500
