نماد,نام,تعداد,حجم,ارزش,دیروز,اولین,آخرین معامله - مقدار,آخرین معامله - تغییر,آخرین معامله - درصد,قیمت پایانی - مقدار,قیمت پایانی - تغییر,قیمت پایانی - درصد,کمترین,بیشترین
اسياتك,انتقال داده هاي آسياتك,14739,14649764,188372577020,12270,12860,12880,610,4.97,12860,590,4.81,12610,12880
شستا,سرمايه گذاري تامين اجتماعي,13569,658176852,683938302125,1040,1042,1039,-1,-0.1,1039,-1,-0.1,1032,1052
افرا,افرانت,12397,37154642,1443638790950,39300,37400,37350,-1950,-4.96,38850,-450,-1.15,37350,40900
مديريت,س. و خدمات مديريت صند. ب كشوري,11419,146361951,1437392358150,9280,9830,9830,550,5.93,9820,540,5.82,9650,9830
پالايش,صندوق پالايشي يكم-سهام,11366,12060257,956953521930,79420,79600,79100,-320,-0.4,79350,-70,-0.09,78640,80010
بهير,س. توسعه تجارت هيرمند,11133,13751660,106278409900,7510,7660,7730,220,2.93,7730,220,2.93,7510,7730
حگهر,حمل و نقل گهرترابر سيرجان,9978,50089588,455646647660,8590,9090,9100,510,5.94,9100,510,5.94,8810,9100
شپنا,پالايش نفت اصفهان,9743,156741720,1030335906120,6520,6520,6580,60,0.92,6570,50,0.77,6470,6680
خگستر,گسترش‌سرمايه‌گذاري‌ايران‌خودرو,9344,264676174,1068760427908,4114,4069,4081,-33,-0.8,4038,-76,-1.85,3980,4140
خودرو,ايران‌ خودرو,9324,307525970,725807126087,2363,2355,2364,1,0.04,2360,-3,-0.13,2326,2387
خساپا,سايپا,9304,384564600,821868430241,2153,2150,2128,-25,-1.16,2137,-16,-0.74,2101,2161
فروسيل,فروسيليسيم خمين,8944,4119710,139452183500,32250,33850,33850,1600,4.96,33850,1600,4.96,33850,33850
كمند,صندوق س. با درآمد ثابت كمند,7480,316515358,3195734714039,10090,10096,10097,7,0.07,10097,7,0.07,10096,10098
فولاد,فولاد مباركه اصفهان,7097,90110710,1129884635110,12550,12560,12560,10,0.08,12540,-10,-0.08,12400,12600
كرمان,س. توسعه و عمران استان كرمان,7071,318030753,322985551198,1025,1030,1006,-19,-1.85,1016,-9,-0.88,999,1045
ذوب,ذوب آهن اصفهان,7019,180252571,530948597578,3015,2873,2961,-54,-1.79,2946,-69,-2.29,2873,2983
شبندر,پالايش نفت بندرعباس,6964,78559675,706881211620,9010,9080,8960,-50,-0.55,9000,-10,-0.11,8930,9080
ددانا,داروسازي دانا,6731,1044276,34669963200,31350,33200,33200,1850,5.9,33200,1850,5.9,33200,33200
دارا يكم,صندوق واسطه گري مالي يكم-سهام,6580,4202851,499710710430,119440,119000,118600,-840,-0.7,118900,-540,-0.45,118500,119440
بترانس,ايران‌ ترانسفو,6513,395983090,1060652430427,2534,2580,2639,105,4.14,2679,145,5.72,2545,2686
وتجارت,بانك تجارت,6439,246818388,555901532301,2251,2270,2249,-2,-0.09,2252,1,0.04,2223,2279
غدام,خوراك‌  دام‌ پارس‌,6239,10004411,615149803270,60650,57620,63670,3020,4.98,61490,840,1.38,57620,63680
سپيد,سپيد ماكيان,6030,13115672,311289593620,24050,23810,23340,-710,-2.95,23730,-320,-1.33,23180,24500
غزر,صنعتي زر ماكارون,5736,26281603,278450974530,10640,10360,10510,-130,-1.22,10590,-50,-0.47,10280,11000
سيمرغ,سيمرغ,5617,17307261,494024391100,29010,28860,28000,-1010,-3.48,28540,-470,-1.62,27930,29500
وبملت,بانك ملت,5523,179240247,709109178796,3945,3961,3960,15,0.38,3956,11,0.28,3902,3982
فملي,ملي‌ صنايع‌ مس‌ ايران‌,5445,71305270,538057581830,7540,7550,7550,10,0.13,7550,10,0.13,7520,7600
پارس,پتروشيمي پارس,5403,113208183,308288718030,2692,2680,2725,33,1.23,2723,31,1.15,2680,2776
شتران,پالايش نفت تهران,5203,75442811,421942490060,5590,5600,5570,-20,-0.36,5590,0,0,5550,5660
شلرد,كود شيميايي اوره لردگان,5164,81037666,979233386260,12160,11800,12520,360,2.96,12080,-80,-0.66,11800,12520
امين يكم,صندوق درآمد ثابت امين يكم فردا,4927,144869856,1448747842486,10147,10000,10001,-146,-1.44,10000,-147,-1.45,9999,10004
غگل,گلوكوزان‌,4877,57855707,294766760430,4950,4930,5190,240,4.85,5090,140,2.83,4830,5190
ورنا,سرمايه‌گذاري‌ رنا(هلدينگ‌,4555,85943893,531100684920,6390,6400,6050,-340,-5.32,6180,-210,-3.29,6030,6430
تليسه,دامداري تليسه نمونه,4549,58826289,278406681446,4984,5000,4685,-299,-6,4733,-251,-5.04,4685,5049
هماي,صندوق س هماي آگاه-ثابت,4543,117535677,1176211587739,10174,10008,10008,-166,-1.63,10007,-167,-1.64,10006,10008
وبصادر,بانك صادرات ايران,4519,212992780,470604689534,2216,2210,2212,-4,-0.18,2209,-7,-0.32,2190,2220
فاذر,صنايع‌ آذرآب‌,4415,211502200,226478084279,1058,1065,1066,8,0.76,1071,13,1.23,1050,1090
خبنيان,بنيان ديزل,4116,77776906,324888989121,4184,4184,4059,-125,-2.99,4177,-7,-0.17,4059,4309
خاور,ايران خودرو ديزل,4058,107037459,184516057483,1726,1749,1689,-37,-2.14,1724,-2,-0.12,1686,1767
غنوش,نوش‌ مازندران‌,3898,24757944,274021848140,11460,11460,11160,-300,-2.62,11070,-390,-3.4,10890,11620
بركت,گروه دارويي بركت,3845,11229920,190231661120,16950,16630,16970,20,0.12,16940,-10,-0.06,16630,17290
فلوله,لوله‌وماشين‌سازي‌ايران‌,3655,88971258,188719831774,2066,2120,2142,76,3.68,2121,55,2.66,2070,2159
كالا,بورس كالاي ايران,3627,9571355,262779839790,27600,27830,27180,-420,-1.52,27450,-150,-0.54,27010,28190
آريا,پليمر آريا ساسول,3619,2236497,178737008550,79800,79800,80100,300,0.38,79900,100,0.13,79650,80150
شبريز,پالايش نفت تبريز,3565,18760265,427409109990,22620,22710,22840,220,0.97,22780,160,0.71,22560,23460
هاي وب,داده گسترعصرنوين-هاي وب,3494,28117580,284190170600,9810,9750,10110,300,3.06,10110,300,3.06,9750,10280
خپارس,پارس‌ خودرو,3486,128838791,158593517482,1234,1235,1224,-10,-0.81,1231,-3,-0.24,1214,1259
نوري,پتروشيمي نوري,3478,2663695,317887726590,117890,117900,119800,1910,1.62,119340,1450,1.23,117550,120000
فجهانح,ح. مجتمع جهان فولاد سيرجان,3231,4325904,8026899330,1832,1813,1856,24,1.31,1856,24,1.31,1813,1900
انرژي,بورس انرژي ايران,3184,3175615,201094955630,62540,62540,62890,350,0.56,63320,780,1.25,62540,64580
غكورش,صنعت غذايي كورش,3173,4502249,212889138550,48130,48180,47310,-820,-1.7,47290,-840,-1.75,45990,48300
كيان,صندوق س. با درآمد ثابت كيان,3027,23469979,819860071922,34911,34933,34933,22,0.06,34932,21,0.06,34931,34934
بوعلي,پتروشيمي بوعلي سينا,3024,2439070,215227024230,88360,88500,88670,310,0.35,88240,-120,-0.14,87110,91000
خنصير,مهندسي‌نصيرماشين‌,2990,10232506,172640190670,17530,17640,16750,-780,-4.45,16870,-660,-3.76,16660,17640
پترول,گ.س.وت.ص.پتروشيمي خليج فارس,2988,58478341,140849808416,2362,2362,2395,33,1.4,2409,47,1.99,2353,2459
وساپا,سرمايه‌گذاري‌ سايپا,2972,59568153,310794430000,5430,5400,5150,-280,-5.16,5220,-210,-3.87,5110,5420
وآذر,سرمايه‌گذاري‌توسعه‌آذربايجان‌,2952,4440000,453896526460,107170,102010,104330,-2840,-2.65,102230,-4940,-4.61,101820,105820
فرابورس,فرابورس ايران,2940,15185492,228585544140,15040,15000,14960,-80,-0.53,15050,10,0.07,14880,15380
گدنا,تهيه توزيع غذاي دنا آفرين فدك,2914,2888432,43036836710,14660,14480,14920,260,1.77,14900,240,1.64,14480,15120
حكشتي,كشتيراني جمهوري اسلامي ايران,2895,36094073,753483251190,19980,19860,20970,990,4.95,20880,900,4.5,19830,20970
زقيام,كشت و دام قيام اصفهان,2885,58322598,140517948268,2442,2500,2466,24,0.98,2409,-33,-1.35,2296,2500
سمگا,گروه سرمايه گذاري ميراث فرهنگي,2847,21307930,205517683230,9680,9600,9650,-30,-0.31,9650,-30,-0.31,9500,9840
اعتماد,صندوق س.اعتماد آفرين پارسيان-د,2758,42012330,1866047961080,44387,44416,44418,31,0.07,44417,30,0.07,44416,44418
سآبيك,سيمان آبيك,2750,1288239,17391226500,12860,13500,13500,640,4.98,13500,640,4.98,13500,13500
كاما,باما,2728,21729028,149244246990,6830,6720,6840,10,0.15,6870,40,0.59,6710,7100
ثعتما,س. ساختماني اعتماد گستر,2697,12217802,199448843410,16420,16910,16050,-370,-2.25,16320,-100,-0.61,15930,16910
وكبهمن,مديريت سرمايه گذاري كوثربهمن,2696,7260267,45984782400,6010,5920,6370,360,5.99,6330,320,5.32,5920,6370
سكرد,سيمان كردستان,2696,17081633,158585499260,9230,9230,9490,260,2.82,9280,50,0.54,8900,9630
ثاميد,توسعه و عمران اميد,2684,21578372,35434024067,1624,1624,1636,12,0.74,1642,18,1.11,1624,1665
فجهان,مجتمع جهان فولاد سيرجان,2625,10014222,35115317953,3552,3529,3528,-24,-0.68,3534,-18,-0.51,3456,3547
شاروم,پتروشيمي اروميه,2609,2186327,35383998510,16040,15910,16060,20,0.12,16180,140,0.87,15900,16380
كيمياتك,آريان كيميا تك,2599,2057876,55904050290,27220,26800,27170,-50,-0.18,27170,-50,-0.18,26680,27900
وخارزم,سرمايه گذاري خوارزمي,2599,40375511,202635644030,5030,4990,5010,-20,-0.4,5020,-10,-0.2,4980,5090
خبهمن,گروه‌بهمن‌,2543,79188771,153198522085,1933,1933,1936,3,0.16,1935,2,0.1,1912,1963
خزاميا,زامياد,2529,17362463,169964948260,9570,9570,9840,270,2.82,9790,220,2.3,9570,9940
ومدير,گ.مديريت ارزش سرمايه ص ب كشوري,2491,17008594,76106470827,4355,4400,4497,142,3.26,4475,120,2.76,4330,4559
بپيوند,برق و انرژي پيوندگستر پارس,2452,5678773,68197031650,11370,11390,12050,680,5.98,12010,640,5.63,11040,12050
ثبهساز,بهساز كاشانه تهران,2431,12372120,20127487401,1635,1619,1628,-7,-0.43,1627,-8,-0.49,1612,1648
وغدير,سرمايه‌گذاري‌غدير(هلدينگ‌,2430,14941182,222206281990,14770,14650,14990,220,1.49,14870,100,0.68,14650,15010
سصفها,سيمان‌اصفهان‌,2377,5169744,272004857750,53550,51880,53590,40,0.07,52610,-940,-1.76,50880,54500
وتوصا,گروه س توسعه صنعتي ايران,2349,16064713,172781030150,10670,10800,10590,-80,-0.75,10760,90,0.84,10220,11090
تجلي,تجلي توسعه معادن و فلزات,2335,57005931,89816016457,1555,1555,1556,1,0.06,1576,21,1.35,1550,1612
صباح,ح . گروه مالي صبا تامين,2326,25406720,61564529250,2419,2440,2435,16,0.66,2423,4,0.17,2397,2450
آبادا,توليد نيروي برق آبادان,2232,1695350,21692665840,12660,12750,12840,180,1.42,12800,140,1.11,12280,13100
شگويا,پتروشيمي تندگويان,2220,11694158,146290468750,12550,12270,12500,-50,-0.4,12510,-40,-0.32,12270,12650
صبا,گروه مالي صبا تامين,2218,22134851,111142583170,5020,4980,5050,30,0.6,5020,0,0,4930,5060
سيتا,سرمايه گذاري سيمان تامين,2217,3563981,42189957200,11530,11390,11970,440,3.82,11780,250,2.17,11390,11980
فاسمين,كالسيمين‌,2203,8539224,181590296700,21190,21010,21230,40,0.19,21270,80,0.38,20990,21580
افران,صندوق س افرا نماد پايدار-ثابت,2186,49403862,809276103022,16370,16381,16381,11,0.07,16381,11,0.07,16380,16383
شفارس,صنايع‌ شيميايي‌ فارس‌,2173,60954200,87137654129,1360,1398,1441,81,5.96,1430,70,5.15,1381,1441
توسن,توسعه سامانه ي نرم افزاري نگين,2162,2098675,46917703850,22150,22600,22150,0,0,22350,200,0.9,22050,22700
زگلدشت,كشت و دام گلدشت نمونه اصفهان,2162,9747801,112220165240,12090,11990,11410,-680,-5.62,11510,-580,-4.8,11370,12360
فسبزوار,پارس فولاد سبزوار,2148,3583163,100389717220,27990,27990,27980,-10,-0.04,28020,30,0.11,27950,28220
غبشهر,صنعتي‌ بهشهر,2142,31758098,135660569009,4294,4390,4185,-109,-2.54,4272,-22,-0.51,4150,4444
بورس,بورس اوراق بهادار تهران,2118,12752118,117598300500,9270,9210,9130,-140,-1.51,9220,-50,-0.54,9130,9350
وسپهر,سرمايه گذاري مالي سپهرصادرات,2118,3648187,27573705040,7620,7500,7560,-60,-0.79,7600,-20,-0.26,7500,7600
غمارگ,مارگارين‌,2102,31565446,109964671967,3525,3560,3447,-78,-2.21,3484,-41,-1.16,3402,3640
پتاير,ايران‌ تاير,2089,47352092,79714730351,1635,1620,1672,37,2.26,1683,48,2.94,1600,1725
لپارس,پارس‌ الكتريك‌,2068,951615,108916726670,111580,112550,112500,920,0.82,114450,2870,2.57,111590,116480
طلا,صندوق س.پشتوانه طلاي لوتوس,2034,2441006,248620255615,100422,101401,101850,1428,1.42,101852,1430,1.42,101137,102272
وپارس,بانك‌پارسيان‌,2021,78686137,163822499600,2097,2100,2075,-22,-1.05,2082,-15,-0.72,2070,2111
چخزر,صنايع چوب خزر كاسپين,2006,515569,16358416950,31200,31900,31650,450,1.44,31750,550,1.76,31250,32300
فتوسا,توليد و توسعه سرب روي ايرانيان,1991,14767772,112241822800,7260,7130,7620,360,4.96,7600,340,4.68,7130,7620
گشان,توسعه بين المللي پديده شانديز,1987,5475028,114320609700,21350,21250,20800,-550,-2.58,20900,-450,-2.11,20750,21700
غگيلا,شيرپاستوريزه پگاه گيلان,1984,2472829,39926952610,15870,15760,15990,120,0.76,16150,280,1.76,15700,16450
خكاوه,سايپا ديزل,1937,35220753,305432181120,8700,8440,8960,260,2.99,8670,-30,-0.34,8440,8960
سدبير,س. تدبيرگران فارس وخوزستان,1934,3415842,109936188100,32050,33800,31550,-500,-1.56,32200,150,0.47,31050,33800
ساينا,صنايع بهداشتي ساينا,1929,2481682,220645077700,94450,88800,88950,-5500,-5.82,88900,-5550,-5.88,88800,90000
زماهان,مجتمع توليد گوشت مرغ ماهان,1929,10835022,103023759000,9820,9800,9300,-520,-5.3,9510,-310,-3.16,9240,9980
بگيلان,توسعه مسير برق گيلان,1906,680568,9957789460,14490,14300,14700,210,1.45,14550,60,0.41,14230,14840
دسانكو,داروسازي سبحان انكولوژي,1899,6411529,75256120770,12060,11860,11710,-350,-2.9,11740,-320,-2.65,11500,12270
شبريزح,ح. پالايش نفت تبريز,1889,7407499,113734920040,15460,15590,15280,-180,-1.16,15350,-110,-0.71,15250,15750
غويتا,ويتانا,1889,15120704,86408417260,5820,5800,5690,-130,-2.23,5710,-110,-1.89,5550,5960
شوينده,مديريت صنعت شوينده ت.ص.بهشهر,1874,4325018,95682118120,21980,22180,22780,800,3.64,22120,140,0.64,20740,23240
قشرين,قند شيرين خراسان,1863,18886388,103791433460,5630,5470,5590,-40,-0.71,5500,-130,-2.31,5470,5620
واحصا,احياء صنايع خراسان,1859,2059125,216568499550,103400,106500,103650,250,0.24,105200,1800,1.74,102100,106500
فگستر,گسترش صنايع روي ايرانيان,1854,3163042,24973062340,7790,7780,7770,-20,-0.26,7900,110,1.41,7430,8150
كلر,كلر پارس,1805,732901,69447807600,97750,95300,94300,-3450,-3.53,94750,-3000,-3.07,93500,97800
ثشاهد,سرمايه‌ گذاري‌ شاهد,1804,15927693,152741851550,9820,9600,9580,-240,-2.44,9590,-230,-2.34,9310,9900
زنجان,صنايع كشاورزي وكود زنجان,1753,16275583,68204974981,4250,4132,4178,-72,-1.69,4191,-59,-1.39,4123,4365
قرن,پديده شيمي قرن,1748,4280695,111340370250,25890,25420,26090,200,0.77,26010,120,0.46,25110,26600
جم پيلن,پتروشيمي جم پيلن,1741,2189405,303661707740,141910,135020,138120,-3790,-2.67,138700,-3210,-2.26,135000,140860
امين,تامين سرمايه امين,1731,1031220,11105681980,10770,10770,10780,10,0.09,10770,0,0,10760,10780
ختوقا,قطعات‌ اتومبيل‌ ايران‌,1723,27438447,93517531569,3400,3334,3379,-21,-0.62,3408,8,0.24,3330,3500
ونيرو,سرمايه‌گذاري‌نيرو,1720,33510143,98233964403,3047,3010,2970,-77,-2.53,2931,-116,-3.81,2870,3055
پيزد,مجتمع صنايع لاستيك يزد,1714,2758038,36956961750,13210,13380,13330,120,0.91,13400,190,1.44,13270,13530
كزغال,زغال سنگ پروده طبس,1708,2195106,44693801750,20600,20250,20350,-250,-1.21,20350,-250,-1.21,20100,20800
كماسه,تامين‌ ماسه‌ ريخته‌گري‌,1703,30414412,112474487100,3789,3789,3790,1,0.03,3698,-91,-2.4,3600,3840
ختور,رادياتور ايران‌,1684,9389464,126461962410,13000,12800,13780,780,6,13470,470,3.62,12800,13780
فاراك,ماشين‌ سازي‌ اراك‌,1676,49504662,83319628497,1692,1661,1670,-22,-1.3,1683,-9,-0.53,1661,1725
بجهرم,توسعه مولد نيروگاهي جهرم,1667,33645178,81403143746,2345,2316,2426,81,3.45,2419,74,3.16,2304,2459
كرماشا,صنايع پتروشيمي كرمانشاه,1629,5436643,360466938240,66910,66020,66370,-540,-0.81,66300,-610,-0.91,66020,66760
شپاكسا,پاكسان‌,1623,63554498,173087398900,2608,2550,2764,156,5.98,2723,115,4.41,2545,2764
شكربن,كربن‌ ايران‌,1622,19410955,80553706174,4283,4300,4120,-163,-3.81,4150,-133,-3.11,4080,4300
ولپارس,ليزينگ پارسيان,1614,2868020,9892267049,3491,3340,3449,-42,-1.2,3462,-29,-0.83,3340,3570
شسينا,صنايع‌شيميايي‌سينا,1611,30959069,65173215038,2164,2199,2099,-65,-3,2105,-59,-2.73,2075,2199
كهمدا,شيشه‌ همدان‌,1609,15577363,205666759960,12630,12450,13150,520,4.12,13200,570,4.51,12450,13380
ولساپا,ليزينگ رايان‌ سايپا,1609,50670137,83099796453,1647,1634,1657,10,0.61,1640,-7,-0.43,1628,1660
فارس,صنايع پتروشيمي خليج فارس,1607,13075311,110588107470,8450,8450,8490,40,0.47,8460,10,0.12,8440,8490
كپارس,كاشي‌ پارس‌,1607,13056956,143990227900,11340,11250,10780,-560,-4.94,11030,-310,-2.73,10780,11310
كچاد,معدني‌وصنعتي‌چادرملو,1594,9755881,165509351370,16960,16950,16960,0,0,16970,10,0.06,16500,17100
ميهن,بيمه ميهن,1593,36091579,132229168980,3504,3580,3679,175,4.99,3664,160,4.57,3570,3679
حپترو,حمل و نقل پتروشيمي( سهامي عام,1578,3698029,95759895280,25880,25500,26480,600,2.32,25890,10,0.04,24590,26710
ديران,ايران‌دارو,1577,3800478,78705730930,21030,20760,20990,-40,-0.19,20710,-320,-1.52,20210,21360
شپلي,پلي اكريل ايران,1568,14502919,116314175560,7860,7850,8090,230,2.93,8020,160,2.04,7850,8090
كبافق,معادن‌ بافق‌,1551,2094539,83734697560,39290,40000,39510,220,0.56,39980,690,1.76,38730,41100
زنگان,صنعت روي زنگان,1548,1514243,86404958900,55700,56850,58200,2500,4.49,57050,1350,2.42,55000,58600
قلرست,قند لرستان‌,1547,3827471,95530184270,25130,25250,24880,-250,-0.99,24960,-170,-0.68,23990,25800
البرز,بيمه البرز,1546,96287008,235693974427,2485,2450,2423,-62,-2.49,2448,-37,-1.49,2336,2490
فخوز,فولاد  خوزستان,1529,24175309,149775135380,6170,6190,6220,50,0.81,6200,30,0.49,6160,6240
سخواف,سيمان مجد خواف,1528,7069187,59643276250,8380,8360,8530,150,1.79,8440,60,0.72,8130,8630
خصدرا,صنعتي‌ دريايي‌ ايران‌,1494,36698306,74846592470,2078,2026,2019,-59,-2.84,2040,-38,-1.83,2016,2095
تسه1401,امتيازتسهيلات مسكن سال1401,1489,72517,90933417320,1319957,1253960,1253960,-65997,-5,1253960,-65997,-5,1253960,1253960
رافزا,رايان هم افزا,1489,151235,8668395600,56900,54650,56750,-150,-0.26,57150,250,0.44,54650,58400
فسازان,غلتك سازان سپاهان,1484,15564392,92416837170,5720,6000,5860,140,2.45,5940,220,3.85,5800,6000
لطيف,محصولات كاغذي لطيف,1480,417141,19368402100,45450,45400,46650,1200,2.64,46450,1000,2.2,45400,47000
فگسترح,ح . گسترش صنايع روي ايرانيان,1479,5266725,25839213933,4884,4677,4901,17,0.35,4906,22,0.45,4677,5097
ثنوسا,نوسازي‌وساختمان‌تهران‌,1447,18727126,98188279250,5460,5320,5220,-240,-4.4,5240,-220,-4.03,5190,5470
بنو,بيمه تجارت نو,1445,9668732,60664150320,6490,6450,6280,-210,-3.24,6270,-220,-3.39,6170,6490
پارند,صندوق س. پارند پايدار سپهر,1445,42369003,427735029440,10089,10095,10096,7,0.07,10095,6,0.06,10095,10096
قچار,فراوردههاي غذايي وقند چهارمحال,1443,4897527,55646766710,11360,11370,11170,-190,-1.67,11360,0,0,11170,11630
وپست,پست بانك ايران,1440,23283674,96701262172,4067,4070,4168,101,2.48,4153,86,2.11,4068,4240
غپاك,لبنيات‌ پاك‌,1438,4692668,60937215240,13460,13680,12820,-640,-4.75,12990,-470,-3.49,12790,13680
حگردش,ريل گردش ايرانيان,1434,17403593,47816786131,2797,2732,2750,-47,-1.68,2748,-49,-1.75,2714,2828
ضسپا3016,اختيارخ خساپا-2500-1401/03/25,1426,73985,2022471000,35,33,20,-15,-42.86,27,-8,-22.86,19,36
وگستر,گسترش سرمايه گذاري ايرانيان,1422,15300156,106313406230,6630,6700,7020,390,5.88,6950,320,4.83,6320,7020
ونوين,بانك‌اقتصادنوين‌,1413,27644645,111148447015,4042,4021,4000,-42,-1.04,4021,-21,-0.52,3985,4074
بالاس,مهندسي ساختمان تاسيسات راه آهن,1401,1847030,57894707000,31600,31650,31750,150,0.47,31350,-250,-0.79,30250,32250
بكاب,صنايع‌جوشكاب‌يزد,1393,792138,56165896310,70130,71500,69530,-600,-0.86,70900,770,1.1,69010,72990
فرآور,فرآوري‌موادمعدني‌ايران‌,1377,2279300,80888086440,34900,35990,34730,-170,-0.49,35490,590,1.69,34510,36490
زدشت,كشت و صنعت دشت خرم دره,1377,2724568,74300376150,27350,28900,26350,-1000,-3.66,27250,-100,-0.37,26150,28900
ثنور,سرمايه گذاري كوه نور,1377,12557912,101871916460,8350,8290,8100,-250,-2.99,8110,-240,-2.87,8100,8300
ثمسكن,سرمايه‌گذاري‌ مسكن‌,1375,23106654,96377487829,3969,4188,4207,238,6,4171,202,5.09,4042,4207
چكاپا,گروه صنايع كاغذ پارس,1360,18542648,63436794352,3395,3415,3440,45,1.33,3421,26,0.77,3378,3498
آرام,صندوق س شاخصي آرام مفيد,1360,8899270,100221874210,11190,11300,11270,80,0.71,11260,70,0.63,11190,11300
فجر,فولاد اميركبيركاشان,1358,4157797,87126797250,20980,21390,20890,-90,-0.43,20960,-20,-0.1,20600,21390
شسپا,نفت سپاهان,1345,28238808,96315789952,3432,3401,3452,20,0.58,3411,-21,-0.61,3386,3460
خاذين,سايپاآذين‌,1344,32122760,67375187340,2155,2050,2114,-41,-1.9,2097,-58,-2.69,2050,2153
اخابر,مخابرات ايران,1343,11428706,93220876670,8280,8100,8130,-150,-1.81,8180,-100,-1.21,7910,8300
تسه1400,امتيازتسهيلات مسكن سال1400,1339,23603,29468904356,1300900,1235855,1235855,-65045,-5,1248524,-52376,-4.03,1235855,1360000
نتوس,پشم‌ بافي‌ توس,1338,6072243,61526354880,10180,10480,10050,-130,-1.28,10130,-50,-0.49,9880,10480
غدشت,دشت‌ مرغاب‌,1334,6123367,107763775150,16820,17630,17500,680,4.04,17600,780,4.64,17000,17660
غمينو,شركت صنايع غذايي مينو شرق,1327,14843943,88360440150,6020,5720,6000,-20,-0.33,5950,-70,-1.16,5670,6120
ثفارس,عمران‌وتوسعه‌فارس‌,1324,11526531,75310570510,6420,6380,6680,260,4.05,6530,110,1.71,6300,6720
بخاور,بيمه زندگي خاورميانه,1289,27728679,72046018274,2576,2585,2614,38,1.48,2598,22,0.85,2548,2658
ثاخت,بين‌المللي‌توسعه‌ساختمان,1287,28623543,68740840167,2391,2362,2425,34,1.42,2402,11,0.46,2346,2443
فزرين,زرين معدن آسيا,1281,6631972,49633431660,7620,7500,7490,-130,-1.71,7480,-140,-1.84,7380,7690
غسالم,سالمين‌,1265,12102313,44232631910,3707,3570,3630,-77,-2.08,3655,-52,-1.4,3570,3760
ولكار,ليزينگ كارآفرين,1263,533592,3518656500,6430,6500,6500,70,1.09,6470,40,0.62,6490,6630
كدما,معدني‌ دماوند,1256,1803067,165291580300,87320,91680,91680,4360,4.99,91670,4350,4.98,90560,91680
كاذر,فرآورده‌هاي‌نسوزآذر,1255,8315457,124856171310,14600,14930,15000,400,2.74,15010,410,2.81,14460,15330
فوكا,فولاد كاويان,1246,9893987,153095961280,15030,15290,15480,450,2.99,15470,440,2.93,15200,15480
پارسيان,بيمه پارسيان,1241,16912801,64115029190,3821,3706,3752,-69,-1.81,3791,-30,-0.79,3706,3884
كارا,صندوق س. كارا -د,1241,46443247,528488187826,11373,11380,11379,6,0.05,11379,6,0.05,11379,11381
شيران,س. صنايع‌شيميايي‌ايران,1239,3312292,67576272920,20240,20090,20440,200,0.99,20380,140,0.69,20090,20840
بشهاب,لامپ‌  پارس‌ شهاب‌,1238,517660,49597787840,97930,96760,94850,-3080,-3.15,95810,-2120,-2.16,94800,98590
وسينا,بانك سينا,1237,31979575,82740736788,2655,2689,2566,-89,-3.35,2587,-68,-2.56,2561,2689
مفاخر,توسعه فناوري اطلاعات خوارزمي,1236,3358774,179207629550,52000,52950,54000,2000,3.85,53350,1350,2.6,52200,54000
پاكشو,گروه صنعتي پاكشو,1229,11013256,74522805360,6710,6620,6830,120,1.79,6740,30,0.45,6450,6980
فسرب,ملي‌ سرب‌وروي‌ ايران‌,1224,26082635,47973095757,1824,1782,1824,0,0,1839,15,0.82,1782,1879
كيسون,شركت كيسون,1220,38260616,64919983288,1663,1630,1712,49,2.95,1697,34,2.04,1630,1712
وسپه,سرمايه‌گذاري‌ سپه‌,1219,7206874,65511676180,8990,8980,9110,120,1.33,9090,100,1.11,8920,9140
اپال,فرآوري معدني اپال كاني پارس,1210,2151358,44772104010,20720,20980,20840,120,0.58,20750,30,0.14,20460,21000
شاراك,پتروشيمي شازند,1197,2235241,104905403650,46120,46740,47390,1270,2.75,46930,810,1.76,46130,47770
غشصفا,شيرپاستوريزه‌پگاه‌اصفهان‌,1192,2146799,46835647290,23330,22960,21600,-1730,-7.42,21820,-1510,-6.47,21590,22960
آگاس,صندوق س.هستي بخش آگاه-س,1184,548517,48660396817,88282,88300,89048,766,0.87,88713,431,0.49,88021,89462
شجم,صنايع پتروشيمي تخت جمشيد,1181,8996558,111282069790,12520,12100,12160,-360,-2.88,12370,-150,-1.2,12100,12600
ودي,بيمه  دي,1174,15722975,96898967670,6060,6110,6150,90,1.49,6160,100,1.65,6000,6390
وآوا,سرمايه گذاري آوا نوين,1172,10308762,39275490909,3981,4000,3799,-182,-4.57,3810,-171,-4.3,3743,4020
فنوال,نورد آلومينيوم‌,1169,3654633,122718572750,32300,33000,33460,1160,3.59,33580,1280,3.96,32600,34000
خمحركه,نيرو محركه‌,1155,11629933,49867282667,4373,4300,4243,-130,-2.97,4288,-85,-1.94,4208,4428
زبينا,كشاورزي و دامپروري بينالود,1152,12821209,44275716480,3438,3477,3421,-17,-0.49,3453,15,0.44,3320,3590
ملت,بيمه ملت,1150,37755028,50577165661,1360,1340,1330,-30,-2.21,1340,-20,-1.47,1314,1375
دلقما,دارويي‌ لقمان‌,1144,28231091,61163251256,2075,2080,2178,103,4.96,2167,92,4.43,2080,2178
شگل,گلتاش‌,1144,10843062,68256365930,6220,6150,6270,50,0.8,6290,70,1.13,5950,6520
ماديرا,صنايع ماديران,1132,14137247,49101854348,3446,3480,3514,68,1.97,3473,27,0.78,3400,3548
فروي,ذوب روي اصفهان,1129,2729639,49028664250,17810,17990,17720,-90,-0.51,17960,150,0.84,17600,18310
زفكا,كشت و دامداري فكا,1126,6909380,77224648730,11310,11300,10900,-410,-3.63,11180,-130,-1.15,10880,11560
آباد,توريستي ورفاهي آبادگران ايران,1122,1387021,48472126460,36260,36150,34680,-1580,-4.36,34950,-1310,-3.61,34450,36180
غصينو,صنعتي مينو,1121,3180855,52309803510,16700,16700,16350,-350,-2.1,16500,-200,-1.2,16200,16940
فولاي,صنايع فولاد آلياژي يزد,1121,6472813,63278184110,9640,9370,9900,260,2.7,9780,140,1.45,9070,10000
ضخود3058,اختيارخ خودرو-2500-1401/03/04,1116,53640,422347000,16,14,7,-9,-56.25,8,-8,-50,6,14
غديس,پاكديس,1113,4637467,59419574050,12420,12820,12890,470,3.78,12810,390,3.14,12320,13160
شلعاب,لعابيران‌,1113,9219408,60672533770,6290,6490,6600,310,4.93,6580,290,4.61,6400,6600
سشرق,سيمان‌ شرق‌,1107,6423267,59199847890,9130,9130,9160,30,0.33,9220,90,0.99,9070,9400
كسرا,سراميك‌هاي‌صنعتي‌اردكان‌,1107,13785888,101433251880,7680,7710,7350,-330,-4.3,7360,-320,-4.17,7260,7710
دتوليد,داروسازي توليد دارو,1104,8578729,85061496260,9430,9370,9990,560,5.94,9920,490,5.2,9370,9990
كفرا,فراورده‌ هاي‌ نسوزايران‌,1102,5184929,62529922080,11250,11700,11990,740,6.58,12060,810,7.2,11700,12280
سنوين,سرمايه گذاري اقتصاد نوين,1099,11746259,74684665250,6230,6410,6240,10,0.16,6360,130,2.09,6080,6410
اهرم,صندوق س سهامي كاريزما- اهرمي,1092,11102716,160132250510,14640,14770,14370,-270,-1.84,14420,-220,-1.5,14190,14790
تماوند,تامين سرمايه دماوند,1089,11659001,66632398380,5660,5760,5660,0,0,5720,60,1.06,5600,5800
ورازي,بيمه رازي,1085,52878112,110397552815,2054,2100,2024,-30,-1.46,2088,34,1.66,2022,2113
فباهنر,مس‌ شهيدباهنر,1075,1713091,58209314570,33830,33280,33600,-230,-0.68,33980,150,0.44,33280,34700
وجامي,سرمايه گذاري جامي,1074,14059962,63950378243,4671,4531,4531,-140,-3,4548,-123,-2.63,4531,4730
كيميا,معدني كيمياي زنجان گستران,1072,8751582,61548133060,6990,7030,7120,130,1.86,7030,40,0.57,6910,7160
وثنو,سرمايه گذاري ساختماني نوين,1069,16821323,40707469787,2491,2417,2417,-74,-2.97,2420,-71,-2.85,2417,2469
كرازي,كارخانجات‌توليدي‌شيشه‌رازي‌,1062,40604448,67948508911,1677,1670,1695,18,1.07,1673,-4,-0.24,1626,1705
وملي,گروه‌ صنعتي‌ ملي‌ (هلدينگ‌,1058,266438,41120188590,152250,151350,153210,960,0.63,154330,2080,1.37,151330,158000
تپكو,توليدتجهيزات‌سنگين‌هپكو,1051,24057366,42454394709,1815,1763,1761,-54,-2.98,1765,-50,-2.75,1761,1795
رانفور,خدمات‌انفورماتيك‌,1039,18777206,80447292224,4327,4379,4349,22,0.51,4284,-43,-0.99,4204,4379
شپديس,پتروشيمي پرديس,1034,635093,112974277480,175070,177500,177050,1980,1.13,177890,2820,1.61,175410,178890
شغدير,پتروشيمي غدير,1032,845169,80033707440,94650,94650,95290,640,0.68,94700,50,0.05,93960,95830
غشهداب,كشت و صنعت شهداب ناب خراسان,1031,13215967,38681976803,2897,2899,2909,12,0.41,2927,30,1.04,2890,2979
افق,فروشگاههاي زنجيره اي افق كوروش,1029,1283333,63374594190,50390,50500,48670,-1720,-3.41,49380,-1010,-2,48650,50500
واحيا,م .صنايع و معادن احياء سپاهان,1022,5463031,111319224620,20420,20410,20390,-30,-0.15,20380,-40,-0.2,20060,20990
ستران,سيمان‌ تهران‌,1019,3356041,92323837370,26100,26000,27660,1560,5.98,27510,1410,5.4,25560,27660
غاذر,كشت‌وصنعت‌پياذر,1018,4401632,249923887590,54100,56800,56800,2700,4.99,56780,2680,4.95,55650,56800
كگل,معدني و صنعتي گل گهر,1001,6950152,96165522760,13800,13750,13850,50,0.36,13830,30,0.22,13510,13940
وليز,ليزينگ‌ايران‌,993,20290600,41023727858,1962,2060,1973,11,0.56,2022,60,3.06,1950,2060
غشاذر,پگاه‌آذربايجان‌غربي‌,991,7728427,46469995310,6230,6390,5860,-370,-5.94,6010,-220,-3.53,5860,6390
وگردش,بانك گردشگري,985,9808741,111235147850,11410,11070,11070,-340,-2.98,11340,-70,-0.61,11070,11600
خكمك,كمك‌فنرايندامين‌,984,4822223,113183825840,22740,22220,23790,1050,4.62,23470,730,3.21,22220,23870
شصدف,صنعتي دوده فام,977,1032491,37018941600,36200,35300,35550,-650,-1.8,35850,-350,-0.97,35300,36750
حسير,ريل سير كوثر,950,2017802,41264838100,21000,21000,20200,-800,-3.81,20450,-550,-2.62,20050,21150
زكوثر,سرمايه گذاري كشاورزي كوثر,950,1966262,34045160460,17510,17020,17210,-300,-1.71,17310,-200,-1.14,17020,17880
وصنعت,سرمايه گذاري توسعه صنعت وتجارت,950,18592959,43856869210,2299,2260,2400,101,4.39,2359,60,2.61,2260,2410
زكشت,كشاورزي مكانيزه اصفهان كشت,949,1445926,35602227750,25450,25650,24000,-1450,-5.7,24600,-850,-3.34,23950,26200
تملت,تامين سرمايه بانك ملت,945,19948709,73908017361,3522,3502,3733,211,5.99,3705,183,5.2,3502,3733
وبانك,سرمايه گذاري گروه توسعه ملي,930,9131984,97436202370,10710,10710,10730,20,0.19,10680,-30,-0.28,10500,10890
آكورد,صندوق س. آرمان آتي كوثر-د,920,5737098,222724646992,38798,38821,38822,24,0.06,38822,24,0.06,38821,38824
زمگسا,كشاورزي‌ ودامپروي‌ مگسال‌,918,1992161,54277452740,27890,28940,27200,-690,-2.47,27250,-640,-2.29,26600,28940
سبزوا,سيمان لار سبزوار,897,30240736,122201744508,3813,4041,4041,228,5.98,4041,228,5.98,4000,4041
ختراك,ريخته‌گري‌ تراكتورسازي‌ ايران‌,892,15830873,101769876210,6280,6480,6590,310,4.94,6430,150,2.39,6160,6590
كاوه,فولاد كاوه جنوب كيش,884,5127994,67610789340,13260,12990,13260,0,0,13200,-60,-0.45,12900,13350
وبرق,س.کارکنان صنعت برق زنجان وقزوي,880,971669,83700560400,83700,86200,86200,2500,2.99,86150,2450,2.93,85000,86200
زشگزا,شير و گوشت زاگرس شهركرد,872,5970678,43307260000,7400,7470,7290,-110,-1.49,7250,-150,-2.03,7030,7500
زشريف,كشت وصنعت شريف آباد,869,6520314,29369785109,4604,4620,4525,-79,-1.72,4504,-100,-2.17,4400,4685
فپنتا,سپنتا,869,125339,86428512320,710460,710000,690090,-20370,-2.87,689560,-20900,-2.94,679000,710000
حآسا,آسيا سير ارس,868,2344886,34856035220,14570,14570,14700,130,0.89,14860,290,1.99,14470,15260
كفپارس,فرآورده‌هاي‌ نسوز پارس‌,862,13681847,60644219623,4273,4200,4486,213,4.98,4432,159,3.72,4200,4486
شبصير,توليدات پتروشيمي قائد بصير,861,509965,60863992450,120700,118450,119000,-1700,-1.41,119350,-1350,-1.12,118450,122000
اعتلا,شركت سرمايه گذاري اعتلاء البرز,859,14407252,60847192395,4004,4000,4244,240,5.99,4223,219,5.47,3950,4244
وهنر,گروه توسعه هنر ايران,857,12655250,30234893448,2443,2433,2380,-63,-2.58,2389,-54,-2.21,2370,2496
خودكفا,اقتصادي و خودكفايي آزادگان,857,6013788,46883152490,7820,8040,7760,-60,-0.77,7800,-20,-0.26,7720,8040
دزهراوي,داروسازي‌زهراوي‌,853,8806644,46780337090,5160,5080,5410,250,4.84,5310,150,2.91,5030,5410
توريل,توكاريل,852,7764555,73277374210,9030,8800,9370,340,3.77,9440,410,4.54,8800,9480
غگرجي,بيسكويت‌  گرجي‌,851,18116553,36993691894,1986,1920,2016,30,1.51,2042,56,2.82,1920,2081
دبالك,مواد اوليه دارويي البرز بالك,851,4647801,47713819870,10040,9560,10580,540,5.38,10270,230,2.29,9560,10600
وسبحان,سرمايه گذاري سبحان,851,19125100,73868198139,3757,3750,3920,163,4.34,3862,105,2.79,3702,3933
درهآور,دارويي ره آورد تامين,844,2535228,88294536950,33550,32400,35550,2000,5.96,34850,1300,3.87,32400,35550
ونيكي,سرمايه‌گذاري‌ ملي‌ايران‌,844,10824630,110191512000,10180,10130,10200,20,0.2,10180,0,0,10100,10340
آپ,آسان پرداخت پرشين,837,4657538,34426807280,7340,7330,7380,40,0.54,7390,50,0.68,7280,7540
كامياب,صندوق س. كامياب آشنا-د,836,23479982,284245886041,12099,12106,12106,7,0.06,12106,7,0.06,12105,12107
بهپاك,صنعتي بهپاك,828,6152614,47273025210,7900,8000,7740,-160,-2.03,7680,-220,-2.78,7560,8000
سمايه,بانك سرمايه,828,10386186,40911896086,3842,3930,3957,115,2.99,3939,97,2.52,3821,3957
تاصيكو,سرمايه گذاري صدرتامين,820,4752028,52491900680,11110,10940,11130,20,0.18,11080,-30,-0.27,10860,11160
غپينو,پارس‌ مينو,816,12572094,34816250766,2776,2847,2738,-38,-1.37,2769,-7,-0.25,2702,2860
زپارس,ملي كشت و صنعت و دامپروري پارس,811,3295955,122574498310,37990,38100,37100,-890,-2.34,37190,-800,-2.11,37000,38490
خكار,ايركا پارت صنعت,807,18758050,52464510551,2835,2800,2806,-29,-1.02,2797,-38,-1.34,2761,2850
كوير,توليدي فولاد سپيد فراب كوير,795,7807289,34549749153,4389,4341,4391,2,0.05,4418,29,0.66,4282,4480
غشان,شيرپاستوريزه‌پگاه‌خراسان‌,794,6463824,28367410703,4581,4638,4343,-238,-5.2,4389,-192,-4.19,4307,4648
سصوفي,سيمان‌ صوفيان‌,790,3266265,60934259820,17710,18350,18770,1060,5.99,18660,950,5.36,18000,18770
پدرخش,درخشان‌ تهران‌,788,4334245,35076545500,8160,7900,7990,-170,-2.08,8090,-70,-0.86,7900,8500
وملل,اعتباري ملل,787,9074821,72540041590,7640,7790,8020,380,4.97,7990,350,4.58,7620,8020
دروز,داروسازي‌ روزدارو,787,1814535,51417313080,27820,27300,28000,180,0.65,28340,520,1.87,27290,28850
رنيك,جنرال مكانيك,786,3523513,48656135140,13340,13130,14000,660,4.95,13810,470,3.52,13080,14000
سرو,صندوق س سروسودمند مدبران-سهام,784,2029168,162914058190,80460,80030,80110,-350,-0.43,80290,-170,-0.21,79850,81240
ماديراح,ح صنايع ماديران,783,9625021,16946591191,1781,1800,1742,-39,-2.19,1761,-20,-1.12,1729,1810
دكوثر,داروسازي‌ كوثر,782,13134600,49670407051,3581,3500,3795,214,5.98,3782,201,5.61,3500,3795
فروس,فروسيليس‌ ايران‌,781,6090356,46316062120,7450,7420,7600,150,2.01,7600,150,2.01,7340,7760
كارين,صندوق س نگين سامان-ثابت,779,21923004,219400709972,10177,10008,10009,-168,-1.65,10008,-169,-1.66,10006,10009
حريل,ريل پردازسير,765,14967789,42504604921,2846,2888,2888,42,1.48,2840,-6,-0.21,2811,2890
ولملت,واسپاري ملت,762,12688368,48823111946,4040,4250,3802,-238,-5.89,3848,-192,-4.75,3798,4250
قتربت,قند تربت حيدريه,762,114453,1994915790,16930,17430,17430,500,2.95,17030,100,0.59,17430,17430
فن آوا,گروه فن آوا,762,6318450,56028558940,8620,8870,8870,250,2.9,8870,250,2.9,8750,8870
ضخود3057,اختيارخ خودرو-2000-1401/03/04,760,27495,9622794000,362,340,352,-10,-2.76,350,-12,-3.31,326,375
تپمپي,پمپ‌ سازي‌ ايران‌,755,2896545,55799554130,18990,19190,19260,270,1.42,19260,270,1.42,18330,19750
دحاوي,الحاوي,754,4277979,25762685650,5890,5950,6060,170,2.89,6020,130,2.21,5790,6060
چدن,توليدي چدن سازان,753,17606386,42198716055,2390,2350,2370,-20,-0.84,2397,7,0.29,2350,2427
ثپرديس,سرمايه گذاري مسكن پرديس,744,9806003,45825743569,4575,4770,4590,15,0.33,4673,98,2.14,4585,4770
چكارن,كارتن‌ ايران‌,737,14034417,43785618688,3067,3077,3081,14,0.46,3120,53,1.73,3077,3177
تيپيكو,سرمايه گذاري دارويي تامين,736,3438550,78430882360,22970,22940,22700,-270,-1.18,22840,-130,-0.57,22010,22990
كحافظ,كاشي‌ وسراميك‌ حافظ‌,734,6554871,33568174634,5103,5200,5099,-4,-0.08,5121,18,0.35,5010,5248
خلنت,لنت‌ ترمزايران‌,730,647065,22263070940,35200,34450,34200,-1000,-2.84,34410,-790,-2.24,34000,35320
وشمال,س. چشم انداز توسعه شمال,727,1532872,37342605900,24800,24350,24350,-450,-1.81,24350,-450,-1.81,24350,24750
وشهر,بانك شهر,726,8510194,40584926163,4795,4654,4850,55,1.15,4769,-26,-0.54,4652,4938
خراسان,پتروشيمي خراسان,723,487387,65410422520,130400,135990,134500,4100,3.14,132990,2590,1.99,132350,135990
هجرت,پخش هجرت,721,2622614,85345267400,32900,33000,32450,-450,-1.37,32550,-350,-1.06,31950,33200
سهرمز,سيمان‌هرمزگان‌,721,2225161,48066233970,21180,22000,22060,880,4.15,21600,420,1.98,21010,22180
حفارس,حمل و نقل بين المللي خليج فارس,720,4561812,42666515350,9560,9570,9220,-340,-3.56,9350,-210,-2.2,9100,9600
تاپيكو,س. نفت و گاز و پتروشيمي تأمين,719,5154595,86939031380,16860,16600,16890,30,0.18,16860,0,0,16600,17060
ومهان,گروه توسعه مالي مهر آيندگان,719,14360852,82927629400,5740,5580,5760,20,0.35,5770,30,0.52,5580,5830
خوساز,محورسازان‌ايران‌خودرو,718,4724786,40200982130,8880,8610,8460,-420,-4.73,8510,-370,-4.17,8440,8850
وصنا,گروه‌صنايع‌بهشهرايران‌,718,11996789,43783924028,3653,3590,3620,-33,-0.9,3650,-3,-0.08,3590,3720
قاروم,قند اروميه,716,2254781,450430964077,1,199150,193176,193175,19317500,199767,199766,19976600,193176,205124
تاپكيش,تجارت الكترونيك پارسيان كيش,709,2313333,33429698300,14540,14780,14330,-210,-1.44,14450,-90,-0.62,14210,15100
خمهر,مهركام‌پارس‌,694,20363771,46168920239,2269,2260,2209,-60,-2.64,2267,-2,-0.09,2201,2350
ريشمك,توليد و صادرات ريشمك,692,1501931,41949603900,26550,26150,28100,1550,5.84,27950,1400,5.27,26150,28100
ثباغ,شهر سازي و خانه سازي باغميشه,691,3409033,29507863740,8960,8960,8590,-370,-4.13,8660,-300,-3.35,8510,9050
مداران,داده‌پردازي‌ايران‌,689,3332543,65436481710,18800,18610,19740,940,5,19640,840,4.47,18610,19740
ثرود,سرمايه‌گذاري مسكن زاينده رود,685,3218364,42377072790,13600,14210,12790,-810,-5.96,13170,-430,-3.16,12790,14210
هرمز,فولاد هرمزگان جنوب,679,3324667,56979718920,17210,17160,17100,-110,-0.64,17180,-30,-0.17,16910,17300
رمپنا,گروه مپنا (سهامي عام),678,2188592,37698762960,17110,17110,17180,70,0.41,17150,40,0.23,17110,17520
وبوعلي,سرمايه‌گذاري‌بوعلي‌,677,6544023,34194517130,5100,5190,5270,170,3.33,5230,130,2.55,5050,5330
فافزا,فولاد افزا سپاهان,676,763398,40356933550,51650,50400,53050,1400,2.71,52850,1200,2.32,50400,53150
دلر,داروسازي‌ اكسير,674,1897521,87536996600,45220,45300,46940,1720,3.8,46130,910,2.01,45300,46940
واتي,سرمايه‌ گذاري‌ آتيه‌ دماوند,668,10118790,105806416230,10010,10000,10610,600,5.99,10460,450,4.5,9950,10610
كگهر,سنگ آهن گهرزمين,662,856654,42926141500,50000,49550,50550,550,1.1,50050,50,0.1,49000,50700
تسه0011,امتيازتسهيلات مسكن بهمن 1400,661,7721,9563602286,1298000,1233100,1290000,-8000,-0.62,1238648,-59352,-4.57,1233100,1290000
وتوكا,سرمايه‌گذاري‌توكافولاد(هلدينگ,661,4610189,47044433520,10010,10020,10200,190,1.9,10200,190,1.9,10000,10350
سغرب,سيمان‌غرب‌,652,2352009,46646662370,20670,19430,20050,-620,-3,19830,-840,-4.06,19430,20660
سشمال,سيمان‌ شمال‌,649,3861462,50554866280,13070,13280,12660,-410,-3.14,13090,20,0.15,12630,13700
نيرو,نيرو سرمايه,640,5995075,149191873150,24200,24900,24900,700,2.89,24900,700,2.89,24350,24900
شپترو,پتروشيمي آبادان,639,10030046,23357640294,2342,2320,2310,-32,-1.37,2329,-13,-0.56,2290,2380
فسپا,گروه‌صنعتي‌سپاهان‌,639,2836047,47135196140,16720,16700,16660,-60,-0.36,16620,-100,-0.6,16530,17000
فلامي,لاميران‌,638,1269613,26048236560,20320,20200,20500,180,0.89,20520,200,0.98,19580,21120
غگلپا,شير پاستوريزه پگاه گلپايگان,638,879863,47357291750,55250,57000,55000,-250,-0.45,53800,-1450,-2.62,52600,57000
نوين,بيمه نوين,631,8973577,19630836409,2183,2260,2189,6,0.27,2188,5,0.23,2111,2260
ثنام,س ساختماني ب نام آوران مهندسي,627,4070614,25451194080,6400,6280,6210,-190,-2.97,6250,-150,-2.34,6210,6490
خرينگ,رينگ‌سازي‌مشهد,622,1502521,37344787520,25030,25340,24420,-610,-2.44,24850,-180,-0.72,24010,25700
خاهن,آهنگري‌ تراكتورسازي‌ ايران‌,621,3703318,23665550930,6480,6350,6480,0,0,6420,-60,-0.93,6280,6570
كساوه,صنايع‌ كاشي‌ و سراميك‌ سينا,618,1002924,52002261350,51920,50300,51940,20,0.04,51850,-70,-0.13,50300,52000
مدير,ص.س.مديريت ثروت ص.بازنشستگي-س,615,4208414,47675915151,11159,11360,11294,135,1.21,11329,170,1.52,11105,11360
كنور,توسعه معدني و صنعتي صبانور,609,2501155,49839940720,20030,19630,19770,-260,-1.3,19980,-50,-0.25,19630,20090
شخارك,پتروشيمي‌ خارك‌,606,1022089,48743196160,47690,48000,47470,-220,-0.46,47690,0,0,46180,48950
كشرق,صنعتي و معدني شمال شرق شاهرود,605,287288,27798997850,92700,94500,97550,4850,5.23,96750,4050,4.37,94400,97900
حتايد,تايدواترخاورميانه,601,5676931,33908425750,5970,5920,5980,10,0.17,5970,0,0,5870,6060
شپتروح,ح . پتروشيمي آبادان,597,19876505,22024054165,1139,1111,1105,-34,-2.99,1108,-31,-2.72,1105,1135
آ س پ,آ.س.پ,590,2825416,16444470880,5790,5730,5750,-40,-0.69,5820,30,0.52,5510,5990
نطرين,عطرين نخ قم,590,3529820,21770456340,6170,6440,6100,-70,-1.13,6170,0,0,6010,6440
كتوكا,توليدي و خدمات صنايع نسوز توكا,589,2053141,18535277680,8790,9000,9090,300,3.41,9030,240,2.73,8600,9250
ثتران,سرمايه گذاري مسكن تهران,587,6779745,23460357021,3452,3515,3450,-2,-0.06,3460,8,0.23,3400,3518
عيار,صندوق طلاي عيار مفيد,586,3205942,117399123151,36043,36360,36660,617,1.71,36619,576,1.6,36360,36808
وبشهر,توسعه‌ صنايع‌ بهشهر(هلدينگ,584,3800509,34191656770,9040,9080,8860,-180,-1.99,9010,-30,-0.33,8800,9190
آريان,سرمايه گذاري پارس آريان,583,7978737,56621891920,7200,7120,7140,-60,-0.83,7150,-50,-0.69,6990,7270
غشهد,شهد ايران ‌,582,5149198,30632383750,5930,5840,6000,70,1.18,5950,20,0.34,5740,6140
وتوسم,سرمايه‌گذاري‌توسعه‌ملي‌,574,8564105,39400403179,4646,4592,4628,-18,-0.39,4601,-45,-0.97,4570,4740
سخاش,سيمان‌خاش‌,573,297863,19426845490,64610,64810,66390,1780,2.75,65220,610,0.94,63700,67000
ساوه,سيمان ساوه,570,147965,8006624250,53900,55050,53850,-50,-0.09,54000,100,0.19,53400,55050
اطلس,صندوق س.توسعه اطلس مفيد-س,570,296494,83862680139,280266,280310,283498,3232,1.15,282848,2582,0.92,280310,283498
همراه,شركت ارتباطات سيار ايران,569,4790512,48055457460,10130,10200,10000,-130,-1.28,10090,-40,-0.39,9930,10200
غبهار,كشت وصنعت بهاران گلبهار خراسان,567,1976178,32271374230,16810,16810,16310,-500,-2.97,16330,-480,-2.86,16310,16810
سرچشمه,سرمايه گذاري مس سرچشمه,565,5513187,24749328902,4586,4550,4489,-97,-2.12,4489,-97,-2.12,4420,4620
شبهرن,نفت‌ بهران‌,559,2678318,39233442000,14670,14700,14660,-10,-0.07,14660,-10,-0.07,14480,14760
كترام,توليدي‌ كاشي‌ تكسرام‌,551,1337565,42029065540,31850,31690,31380,-470,-1.48,31420,-430,-1.35,30610,32000
ركيش,كارت اعتباري ايران كيش,549,3565662,19456573000,5380,5280,5430,50,0.93,5460,80,1.49,5280,5570
دسبحا,گروه دارويي سبحان,549,1349234,26002223010,19490,19400,19490,0,0,19270,-220,-1.13,18660,19980
دماوند,توليد نيروي برق دماوند,541,1508039,31531058100,20650,20650,21100,450,2.18,20850,200,0.97,20500,21150
رتاپ,تجارت الكترونيك  پارسيان,540,2102363,10745955380,5180,5090,5090,-90,-1.74,5130,-50,-0.97,5080,5170
بپاس,بيمه پاسارگاد,539,4153724,206458266850,49700,49700,49700,0,0,49700,0,0,49600,49750
پارسان,گسترش نفت و گاز پارسيان,535,3459714,107329018160,31000,30600,31010,10,0.03,31020,20,0.06,30600,31300
هكشو208,اختيارف ت پاكشو9799-02/08/29,533,26502393,14152277862,510,534,534,24,4.71,534,24,4.71,534,534
ثبات,صندوق س. ثبات ويستا -د,530,19823794,229685212119,11579,11587,11587,8,0.07,11586,7,0.06,11586,11587
والبر,سرمايه‌ گذاري‌ البرز(هلدينگ‌,526,4140133,30389242890,7330,7320,7340,10,0.14,7340,10,0.14,7200,7490
فنفت,صنايع تجهيزات نفت,526,1925923,64229532050,34350,33350,33350,-1000,-2.91,33350,-1000,-2.91,33350,33350
فايرا,آلومينيوم‌ايران‌,525,1882465,37369839750,20020,19980,20010,-10,-0.05,19940,-80,-0.4,19490,20070
بكهنوج,توليد برق ماهتاب كهنوج,525,18850696,23190210000,1225,1201,1221,-4,-0.33,1230,5,0.41,1201,1254
سكه0312پ01,تمام سكه طرح جديد0312 رفاه,525,243600,356190339400,1440266,1464452,1462602,22336,1.55,1462193,21927,1.52,1455000,1466990
چكاوه,صنايع‌كاغذسازي‌كاوه‌,523,4049231,32078380500,8100,7900,7920,-180,-2.22,7920,-180,-2.22,7780,8210
لسرما,سرما آفرين‌,522,1238484,34130501080,28950,27600,27510,-1440,-4.97,27560,-1390,-4.8,27510,28110
ولغدر,ليزينگ‌خودروغدير,520,2250799,25869605500,11410,11680,11300,-110,-0.96,11490,80,0.7,11010,12000
ثامان,سامان‌ گستراصفهان‌,514,3607134,54653392540,14580,14900,15280,700,4.8,15150,570,3.91,14500,15300
سنير,سيمان‌ سفيد ني‌ريز,513,1295364,47841392440,35200,36950,36960,1760,5,36930,1730,4.91,36500,36960
شكام,صنايع شيميايي كيمياگران امروز,512,1522820,52816218050,35150,35200,34600,-550,-1.56,34700,-450,-1.28,34400,35200
تبرك,گروه كارخانجات صنعتي تبرك,512,1441072,14549136400,10060,10170,9990,-70,-0.7,10100,40,0.4,9900,10380
وامير,گروه صنعتي و معدني امير,509,27831,10567063700,377800,380000,380000,2200,0.58,379350,1550,0.41,370050,388000
قاسم,قاسم ايران,509,5012453,24172729130,4870,4820,4770,-100,-2.05,4820,-50,-1.03,4760,4940
جم,پتروشيمي جم,508,2117314,101507335580,48000,47650,47940,-60,-0.13,47940,-60,-0.13,47000,48770
چفيبر,فيبر ايران‌,506,3460822,21956192100,6590,6660,6270,-320,-4.86,6340,-250,-3.79,6270,6660
آسيا,بيمه آسيا,505,18699219,34222202685,1829,1850,1830,1,0.05,1830,1,0.05,1810,1850
تسه0010,امتيازتسهيلات مسكن دي1400,504,5098,6354593927,1309095,1243641,1243641,-65454,-5,1246488,-62607,-4.78,1243641,1270000
جهرم,پتروشيمي جهرم,504,16570863,14671029156,881,880,905,24,2.72,885,4,0.45,860,907
كمرجان,بازرگاني و توليدي مرجان كار,502,2657900,17244535410,6310,6370,6470,160,2.54,6490,180,2.85,6350,6650
شيراز,پتروشيمي‌شيراز,500,1529016,120320946630,78710,79980,78700,-10,-0.01,78690,-20,-0.03,78160,79980
شنفت,نفت‌ پارس‌,497,3686823,33209249120,9120,9120,8940,-180,-1.97,9060,-60,-0.66,8910,9120
بزاگرس,نيروگاه زاگرس كوثر,497,4022355,19704201864,4758,4610,4958,200,4.2,4899,141,2.96,4610,4958
تكشا,گسترش‌صنايع‌وخدمات‌كشاورزي‌,496,522870,19744610340,38480,37660,37150,-1330,-3.46,37760,-720,-1.87,37020,38500
خموتور,موتورسازان‌تراكتورسازي‌ايران‌,495,9947949,44462913450,4277,4390,4490,213,4.98,4470,193,4.51,4300,4490
ساذري,آذريت‌,493,2668704,16094610720,6120,6050,6040,-80,-1.31,6030,-90,-1.47,5940,6290
قزوين,كارخانجات‌ قند قزوين‌,490,8860420,48745423490,5250,5400,5510,260,4.95,5500,250,4.76,5390,5510
دتماد,توليدمواداوليه‌داروپخش‌,488,690673,29504117880,43510,43220,42700,-810,-1.86,42720,-790,-1.82,42310,43430
كي بي سي,شركت كي بي سي,487,2436709,31666476740,12500,12590,13100,600,4.8,13000,500,4,12590,13120
خكرمان,سرمايه گذاري آرمان گستر پاريز,485,7497231,26272867535,3553,3460,3567,14,0.39,3504,-49,-1.38,3447,3598
پرديس,سرمايه گذاري پرديس,482,6141343,19489102951,3147,3200,3141,-6,-0.19,3173,26,0.83,3113,3250
فنرژي,گسترش صنايع انرژي آذرآب,481,3053260,23974402020,8000,7840,7940,-60,-0.75,7850,-150,-1.88,7840,8000
سپاها,سيمان‌سپاهان‌,481,2802471,30082302310,10780,10960,10680,-100,-0.93,10730,-50,-0.46,10630,11070
ثجوان,تامين مسكن جوانان,481,9633735,43784092042,4451,4480,4584,133,2.99,4545,94,2.11,4345,4584
ولشرق,ليزينگ ايران و شرق,478,10880836,24905314071,2206,2161,2338,132,5.98,2289,83,3.76,2149,2338
آساميد,صندوق س.مشترك آسمان اميد -د,472,11876345,176561025675,14858,14867,14867,9,0.06,14867,9,0.06,14866,14867
ثزاگرس,سرمايه گذاري توسعه عمران زاگرس,470,653084,21082590850,32750,32900,31900,-850,-2.6,32300,-450,-1.37,31800,33250
حتوكا,حمل‌ونقل‌توكا,470,1842651,31768760370,17160,16700,17070,-90,-0.52,17240,80,0.47,16700,17940
فالوم,آلومتك‌,470,1431784,21432100380,15330,15120,14880,-450,-2.94,14970,-360,-2.35,14880,15370
غبهنوش,بهنوش‌ ايران‌,468,394179,23932502440,61350,61800,60080,-1270,-2.07,60710,-640,-1.04,59900,62810
پارتا,مجتمع‌صنعتي‌آرتاويل‌تاير,466,1961258,35215057900,18480,18030,18100,-380,-2.06,17960,-520,-2.81,17930,18480
فراز,صندوق س.سهام فراز داريك-س,465,2775313,42454457978,15246,15250,15300,54,0.35,15297,51,0.33,15247,15301
ونفت,سرمايه‌گذاري‌ صنعت‌ نفت‌,463,6587481,30308804955,4610,4550,4600,-10,-0.22,4601,-9,-0.2,4550,4695
دفارا,داروسازي‌ فارابي‌,461,1523890,21376472010,14240,14470,13860,-380,-2.67,14030,-210,-1.47,13800,14470
پرداخت,به پرداخت ملت,460,2006507,46020461080,23700,23660,22900,-800,-3.38,22940,-760,-3.21,22520,24100
گوهر,صندوق سكه طلاي كيان,459,431362,30965290129,70668,71300,72299,1631,2.31,71785,1117,1.58,71234,72300
كلوند,كاشي‌ الوند,457,1005963,25504255520,25560,25640,25000,-560,-2.19,25350,-210,-0.82,24850,25960
غچين,كشت‌ و صنعت‌ چين‌ چين,455,1767330,21861974550,11960,11780,12370,410,3.43,12370,410,3.43,11780,12550
شزنگ,تجهيزنيروي‌زنگان‌,455,165039,14600805900,88200,90000,88950,750,0.85,88450,250,0.28,86050,90050
شفا,سرمايه گذاري شفادارو,444,2095631,35350352640,17010,17010,16980,-30,-0.18,16870,-140,-0.82,16590,17140
شكلر,نيروكلر,442,762105,35697694080,46600,46400,47350,750,1.61,46840,240,0.52,46000,47490
كساپا,سايپاشيشه‌,441,1551852,26477649180,16490,16650,16600,110,0.67,17060,570,3.46,16510,17310
داراب,پتروشيمي داراب,434,8557932,8249504728,979,979,965,-14,-1.43,966,-13,-1.33,950,989
سپيدما,صندوق س. سپيد دماوند-د,433,16815755,211860023291,12583,12603,12599,16,0.13,12599,16,0.13,12598,12603
وهور,مديريت انرژي اميد  تابان هور,429,11588767,16457961706,1436,1409,1429,-7,-0.49,1429,-7,-0.49,1400,1448
شدوص,دوده‌ صنعتي‌ پارس‌,426,1202851,15369073810,12630,12800,12880,250,1.98,12780,150,1.19,12560,12950
تكنار,مجتمع معادن مس تكنار,423,248261,14903050350,60900,61900,59900,-1000,-1.64,60050,-850,-1.4,59100,62200
شتوكا,توكا رنگ فولاد سپاهان,423,637828,11099676660,17170,17870,17270,100,0.58,17350,180,1.05,16710,18100
ميدكو,توسعه معادن وص.معدني خاورميانه,419,3701825,168588993370,45540,45600,45560,20,0.04,45540,0,0,45530,45600
گپارس,امور رفاهي كارگزاران پارس,418,109895,12043938250,106850,109950,110050,3200,2.99,109600,2750,2.57,106150,110050
واعتبار,سرمايه گذاري اعتبار ايران,418,3363092,10995359813,3324,3210,3183,-141,-4.24,3285,-39,-1.17,3160,3470
وخاور,بانك خاورميانه,414,11676636,69389146260,6010,6080,5900,-110,-1.83,5940,-70,-1.16,5870,6080
كوثر,بيمه كوثر,412,5530346,22707764606,4157,4189,4110,-47,-1.13,4115,-42,-1.01,4090,4189
بكام,كارخانجات توليدي شهيد قندي,411,7300437,14605772474,1993,2015,1999,6,0.3,2001,8,0.4,1965,2060
حآفرين,ريل پرداز نو آفرين,410,7034056,27212904781,3869,3937,3854,-15,-0.39,3869,0,0,3831,3937
دتوزيع,توزيع دارو پخش,408,433574,15787078000,35900,35900,35900,0,0,36350,450,1.25,35550,36900
نمرينو,ايران‌ مرينوس‌,407,152583,13946954770,93670,90050,91190,-2480,-2.65,91470,-2200,-2.35,90050,93960
دارا,صندوق س. دارا الگوريتم-د,406,18657417,186678392177,10173,10005,10006,-167,-1.64,10006,-167,-1.64,10005,10006
تكمبا,كمباين‌ سازي‌ ايران‌,405,3460569,15756559965,4584,4500,4597,13,0.28,4553,-31,-0.68,4471,4718
غمهرا,توليدي‌مهرام‌,402,1398057,17603804490,13170,13140,12760,-410,-3.11,12590,-580,-4.4,12490,13140
ماني,صندوق س. با درآمد ثابت ماني,402,8631165,101200179009,11718,11725,11724,6,0.05,11725,7,0.06,11724,11726
فولاژ,فولاد آلياژي ايران,401,2156972,19920061770,9270,9120,9260,-10,-0.11,9260,-10,-0.11,9050,9340
فجام,جام‌دارو,400,4416332,21312807790,4818,4818,4901,83,1.72,4826,8,0.17,4710,4940
سخزر,سيمان‌ خزر,400,1414712,34307303270,24570,24360,23630,-940,-3.83,24250,-320,-1.3,23400,24700
پكوير,كوير تاير,399,2877619,16289111260,5710,5730,5660,-50,-0.88,5660,-50,-0.88,5500,5770
وحكمت,بيمه حكمت صبا,396,8023517,12643914495,1575,1610,1555,-20,-1.27,1576,1,0.06,1531,1610
ولانا,شركت ليزينگ آريا دانا,392,1297757,18437417230,13930,14330,13930,0,0,14210,280,2.01,13550,14340
وكادو,تكادو,392,1478262,28457424520,18930,19300,18940,10,0.05,19250,320,1.69,18760,19490
لابسا,آبسال‌,390,1533988,11337705710,7310,7210,7310,0,0,7370,60,0.82,7210,7660
غفارس,شير پاستوريزه پگاه فارس,389,3793265,24564522190,6810,6790,6470,-340,-4.99,6480,-330,-4.85,6470,6790
تسه0009,امتيازتسهيلات مسكن آذر 1400,389,6458,7991897624,1284724,1284799,1235000,-49724,-3.87,1237519,-47205,-3.67,1220488,1284799
وسكاب,س.ص.بازنشستگي كاركنان بانكها,386,6622841,20228589077,3040,3030,3069,29,0.95,3054,14,0.46,3020,3108
زر,صندوق س.پشتوانه سكه طلاي زر,386,421852,26460779846,61997,62996,62520,523,0.84,62725,728,1.17,62300,63300
سخاشح,ح . سيمان‌خاش‌,384,161198,8405053740,51170,50500,52380,1210,2.36,52140,970,1.9,50500,53620
ضستا7003,اختيارخ شستا-1000-1401/07/17,383,20463,3737420000,187,188,182,-5,-2.67,183,-4,-2.14,179,188
وايران,ليزينگ ايرانيان,383,3121005,8897224754,2924,2926,2820,-104,-3.56,2878,-46,-1.57,2800,2928
كروي,توسعه‌ معادن‌ روي‌ ايران‌,383,1551570,41055487740,26370,26000,26400,30,0.11,26460,90,0.34,26000,26720
پاسا,ايران‌ياساتايرورابر,383,1694697,22206590460,13240,13070,13200,-40,-0.3,13100,-140,-1.06,12810,13500
شرانل,نفت ايرانول,382,639249,35048689000,53850,54300,55400,1550,2.88,54650,800,1.49,54000,55400
زعف0110پ20,زعفران0110نگين وحدت جام(پ),381,1174034,469824571324,375402,372340,382002,6600,1.76,400180,24778,6.6,372340,405000
زيتون,صندوق س زيتون نماد پايا- مختلط,380,3637878,45477670570,12410,12470,12510,100,0.81,12500,90,0.73,12450,12560
كسرام,پارس‌ سرام‌,377,3336394,20713736940,6260,6330,6260,0,0,6210,-50,-0.8,6070,6330
سپر,صندوق س سپر سرمايه بيدار- ثابت,377,13124192,190447482754,14502,14514,14514,12,0.08,14511,9,0.06,14511,14514
ثالوند,سرمايه گذاري مسكن الوند,376,2218156,16592634160,7420,7280,7480,60,0.81,7480,60,0.81,7200,7650
سفار,سيمان‌فارس‌,371,1268832,105093352390,73560,80920,84960,11400,15.5,82830,9270,12.6,80920,84960
غگلستا,شير پاستوريزه پگاه گلستان,368,1878936,22920259460,12160,12400,12020,-140,-1.15,12200,40,0.33,12000,12600
پخش,پخش البرز,367,2005589,70407849150,34800,33900,35000,200,0.57,35100,300,0.86,33900,35500
بنيرو,نيروترانس‌,366,7982745,19505713221,2409,2477,2487,78,3.24,2443,34,1.41,2394,2497
وپاسار,بانك  پاسارگاد,366,9210136,82529425170,8960,8960,8970,10,0.11,8960,0,0,8960,8970
كسعدي,كاشي‌ سعدي‌,365,1428923,13423755940,9660,9690,9600,-60,-0.62,9420,-240,-2.48,9250,9690
خفنر,فنرسازي‌خاور,365,2797392,19015993630,6720,6510,6890,170,2.53,6800,80,1.19,6500,6900
ولبهمن,شركت بهمن ليزينگ,364,4819609,18501980393,3769,3890,3800,31,0.82,3839,70,1.86,3760,3890
فردا,صندوق س آواي فرداي زاگرس-ثابت,363,13128754,171984033342,13093,13100,13099,6,0.05,13100,7,0.05,13099,13100
خفولا,خدمات فني فولاد يزد,363,2177120,38012456090,16960,17460,17460,500,2.95,17460,500,2.95,17230,17460
وسديد,گروه ‌صنعتي‌سديد,359,7003229,9678462478,1342,1382,1382,40,2.98,1365,23,1.71,1382,1382
داوه,داروسازي آوه سينا,359,1843879,15379088260,8190,8040,8290,100,1.22,8340,150,1.83,8040,8480
كپرور,فرآوري زغال سنگ پروده طبس,358,1523998,17137685430,11200,11310,11250,50,0.45,11250,50,0.45,11020,11430
ساروم,سيمان‌اروميه‌,357,983373,28726839200,28810,28490,29370,560,1.94,29210,400,1.39,28230,29630
قثابت,قند ثابت‌ خراسان‌,356,9907595,29623709050,2848,2990,2990,142,4.99,2990,142,4.99,2990,2990
خبازرس,بازرسي مهندسي و صنعتي ايران,356,1654039,28821905070,16940,17410,17440,500,2.95,17430,490,2.89,17020,17440
اتكاي,بيمه اتكايي ايرانيان,355,6700975,92200520820,13740,13760,13750,10,0.07,13760,20,0.15,13500,13840
وپترو,سرمايه‌گذاري صنايع پتروشيمي‌,352,1452550,16563370890,11510,11190,11350,-160,-1.39,11400,-110,-0.96,11190,11580
قصفها,قنداصفهان‌,349,168808,16992360690,97630,99950,100980,3350,3.43,100660,3030,3.1,95010,102000
سلام,صندوق س سلام فارابي-سهام,348,1724915,17368530570,10020,9970,10060,40,0.4,10070,50,0.5,9970,10120
خمحور,توليدمحورخودرو,348,7058337,19926648001,2820,2738,2810,-10,-0.35,2823,3,0.11,2735,2904
كطبس,ذغال‌سنگ‌ نگين‌ ط‌بس‌,348,1096799,22692349480,20610,19900,20800,190,0.92,20690,80,0.39,19900,21100
دقاضي,داروسازي شهيد قاضي,347,473784,15389259350,32300,32250,32200,-100,-0.31,32500,200,0.62,32000,33100
سكرما,سيمان‌ كرمان‌,346,1304726,17254049410,12840,13060,13470,630,4.91,13220,380,2.96,13020,13530
سحرخيز,صندوق س. گروه زعفران سحرخيز,346,1060341,19968157299,18961,18934,18860,-101,-0.53,18832,-129,-0.68,18705,19045
سفارود,كارخانه فارسيت درود,346,1099309,7308235580,6750,6650,6620,-130,-1.93,6650,-100,-1.48,6620,6780
سدشت,صنايع سيمان دشتستان,340,782785,25264380320,31430,32500,33000,1570,5,32270,840,2.67,30400,33000
دسبحان,سبحان دارو,337,2167400,21144836570,9850,9660,9800,-50,-0.51,9760,-90,-0.91,9570,9940
ولقمان,سرمايه گذاري لقمان,334,1455217,7001048987,4671,4811,4811,140,3,4763,92,1.97,4811,4811
ياقوت,صندوق س ياقوت آگاه-ثابت,332,4160509,61718130642,14828,14835,14834,6,0.04,14834,6,0.04,14834,14840
چافست,افست‌,328,2226315,11593034900,5200,5060,5200,0,0,5210,10,0.19,5020,5330
شرنگي,شيميايي رنگين,328,48134,16929925400,353650,357500,347300,-6350,-1.8,351700,-1950,-0.55,343050,358000
ثاژن,سخت آژند,328,4312477,19370668601,4447,4534,4359,-88,-1.98,4492,45,1.01,4359,4535
تايرا,تراكتورسازي‌ايران‌,326,765397,13801257590,18060,18230,18010,-50,-0.28,18040,-20,-0.11,17810,18250
فكمند,گسترش قطعه سازي كمند,326,814002,19587580500,24700,24100,24000,-700,-2.83,24050,-650,-2.63,24000,25000
وكار,بانك‌ كارآفرين‌,323,15249322,50973643859,3328,3349,3359,31,0.93,3342,14,0.42,3300,3479
حشكوه,دليجان طلايي شكوه پارس,319,5744296,15032792978,2616,2590,2618,2,0.08,2617,1,0.04,2590,2655
گكيش,توريستي ورفاهي آبادگران كيش,319,413096,14799078000,36800,37500,35700,-1100,-2.99,35800,-1000,-2.72,35700,37500
حاريا,كشتيراني آريا,311,1898266,11006860270,5900,5920,5790,-110,-1.86,5800,-100,-1.69,5790,5920
ثشرق,سرمايه گذاري مسكن شمال شرق,310,4282362,17070874892,3935,3993,3960,25,0.64,3986,51,1.3,3900,4050
كمنگنز,معادن‌منگنزايران‌,306,637570,10688183010,16860,17310,16710,-150,-0.89,16790,-70,-0.42,16300,17310
اميد,تامين سرمايه اميد,306,1583915,9248622780,5960,6010,5870,-90,-1.51,5930,-30,-0.5,5790,6010
اخزا005,اسنادخزانه-م5بودجه00-030626,304,696200,430789412000,618320,618510,619000,680,0.11,618770,450,0.07,612520,619350
سباقر,سيمان باقران,300,930318,12646226010,13800,13420,13710,-90,-0.65,13590,-210,-1.52,13420,13970
سمازن,سيمان‌مازندران‌,296,1319556,15003137370,11390,11310,11390,0,0,11370,-20,-0.18,11270,11600
بالبر,كابل‌ البرز,292,404732,13525457780,33750,32600,33350,-400,-1.19,33450,-300,-0.89,32600,34880
پلاسك,پلاسكوكار,292,2966767,9907094714,3344,3281,3380,36,1.08,3341,-3,-0.09,3240,3440
تسه0006,امتيازتسهيلات مسكن شهريور1400,292,5213,6480383924,1287073,1330000,1225730,-61343,-4.77,1243120,-43953,-3.41,1222720,1330000
وآرين,شركت توسعه اقتصادي آرين,290,4773008,5768991606,1227,1254,1222,-5,-0.41,1216,-11,-0.9,1191,1254
دارو,كارخانجات‌داروپخش‌,287,514974,16013275760,31390,31950,31140,-250,-0.8,31140,-250,-0.8,30740,31990
پسهند,صنايع‌ لاستيكي‌  سهند,283,575285,19851033660,34450,35200,34750,300,0.87,34510,60,0.17,34020,35200
وبهمن,سرمايه‌گذاري‌بهمن‌,283,869941,14568546480,16800,16990,16300,-500,-2.98,16760,-40,-0.24,15800,17280
ضستا7002,اختيارخ شستا-900-1401/07/17,282,19635,5110122000,261,251,260,-1,-0.38,260,-1,-0.38,251,261
قشهد,شهد,282,1261214,19334971070,15640,15300,15480,-160,-1.02,15330,-310,-1.98,15030,15600
تمحركه,ماشين سازي نيرو محركه,280,1100378,13666115890,12180,12420,12420,240,1.97,12420,240,1.97,12350,12420
سارومح,ح . سيمان‌اروميه‌,278,595330,15454179690,25440,24660,25880,440,1.73,25960,520,2.04,24660,26650
بايكا,كارخانجات كابلسازي ‌ايران‌,278,773170,12382394530,16480,15990,15990,-490,-2.97,16020,-460,-2.79,15990,16470
دكپسول,توليد ژلاتين كپسول ايران,276,519499,20309854100,38550,39250,38950,400,1.04,39100,550,1.43,38400,39400
خريخت,صنايع‌ريخته‌گري‌ايران‌,274,9748362,31374144545,3071,3100,3224,153,4.98,3218,147,4.79,3100,3224
اپرداز,آتيه داده پرداز,274,681931,10213696880,15200,14960,14820,-380,-2.5,15040,-160,-1.05,14700,15340
فاهواز,نورد و لوله اهواز,273,4270079,24034161320,5620,5530,5700,80,1.42,5630,10,0.18,5510,5720
وبيمه,سرمايه‌ گذاري‌ صنعت‌ بيمه‌,272,3869845,7085658367,1834,1781,1830,-4,-0.22,1833,-1,-0.05,1781,1869
وارس,سرمايه گذاري ارس صبا,271,3044107,51222699820,16360,16080,16850,490,3,16830,470,2.87,15930,16850
اتكام,بيمه اتكايي امين,271,1825388,7893276786,4344,4379,4312,-32,-0.74,4334,-10,-0.23,4300,4405
لخزر,پارس‌ خزر,269,62493,8138666510,129340,127000,129000,-340,-0.26,129820,480,0.37,127000,132000
دابور,داروسازي‌ ابوريحان‌,269,844823,21234963710,24860,25540,24890,30,0.12,25140,280,1.13,24610,25730
آينده,بازرگاني آينده سازان بهشت پارس,266,814828,10583265230,13380,12990,12980,-400,-2.99,12990,-390,-2.91,12980,13310
پكرمان,گروه‌ صنعتي‌ بارز,262,1047516,18708283800,17800,17680,17890,90,0.51,17860,60,0.34,17680,18150
تابا,تابان نيرو سپاهان,260,813806,18456335600,22050,22500,22700,650,2.95,22700,650,2.95,22150,22700
وتوس,توسعه‌شهري‌توس‌گستر,255,1530598,12669419480,8200,8120,8320,120,1.46,8270,70,0.85,8110,8450
لپيام,گسترش صنايع پيام,254,700240,16171016450,22450,22800,23100,650,2.9,23100,650,2.9,22750,23100
ضسپا3015,اختيارخ خساپا-2000-1401/03/25,254,8328,1864295000,248,228,220,-28,-11.29,224,-24,-9.68,210,256
ومعلم,بيمه معلم,253,3315494,7206852433,2194,2180,2162,-32,-1.46,2184,-10,-0.46,2156,2216
مثقال,صندوق س.پشتوانه طلاي زرين آگاه,251,503164,5687161325,11128,11216,11299,171,1.54,11303,175,1.57,11216,11338
تسه0008,امتيازتسهيلات مسكن آبان1400,249,3541,4424622816,1289977,1225503,1231500,-58477,-4.53,1249540,-40437,-3.13,1225503,1354470
خاتم,صندوق س خاتم ايساتيس پويا-ثابت,246,8776698,118695628475,13515,13523,13524,9,0.07,13524,9,0.07,13522,13524
قهكمت,قندهكمتان‌,245,1190953,8969890400,7530,7270,7480,-50,-0.66,7530,0,0,7270,7700
فبيرا,بسته‌ بندي‌ ايران‌,244,4440564,7432009718,1705,1675,1672,-33,-1.94,1674,-31,-1.82,1671,1718
غناب,روغن‌ نباتي‌ ناب,244,53150,10031465950,192250,191950,188450,-3800,-1.98,188750,-3500,-1.82,188450,191950
رتكو,كنترل‌خوردگي‌تكين‌كو,241,732970,6507399630,8720,8500,8840,120,1.38,8790,70,0.8,8500,9150
فسا,پتروشيمي فسا,241,6552717,6065159435,903,891,929,26,2.88,917,14,1.55,890,930
وزمين,بانك ايران زمين,240,2017160,19441181010,9500,9310,9690,190,2,9640,140,1.47,9310,9690
وتوشه,سرمايه‌ گذاري‌ پارس‌ توشه‌,240,1316346,9321473570,6860,7250,7030,170,2.48,6990,130,1.9,6990,7250
خچرخش,چرخشگر,239,3159015,46736901990,13980,14810,14010,30,0.21,14790,810,5.79,14010,14810
فيروزا,صندوق ارمغان فيروزه آسيا-ثابت,234,5229283,147051539471,28105,28120,28121,16,0.06,28121,16,0.06,28120,28121
تسه0007,امتيازتسهيلات مسكن مهر1400,233,2644,3276444154,1300779,1235741,1235741,-65038,-5,1239200,-61579,-4.73,1235741,1300000
ضستا7005,اختيارخ شستا-1200-1401/07/17,233,19772,1584629000,81,84,81,0,0,80,-1,-1.23,79,84
بمپنا,توليد برق عسلويه  مپنا,232,1410935,10227095180,7390,7170,7200,-190,-2.57,7330,-60,-0.81,7160,7470
شساخت,مهندسي و ساختمان صنايع نفت,231,374171,16654633600,45500,44150,45250,-250,-0.55,45150,-350,-0.77,44150,46350
عيار2,صندوق طلاي عيار مفيد,228,2280000,2280000,36043,1,1,-36042,-100,1,-36042,-100,1,1
قيستو,شركت قند بيستون,227,968403,23103669750,23250,23600,23900,650,2.8,23850,600,2.58,23300,23900
سبجنو,سيمان‌ بجنورد,224,617137,26549095030,42510,42580,43330,820,1.93,43020,510,1.2,41160,44000
گكوثر,هتل پارسيان كوثر اصفهان,224,5411812,9527565290,1792,1833,1755,-37,-2.06,1772,-20,-1.12,1730,1833
وسين,بيمه سينا,223,4246938,10833572127,2552,2619,2588,36,1.41,2551,-1,-0.04,2477,2619
هم وزن,صندوق س. شاخصي كيان-س,221,1725847,17258470000,10000,10000,10000,0,0,10000,0,0,10000,10000
گوهران,سرمايه گذاري توسعه گوهران اميد,221,1735826,9905175550,5680,5790,5720,40,0.7,5700,20,0.35,5670,5790
ثنظام,س. ساختماني نظام مهندسي ايران,221,939457,16831517690,18440,17910,17890,-550,-2.98,17920,-520,-2.82,17890,18400
ارزش,صندوق س ارزش آفرين بيدار-سهام,220,1492712,17062482610,11360,11420,11440,80,0.7,11430,70,0.62,11370,11500
خشرق,الكتريك‌ خودرو شرق‌,219,1212130,18220912180,14370,14550,15080,710,4.94,15030,660,4.59,14400,15080
تپولا,مهندسي مرآت پولاد,216,447589,6584256110,14820,14400,15030,210,1.42,14740,-80,-0.54,14380,15190
ثعمرا,عمران و توسعه شاهد,216,827171,6483495040,7880,8180,7900,20,0.25,7860,-20,-0.25,7750,8180
سرود,سيمان‌شاهرود,215,941437,20110690580,21290,21780,21410,120,0.56,21360,70,0.33,21010,21780
ضستا7004,اختيارخ شستا-1100-1401/07/17,215,14904,1811696000,124,122,121,-3,-2.42,122,-2,-1.61,117,124
تنوين,تامين سرمايه نوين,212,2139027,9793586482,4551,4490,4558,7,0.15,4558,7,0.15,4490,4600
وصندوق,سرمايه‌گذاري‌صندوق‌بازنشستگي‌,212,2399838,35956352180,14960,14620,14850,-110,-0.74,14970,10,0.07,14620,15100
ضستا7001,اختيارخ شستا-800-1401/07/17,210,14015,4764900000,335,360,340,5,1.49,340,5,1.49,337,360
كاريس,صندوق س.سپند كاريزما-س,210,1577911,24477066726,15444,15361,15593,149,0.96,15512,68,0.44,15361,15650
فاما,صنعتي‌ آما,208,498360,4840113700,9610,9650,9610,0,0,9640,30,0.31,9530,9990
سجام,مجتمع سيمان غرب آسيا,206,1735384,4463957661,2577,2639,2567,-10,-0.39,2575,-2,-0.08,2503,2639
تشتاد,صنايع توليدي اشتاد ايران‌,204,1494844,8309461160,5450,5400,5610,160,2.94,5540,90,1.65,5290,5610
دالبر,البرزدارو,203,1495803,15353686280,10510,10110,10100,-410,-3.9,10310,-200,-1.9,9990,10510
سيستم,همكاران سيستم,200,892751,5636877070,6180,6150,6370,190,3.07,6210,30,0.49,6100,6400
حپارسا,توسعه حمل و نقل ريلي پارسيان,200,230368,9212592850,39850,40400,40100,250,0.63,39950,100,0.25,39400,40650
ضخود3059,اختيارخ خودرو-3000-1401/03/04,199,10407,10407000,1,1,1,0,0,1,0,0,1,1
اوان,مبين وان كيش,198,711220,8585278080,12360,12360,12000,-360,-2.91,12180,-180,-1.46,11800,12360
شفارا,پتروشيمي فارابي,196,799347,4726149580,5890,6010,5980,90,1.53,5900,10,0.17,5810,6030
دفرا,فرآورده‌هاي‌ تزريقي‌ ايران‌,195,413078,7470253970,17470,18280,18160,690,3.95,17770,300,1.72,16860,18280
خفناور,مهندسي صنعتي روان فن آور,193,720302,23986056600,32350,33300,33300,950,2.94,33300,950,2.94,33300,33300
داسوه,داروسازي‌ اسوه‌,193,432160,19789130520,44810,44310,46500,1690,3.77,45790,980,2.19,44310,46740
ثتوسا,س.توسعه و عمران استان اردبيل,192,346365,5396474480,15710,15710,15670,-40,-0.25,15620,-90,-0.57,15400,15970
بسويچ,پارس‌سويچ‌,191,603954,9988952350,16340,16880,16350,10,0.06,16470,130,0.8,15630,17060
وتعاون,بيمه تعاون,189,4286492,6742795966,1578,1590,1579,1,0.06,1576,-2,-0.13,1538,1619
درازك,دارويي‌ رازك‌,189,635668,10827301840,17220,16790,17230,10,0.06,17080,-140,-0.81,16670,17590
ضخود4011,اختيارخ خودرو-2000-1401/04/08,188,7314,3212479000,455,469,442,-13,-2.86,439,-16,-3.52,425,469
سقاين,سيمان‌ قائن‌,187,149486,6968299460,46900,48400,46570,-330,-0.7,46770,-130,-0.28,46050,48400
بميلا,توسعه سرمايه گذاري ميلاد پارس,186,1338252,14596788720,10640,10370,10950,310,2.91,10910,270,2.54,10370,10950
فافق,صنايع مس افق كرمان,186,2350656,11576106290,5000,5000,4980,-20,-0.4,4920,-80,-1.6,4850,5040
غشوكو,شوكو پارس,184,1978638,17837689850,8770,8800,9030,260,2.96,9020,250,2.85,8770,9030
غپونه,نوش پونه مشهد,180,511993,7773761690,15540,15200,15110,-430,-2.77,15260,-280,-1.8,15080,15680
يارا,صندوق س. آريا-د,179,8631810,92601863950,10720,10728,10728,8,0.07,10728,8,0.07,10727,10728
تصميم,صندوق س با درآمد ثابت تصميم,178,2052960,40636387348,19778,19792,19797,19,0.1,19794,16,0.08,19791,19797
ومشان,س. فني و مهندسي مشانير,177,214534,13484543200,61200,63000,63000,1800,2.94,62850,1650,2.7,61200,63000
تسه0005,امتيازتسهيلات مسكن مرداد 1400,176,2397,2958599135,1286853,1222511,1241000,-45853,-3.56,1234292,-52561,-4.08,1222511,1300000
آبين,كشت و صنعت آبشيرين,176,4031857,18836835904,4536,4672,4672,136,3,4672,136,3,4672,4672
كگاز,شيشه‌ و گاز,174,414092,6880087980,16550,16390,16600,50,0.3,16580,30,0.18,16390,16920
تداوم,صندوق تداوم اطمينان تمدن-ثابت,174,6409893,64689951106,10088,10093,10093,5,0.05,10092,4,0.04,10092,10094
تسه0004,امتيازتسهيلات مسكن تير1400,174,2282,2821764337,1289619,1236139,1230100,-59519,-4.62,1236531,-53088,-4.12,1225139,1320000
شپاس,نفت پاسارگاد,171,806305,15222642070,19230,19000,19240,10,0.05,18940,-290,-1.51,18300,19780
دشيمي,شيمي‌ داروئي‌ داروپخش‌,170,715632,19225898260,26690,26610,26900,210,0.79,26870,180,0.67,26560,27220
تسه0003,امتيازتسهيلات مسكن خرداد1400,169,1610,2001679538,1303260,1238097,1238097,-65163,-5,1243279,-59981,-4.6,1238097,1360000
شمواد,توليد مواداوليه الياف مصنوعي,168,253195,18850367750,73000,74450,74450,1450,1.99,74450,1450,1.99,74450,74450
فمراد,آلومراد,167,461035,11659575150,24090,25290,25290,1200,4.98,24940,850,3.53,25290,25290
حسينا,توسعه خدمات دريايي وبندري سينا,166,325275,18384497700,56700,55700,56600,-100,-0.18,56500,-200,-0.35,55450,56950
زعف0110پ11,زعفران0110نگين سحرخيز(پ),166,253182,94954954170,375402,372340,384500,9098,2.42,375046,-356,-0.09,372340,385630
ساربيل,سيمان آرتا اردبيل,166,206291,6328520210,30730,30320,31100,370,1.2,30710,-20,-0.07,29400,31980
تسه9908,امتياز تسهيلات مسكن آبان99,165,2409,3009469317,1280714,1216679,1231221,-49493,-3.86,1249261,-31453,-2.46,1216679,1300000
وايرا,سرمايه گذاري صنايع ايران,161,2299064,4935056114,2212,2146,2146,-66,-2.98,2178,-34,-1.54,2146,2170
قنقش,قند نقش جهان,161,96232,11750117350,121900,120650,122800,900,0.74,122100,200,0.16,119500,122950
مارون,پتروشيمي مارون,161,109187,20802921150,191050,190000,191850,800,0.42,190950,-100,-0.05,185800,192000
دسينا,داروسازي‌ سينا,158,704819,18747850600,27080,26800,26290,-790,-2.92,26600,-480,-1.77,26000,27000
شليا,شركت مواد ويژه ليا,155,362359,10159869400,27350,28000,28150,800,2.93,28050,700,2.56,27200,28150
رماس,صندوق س.راهبرد ممتازابن سينا-س,155,545498,7219226250,13447,13286,13050,-397,-2.95,13234,-213,-1.58,13001,13799
پلوله,گازلوله‌,154,556863,13464830400,23500,23800,24200,700,2.98,24200,700,2.98,23800,24200
سيدكو,سرمايه گذاري توسعه صنايع سيمان,150,1004997,8129886380,8080,8050,8090,10,0.12,8080,0,0,8040,8150
نهال,صندوق س. طلاي سرخ نوويرا,149,374753,7454206534,19871,19955,20329,458,2.3,19891,20,0.1,19805,20329
سفانو,سيمان فارس نو,148,594223,20739290290,34510,33700,35130,620,1.8,34900,390,1.13,33700,35180
آساس,صندوق س.آسمان آرماني سهام-س,147,53595,11528066422,211867,211400,216100,4233,2,215096,3229,1.52,211400,216100
ضهرم6002,اختيارخ اهرم-12000-1401/06/30,146,13901,542954500,1,4330,3700,3699,369900,3906,3905,390500,3700,4330
ضسپا8057,اختيارخ خساپا-3000-1401/08/25,141,8861,833768000,86,90,105,19,22.09,94,8,9.3,83,109
سپ,پرداخت الكترونيك سامان كيش,138,191983,4255505920,22230,21890,22220,-10,-0.04,22230,0,0,21610,22350
ثغرب,شركت سرمايه گذاري مسكن شمالغرب,136,2182390,10072488871,4357,4430,4618,261,5.99,4524,167,3.83,4430,4618
كاردان,صندوق س تجارت شاخصي كاردان,135,48677,11160399300,227130,226520,228990,1860,0.82,229270,2140,0.94,226520,230510
دعبيد,لابراتوارداروسازي‌  دكترعبيدي‌,135,169746,4168362900,24300,24940,24500,200,0.82,24320,20,0.08,24040,24940
بساما,بيمه سامان,133,1076186,12977818560,12060,12120,12090,30,0.25,12060,0,0,11960,12120
اخزا006,اسنادخزانه-م6بودجه00-030723,133,536000,326632356000,608960,608000,609710,750,0.12,609390,430,0.07,608000,609800
تسه9912,امتياز تسهيلات مسكن اسفند99,132,1055,1308418503,1285688,1278953,1221404,-64284,-5,1240207,-45481,-3.54,1221404,1278953
تسه0001,امتيازتسهيلات مسكن فروردين1400,131,1513,1965637835,1346653,1279321,1279321,-67332,-5,1299166,-47487,-3.53,1279321,1346653
زرين,صندوق س. سهام زرين كوروش-س,129,509028,7022095882,13640,13718,13951,311,2.28,13795,155,1.14,13659,13951
برن0104پ01,برنج طارم0104تجارت مازندران(پ),128,5261,4106448632,749559,740500,787036,37477,5,780545,30986,4.13,740500,787036
دشيري,شيرين دارو,127,45519,4635055850,103200,101000,100850,-2350,-2.28,102550,-650,-0.63,100350,104300
ضخود4014,اختيارخ خودرو-2600-1401/04/08,127,5971,516925000,106,85,79,-27,-25.47,87,-19,-17.92,79,100
كهرام,توليدي گرانيت بهسرام,126,88755,5128906650,58850,58000,57700,-1150,-1.95,57800,-1050,-1.78,57700,59200
تسه9911,امتياز تسهيلات مسكن بهمن99,124,1174,1457386200,1305473,1240200,1244000,-61473,-4.71,1241385,-64088,-4.91,1240200,1250000
قشكر,شكرشاهرود,123,2581610,6273379536,2378,2485,2412,34,1.43,2399,21,0.88,2371,2485
كهربا,صندوق س.پشتوانه سكه طلا كهربا,123,711971,8796375847,12147,12270,12428,281,2.31,12355,208,1.71,12251,12436
ولصنم,ليزينگ‌صنعت‌ومعدن‌,122,999367,2778647431,2853,2887,2815,-38,-1.33,2839,-14,-0.49,2692,2887
وپخش,داروپخش‌ (هلدينگ‌,121,134632,4621101010,34010,34390,34490,480,1.41,34040,30,0.09,33370,34970
اخزا002,اسنادخزانه-م2بودجه00-031024,120,146500,84742132000,577880,577200,579300,1420,0.25,578440,560,0.1,577200,579300
ضشنا8014,اختيارخ شپنا-5850-1401/08/29,119,4181,5288767000,1302,1300,1231,-71,-5.45,1265,-37,-2.84,1220,1316
هامرز,صندوق س اعتماد هامرز-ثابت,118,4244183,42851077707,10091,10097,10097,6,0.06,10096,5,0.05,10096,10097
پلاست,كارخانجات توليدي پلاستيران,116,567510,9284463600,15890,16360,16360,470,2.96,16300,410,2.58,16360,16360
وحافظ,بيمه حافظ,116,2158614,21672484560,9750,10040,10040,290,2.97,10040,290,2.97,10040,10040
آوا,صندوق س.سهام آواي معيار-س,116,1165299,10279160540,8791,8760,8829,38,0.43,8821,30,0.34,8760,8878
كاسپين,داروسازي كاسپين تامين,115,224614,5351858200,23750,24900,23500,-250,-1.05,23800,50,0.21,22900,24900
سكه0111پ05,تمام سكه طرح جديد0111آينده,112,55500,80996492300,1437628,1446000,1460100,22472,1.56,1459396,21768,1.51,1446000,1476098
زعف0110پ18,زعفران0110نگين بهرامن(پ),112,121665,45751330862,375402,372340,380005,4603,1.23,376043,641,0.17,372340,385000
تسه9907,امتياز تسهيلات مسكن مهر99,112,1190,1475449388,1305019,1239769,1239769,-65250,-5,1239873,-65146,-4.99,1239769,1240000
سغدير,توسعه سرمايه و صنعت غدير,112,206782,2825430500,13690,13360,13690,0,0,13690,0,0,13360,14060
وملت,سرمايه گذاري ملت,111,1329535,3104966236,2374,2331,2347,-27,-1.14,2349,-25,-1.05,2327,2408
تسه9910,امتياز تسهيلات مسكن دي99,111,1138,1415312480,1308884,1243440,1243440,-65444,-5,1243684,-65200,-4.98,1243440,1250000
قپيرا,فرآورده‌هاي‌غدايي‌وقندپيرانشهر,109,587243,4989445090,8570,8240,8550,-20,-0.23,8550,-20,-0.23,8240,8600
ضخود4012,اختيارخ خودرو-2200-1401/04/08,109,5353,1477669000,295,306,272,-23,-7.8,276,-19,-6.44,265,325
دپارس,پارس‌ دارو,109,260977,8304434250,31580,30820,31900,320,1.01,31710,130,0.41,30450,32040
پارند2,صندوق س. پارند پايدار سپهر,108,10800000,10800000,10089,1,1,-10088,-99.99,1,-10088,-99.99,1,1
سكه0211پ02,تمام سكه طرح جديد0211ملت,106,22400,32715233400,1435994,1469989,1464000,28006,1.95,1460501,24507,1.71,1453999,1469989
تسه9909,امتياز تسهيلات مسكن آذر99,106,545,672753494,1296725,1232889,1232007,-64718,-4.99,1234410,-62315,-4.81,1231889,1296685
ويسا,سرمايه گذاري ايساتيس پويا,105,801212,5322031410,6760,6620,6610,-150,-2.22,6700,-60,-0.89,6560,6740
غالبر,لبنيات‌ كالبر,105,251697,2932464940,11920,11970,11550,-370,-3.1,11870,-50,-0.42,11380,11970
ساروج,بين المللي ساروج بوشهر,105,274942,4747745100,17730,17600,17370,-360,-2.03,17580,-150,-0.85,16850,17600
اخزا004,اسنادخزانه-م4بودجه00-030522,103,361600,228249883000,632120,631110,631150,-970,-0.15,631220,-900,-0.14,624950,632000
سكه0112پ03,تمام سكه طرح جديد0112سامان,102,17000,24805463800,1438975,1445001,1463000,24025,1.67,1459145,20170,1.4,1445001,1476000
آرام2,صندوق س شاخصي آرام مفيد,102,10200000,10200000,11190,1,1,-11189,-99.99,1,-11189,-99.99,1,1
حخزر,كشتيراني درياي خزر,97,149749,2683966090,18090,17240,17840,-250,-1.38,18060,-30,-0.17,17240,18500
آرمان,بيمه آرمان,97,598623,2526398118,4282,4161,4204,-78,-1.82,4266,-16,-0.37,4161,4281
سكه0110پ04,تمام سكه طرح جديد 0110 صادرات,93,56200,81706229400,1437031,1454000,1463399,26368,1.83,1453847,16816,1.17,1440013,1465000
تسه9904,امتياز تسهيلات مسكن تير99,92,3981,4983375990,1317673,1251790,1251790,-65883,-5,1251790,-65883,-5,1251790,1251790
وثخوز,سرمايه گذاري و توسعه خوزستان,91,137263,4705810700,34550,35000,33800,-750,-2.17,34450,-100,-0.29,33600,35300
كيان2,صندوق س. با درآمد ثابت كيان,90,9000000,9000000,34911,1,1,-34910,-100,1,-34910,-100,1,1
شستان,پتروشيمي گلستان,90,870217,3490432225,3933,4011,4011,78,1.98,3986,53,1.35,4000,4011
كقزوي,شيشه‌ قزوين‌,89,796807,11721030970,14290,14710,14710,420,2.94,14710,420,2.94,14710,14710
خريختح,ح . صنايع‌ريخته‌گري‌ايران‌,88,5010357,10521749700,1932,2100,2100,168,8.7,2100,168,8.7,2100,2100
اخزا001,اسنادخزانه-م1بودجه00-030821,87,205800,123383826000,599170,593550,599510,340,0.06,599530,360,0.06,593450,600000
وثوق,سرمايه گذاري وثوق امين,86,634371,5246248170,8030,8270,8270,240,2.99,8150,120,1.49,8270,8270
داريك,صندوق س.اعتماد داريك-د,85,2199212,27813632011,12608,12618,13079,471,3.74,12647,39,0.31,12615,13079
سكارون,سيمان كارون,73,102882,5524763400,55350,53700,53700,-1650,-2.98,54400,-950,-1.72,53700,53700
وسرمد,بيمه  سرمد,73,2534528,7968649910,3241,3144,3144,-97,-2.99,3162,-79,-2.44,3144,3145
ولراز,ليزينگ رازي,71,89738,2445360500,28050,27250,27250,-800,-2.85,27800,-250,-0.89,27250,27250
فيروزه,صندوق شاخص30 شركت فيروزه- سهام,71,8350,1624157410,194010,194010,194880,870,0.45,194510,500,0.26,194010,195490
سمتاز,سيمان ممتازان كرمان,70,125858,2422989590,19440,19290,19430,-10,-0.05,19390,-50,-0.26,19080,19430
شكبير,پتروشيمي اميركبير,70,292510,27949330500,98500,95550,95550,-2950,-2.99,97650,-850,-0.86,95550,95550
انار,صندوق س.انارنماد ارزش-درسهام,68,138988,1619722510,11580,11770,11680,100,0.86,11650,70,0.6,11580,11770
آسام,صندوق س.آرمان سپهر آشنا-م,67,146450,2199482070,14695,14900,15010,315,2.14,15019,324,2.2,14820,15060
سيناد,صندوق س.سپهرسودمند سينا-د,63,2907443,29068902271,10076,9999,9978,-98,-0.97,9998,-78,-0.77,9953,10000
وپسا,س. پتروشيمي ساختمان  خليج فارس,62,2370206,5401699474,2213,2279,2279,66,2.98,2247,34,1.54,2279,2279
اوصتا,صندوق انديشه ورزان صباتامين -د,62,1777535,40341309959,22682,22696,22696,14,0.06,22695,13,0.06,22695,22696
پاداش,صندوق س. ارزش پاداش-د,59,1248487,12717306468,10181,10187,10186,5,0.05,10186,5,0.05,10186,10187
الماس,صندوق س.امين تدبيرگران فردا-س,57,20065,2623771171,127626,129773,131000,3374,2.64,130764,3138,2.46,128503,131000
كمينا,شيشه سازي مينا,55,348143,3575428610,9980,10270,10270,290,2.91,10080,100,1,10270,10270
وامين,س. امين توان آفرين ساز,55,185887,2127624940,11400,11450,11470,70,0.61,11400,0,0,11430,11470
ضخود4013,اختيارخ خودرو-2400-1401/04/08,55,1887,285617000,173,180,141,-32,-18.5,151,-22,-12.72,141,189
ضملي3013,اختيارخ فملي-7000-1401/03/02,53,1693,798490000,533,450,458,-75,-14.07,472,-61,-11.44,450,529
صنم,ص.س.صندوق در صندوق صنم,53,386043,4482604431,11588,11590,11605,17,0.15,11612,24,0.21,11590,11629
اخزا0052,اسنادخزانه-م5بودجه00-030626,51,1983,1222658450,618320,610030,617520,-800,-0.13,616570,-1750,-0.28,610030,618320
كفرآور,فرآورده هاي سيمان شرق,51,628175,12437865000,20400,19800,19800,-600,-2.94,19800,-600,-2.94,19800,19800
ماني2,صندوق س. با درآمد ثابت ماني,50,5000000,5000000,11718,1,1,-11717,-99.99,1,-11717,-99.99,1,1
اخزا003,اسنادخزانه-م3بودجه00-030418,49,114800,73899341000,643810,640000,644500,690,0.11,643720,-90,-0.01,640000,644700
وآفري,بيمه كارآفرين,46,303022,1160594566,3760,3761,3819,59,1.57,3766,6,0.16,3761,3860
ضشنا8013,اختيارخ شپنا-5350-1401/08/29,46,1229,1882453000,1600,1560,1520,-80,-5,1532,-68,-4.25,1500,1598
وليزح,ح . ليزينگ‌ايران‌,45,1585059,2601081819,1641,1641,1641,0,0,1641,0,0,1641,1641
اخزا0022,اسنادخزانه-م2بودجه00-031024,45,1674,964498310,577880,550810,577810,-70,-0.01,576160,-1720,-0.3,549040,577810
تسه0002,امتيازتسهيلاتمسكن ارديبهشت1400,45,890,1202715480,1422454,1351332,1351332,-71122,-5,1351366,-71088,-5,1351332,1353332
شپارس,بين‌ المللي‌ محصولات‌  پارس‌,43,786402,4356667080,5280,5540,5540,260,4.92,5350,70,1.33,5540,5540
كايتا,ايتالران‌,43,99740,3763790850,36700,36350,37800,1100,3,37100,400,1.09,36350,37800
فبستم,صنايع ‌بسته‌بندي‌ مشهد,43,236575,4492559250,18440,18990,18990,550,2.98,18680,240,1.3,18990,18990
ضخود5004,اختيارخ خودرو-2200-1401/05/12,41,2219,771165000,350,350,345,-5,-1.43,348,-2,-0.57,336,360
وثنوح,ح. سرمايه گذاري ساختماني نوين,41,421229,566974234,1387,1346,1346,-41,-2.96,1346,-41,-2.96,1346,1346
ثاصفا,شركت‌ ساختمان‌ اصفهان‌,40,165021,1935696330,12090,11730,11730,-360,-2.98,12020,-70,-0.58,11730,11730
اخزا910,اسنادخزانه-م10بودجه99-020807,40,121500,91246251000,748100,750800,751600,3500,0.47,751000,2900,0.39,750800,751600
ضملت3013,اختيارخ وبملت-4000-1401/03/18,39,1450,137712000,115,100,91,-24,-20.87,95,-20,-17.39,80,115
ضخود4017,اختيارخ خودرو-3250-1401/04/08,39,2001,34855000,19,19,15,-4,-21.05,17,-2,-10.53,14,20
اخزا010,اسناد خزانه-م10بودجه00-031115,38,189700,108445958000,571670,572450,572500,830,0.15,571671,1,0,571000,572500
پلاستح,ح.كارخانجات توليدي پلاستيران,37,70428,995642720,14700,15480,13820,-880,-5.99,14140,-560,-3.81,13820,15480
آتيمس,صندوق س.آرمان آتيه درخشان مس-س,35,7747,1613989643,206633,206633,207540,907,0.44,208337,1704,0.82,206633,209199
اخزا007,اسنادخزانه-م7بودجه00-030912,35,189500,112227161000,592490,590060,592010,-480,-0.08,592230,-260,-0.04,590060,593390
ضخود4015,اختيارخ خودرو-2800-1401/04/08,34,1572,64588000,55,21,38,-17,-30.91,41,-14,-25.45,21,49
ارمغان,ص سرمايه گذاري ارمغان ايرانيان,34,485335,4895813267,10091,10086,10096,5,0.05,10087,-4,-0.04,10086,10096
اخزا0012,اسنادخزانه-م1بودجه00-030821,34,1909,1135917140,599170,598510,598030,-1140,-0.19,595030,-4140,-0.69,569220,598550
سايرا,ايرانيت‌,34,136512,4001293200,29600,29900,29050,-550,-1.86,29350,-250,-0.84,29050,30100
ضصاد3016,اختيارخ وبصادر-2500-1401/03/11,33,1420,4581000,5,18,3,-2,-40,3,-2,-40,3,18
صايند,صندوق س. گنجينه آينده روشن-د,32,604900,6103364130,10093,10070,10090,-3,-0.03,10090,-3,-0.03,10070,10099
اراد50,مرابحه عام دولت5-ش.خ0302,32,428200,428201154000,1000010,1000000,1000000,-10,0,1000000,-10,0,1000000,1000010
شصفها,پتروشيمي‌ اصفهان‌,31,77964,7905549600,103450,101400,101400,-2050,-1.98,102100,-1350,-1.3,101400,101400
شسم,توليد سموم‌ علف‌ كش,30,3405,981321000,279850,288200,288200,8350,2.98,280650,800,0.29,288200,288200
وبازار,صندوق س شاخصي بازارآشنا,30,162759,2265079230,13880,13990,13950,70,0.5,13920,40,0.29,13800,13990
اخزا0042,اسنادخزانه-م4بودجه00-030522,30,891,560937240,632120,624480,629810,-2310,-0.37,629560,-2560,-0.4,624480,630000
لخانه,لوازم‌ خانگي‌ پارس‌,28,261046,4884170660,18170,18710,18710,540,2.97,18420,250,1.38,18710,18710
اخزا009,اسناد خزانه-م9بودجه00-031101,28,222600,128240339000,575830,575690,576800,970,0.17,576100,270,0.05,575680,577100
ضستر3007,اختيارخ خگستر-4000-1401/03/22,27,940,204165000,262,230,204,-58,-22.14,217,-45,-17.18,200,235
كصدف,كاشي صدف سرام استقلال آباده,27,128140,4766808000,36150,37200,37200,1050,2.9,36650,500,1.38,37200,37200
حبندر,دريايي و کشتيراني خط دريابندر,27,101341,3546935000,34000,35000,35000,1000,2.94,34350,350,1.03,35000,35000
ضپلا4007,اختيارخ پالايش-90000-01/04/29,25,2301,92033000,3997,3300,4000,3,0.08,4000,3,0.08,3300,4000
مرواريد,صندوق س. مرواريد بها بازار-س,25,125492,1263160188,10080,10118,10070,-10,-0.1,10066,-14,-0.14,10055,10118
ولتجار,واسپاري تجار ايرانيان,24,542352,1536483216,2751,2833,2833,82,2.98,2763,12,0.44,2833,2833
اخزا903,اسنادخزانه-م3بودجه99-011110,24,7600,6596469000,866770,867300,869000,2230,0.26,867960,1190,0.14,867280,869000
ضهرم6001,اختيارخ اهرم-11000-1401/06/30,23,1702,82655500,1,4957,4900,4899,489900,4856,4855,485500,4700,4957
ضصاد3015,اختيارخ وبصادر-2000-1401/03/11,22,876,178465000,217,195,211,-6,-2.76,204,-13,-5.99,170,215
ضفلا3013,اختيارخ فولاد-12000-1401/03/18,22,238,190815000,797,800,750,-47,-5.9,802,5,0.63,720,850
وسنا,سرمايه گذاري نيروگاهي ايران,21,107674,1098274800,9910,10200,10200,290,2.93,10200,290,2.93,10200,10200
گوهر2,صندوق سكه طلاي كيان,20,200000,200000,70668,1,1,-70667,-100,1,-70667,-100,1,1
ضپلا4008,اختيارخ پالايش-100000-01/04/29,20,1950,39500000,2500,2000,2000,-500,-20,2026,-474,-18.96,2000,2500
اخزا008,اسنادخزانه-م8بودجه00-030919,20,47800,28163506000,589940,589560,590040,100,0.02,589190,-750,-0.13,583030,590040
صنوين,صندوق سرمايه‌گذاري صنوين-مختلط,20,2632,331540610,125050,125890,125600,550,0.44,125970,920,0.74,125600,126870
بذر,صندوق س بذر اميد آفرين-سهام,19,4157,486683490,116400,117000,116750,350,0.3,117080,680,0.58,116740,119920
ضصاد8044,اختيارخ وبصادر-1998-1401/08/11,18,817,408710000,500,500,500,0,0,500,0,0,500,510
سخند,صندوق س.سپهرخبرگان نفت-د,18,274590,2762742880,10050,10060,10056,6,0.06,10061,11,0.11,10056,10067
اخزا814,اسنادخزانه-م14بودجه98-010318,17,101600,100624386000,989100,989470,990450,1350,0.14,990400,1300,0.13,989470,990450
اخزا909,اسنادخزانه-م9بودجه99-020316,17,17500,14223837000,809730,812650,813200,3470,0.43,812790,3060,0.38,812640,813200
ضفلا3012,اختيارخ فولاد-10000-1401/03/18,17,355,928079000,2750,2655,2500,-250,-9.09,2614,-136,-4.95,2500,2750
خعمرا,توسعه و عمران شهرستان نائين,16,78656,766109440,9460,9740,9740,280,2.96,9480,20,0.21,9740,9740
اخزا0062,اسنادخزانه-م6بودجه00-030723,16,694,421506200,608960,608220,607020,-1940,-0.32,607360,-1600,-0.26,605420,608220
اخزا914,اسنادخزانه-م14بودجه99-021025,16,100500,72320842000,717630,719630,719620,1990,0.28,719610,1980,0.28,719610,719630
اخزا0032,اسنادخزانه-م3بودجه00-030418,15,656,417251970,643810,646000,643010,-800,-0.12,636050,-7760,-1.21,612020,646000
افق ملت,صندوق س در سهام افق ملت,15,2829,447292340,158060,158060,158880,820,0.52,158110,50,0.03,158060,158880
تسه9905,امتياز تسهيلات مسكن مرداد99,14,1613,2041782177,1332451,1265829,1265829,-66622,-5,1265829,-66622,-5,1265829,1265829
ثروتم,صندوق س. ثروت آفرين پارسيان-س,14,15280,1515138800,98470,99063,99299,829,0.84,99158,688,0.7,98772,99499
ضسپا3013,اختيارخ خساپا-1600-1401/03/25,14,877,494515000,578,570,545,-33,-5.71,564,-14,-2.42,541,577
ضجار7050,اختيارخ وتجارت-1980-1401/07/20,14,492,253522000,525,510,515,-10,-1.9,515,-10,-1.9,505,520
ضملي3014,اختيارخ فملي-8000-1401/03/02,13,346,7106000,3,3,5,2,66.67,21,18,600,3,30
ويستا,صندوق س. ويستا -س,13,89636,1172256777,13022,13150,13143,121,0.93,13078,56,0.43,12951,13201
پادا,صندوق س.پاداش سرمايه پارس-س,13,1564,189648641,118766,120800,120300,1534,1.29,121259,2493,2.1,120300,121500
اطلس2,صندوق س.توسعه اطلس مفيد-س,13,130000,130000,280266,1,1,-280265,-100,1,-280265,-100,1,1
اخزا902,اسنادخزانه-م2بودجه99-011019,12,115600,101479723000,878870,877400,879800,930,0.11,877850,-1020,-0.12,877400,879900
وآتوس,توسعه س. كشاورزي آرين توسكا,12,50812,1247434600,23850,24550,24550,700,2.94,23950,100,0.42,24550,24550
هاميد104,اختيارف ت ثاميد-1928-01/04/20,12,82168,20542000,188,250,250,62,32.98,250,62,32.98,250,250
ضجار7051,اختيارخ وتجارت-2180-1401/07/20,12,190,72922000,373,398,380,7,1.88,384,11,2.95,377,398
اخزا908,اسنادخزانه-م8بودجه99-020606,12,104800,81454744000,775980,776990,777010,1030,0.13,777240,1260,0.16,776990,777500
فلات,گروه صنايع معادن فلات ايرانيان,12,68568,706250400,10000,10300,10300,300,3,10020,20,0.2,10300,10300
اخزا901,اسنادخزانه-م1بودجه99-010621,11,6800,6380324000,937350,938000,940000,2650,0.28,938280,930,0.1,938000,947000
تسه9906,امتياز تسهيلات مسكن شهريور99,11,1336,1699799480,1339268,1272305,1272305,-66963,-5,1272305,-66963,-5,1272305,1272305
يارا2,صندوق س. آريا-د,11,9000000,9000000,10720,1,1,-10719,-99.99,1,-10719,-99.99,1,1
ضشنا8018,اختيارخ شپنا-8350-1401/08/29,11,125,42505000,302,400,350,48,15.89,340,38,12.58,330,400
اخزا9012,اسنادخزانه-م1بودجه99-010621,11,387,361785370,937350,925030,936610,-740,-0.08,934850,-2500,-0.27,925030,937980
اخزا905,اسنادخزانه-م5بودجه99-020218,11,17200,14204250000,824010,825550,826000,1990,0.24,825830,1820,0.22,825550,826000
ضخود5003,اختيارخ خودرو-2000-1401/05/12,11,766,399650000,547,520,515,-32,-5.85,522,-25,-4.57,515,525
گنجين,صندوق س. گنجينه يكم آويد-د,11,62587,972084662,15493,15530,15530,37,0.24,15532,39,0.25,15530,15538
سپيدما2,صندوق س. سپيد دماوند-د,10,93000000,93000000,12583,1,1,-12582,-99.99,1,-12582,-99.99,1,1
ضهمن3000,اختيارخ خبهمن-1200-1401/03/11,10,96,68333000,710,702,720,10,1.41,712,2,0.28,699,725
اخزا907,اسنادخزانه-م7بودجه99-020704,10,12000,9178161000,761100,764500,765000,3900,0.51,764850,3750,0.49,764500,765000
تكنو,تكنوتار,10,26341,193079530,6990,7330,7330,340,4.86,6990,0,0,7330,7330
ضخود5002,اختيارخ خودرو-1900-1401/05/12,10,356,211442000,690,599,590,-100,-14.49,594,-96,-13.91,590,600
سلار,شركت سيمان لارستان,10,21371,886896500,42750,41500,41500,-1250,-2.92,42650,-100,-0.23,41500,41500
زعف0110پ05,زعفران0110نگين زرين(پ),10,2368,928317280,390176,393000,393000,2824,0.72,392026,1850,0.47,390000,393000
ضهرم6000,اختيارخ اهرم-10000-1401/06/30,9,701,38639800,1,5584,5500,5499,549900,5512,5511,551100,5500,5584
نگين,ص.س. زمين و ساختمان نگين شهرري,9,11340,605146500,53250,53370,52420,-830,-1.56,53360,110,0.21,52380,53380
اخزا9082,اسنادخزانه-م8بودجه99-020606,9,230,175470610,775980,775000,775020,-960,-0.12,762920,-13060,-1.68,737210,777500
ضترا3015,اختيارخ شتران-5000-1401/03/08,9,128,68830000,588,510,579,-9,-1.53,538,-50,-8.5,500,615
اگ010819,گام بانك صادرات 0108,9,70300,62935120000,898000,892003,900000,2000,0.22,895236,-2764,-0.31,892003,900000
داريوش,صندوق س. ثروت داريوش -س,9,14029,162661120,11424,11410,11430,6,0.05,11595,171,1.5,11406,11690
ضسپا8053,اختيارخ خساپا-2200-1401/08/25,9,100,37138000,1,379,350,349,34900,371,370,37000,300,380
پتروما,صندوق س.بخشي پتروشيمي دماوند-ب,9,14782,160952792,10957,10887,10889,-68,-0.62,10888,-69,-0.63,10886,10889
طلا2,صندوق س.پشتوانه طلاي لوتوس,9,900000,900000,100422,1,1,-100421,-100,1,-100421,-100,1,1
اخزا815,اسنادخزانه-م15بودجه98-010406,8,3800,3723653000,980210,980000,980030,-180,-0.02,979910,-300,-0.03,979260,980030
شكف,كف,8,19882,899660500,44400,45250,45250,850,1.91,45250,850,1.91,45250,45250
خاتم2,صندوق س خاتم ايساتيس پويا-ثابت,8,7500000,7500000,13515,1,1,-13514,-99.99,1,-13514,-99.99,1,1
تاراز,صندوق س آواي تاراز زاگرس-سهام,8,14479,178372590,12250,12250,12230,-20,-0.16,12320,70,0.57,12230,12360
ثمين,صندوق س. ثروت افزون ثمين-س,8,16616,203859813,12217,12240,12111,-106,-0.87,12269,52,0.43,12111,12300
ضبدر3013,اختيارخ شبندر-7000-1401/03/29,8,83,207470000,2600,2500,2490,-110,-4.23,2500,-100,-3.85,2490,2500
ضذوب3002,اختيارخ ذوب-3000-1401/03/04,7,258,8068000,65,21,35,-30,-46.15,31,-34,-52.31,21,35
اخزا911,اسنادخزانه-م11بودجه99-020906,7,78300,57939029000,736970,739100,740000,3030,0.41,739960,2990,0.41,739100,740000
طخود4012,اختيارف خودرو-2200-1401/04/08,7,240,10800000,50,45,45,-5,-10,45,-5,-10,45,45
اخزا821,اسنادخزانه-م21بودجه98-020906,7,2600,1925750000,737930,739200,742000,4070,0.55,740670,2740,0.37,739100,742000
تملي703,تسهيلات مسكن ب. ملي-خرداد97,7,77,45846736,575490,604264,600010,24520,4.26,595412,19922,3.46,575490,604264
فردا2,صندوق س آواي فرداي زاگرس-ثابت,7,7000000,7000000,13093,1,1,-13092,-99.99,1,-13092,-99.99,1,1
ضشنا8012,اختيارخ شپنا-4850-1401/08/29,7,21,43223000,2000,2100,2010,10,0.5,2058,58,2.9,2010,2100
هماي2,صندوق س هماي آگاه-ثابت,7,22396000,22396000,10174,1,1,-10173,-99.99,1,-10173,-99.99,1,1
اخزا0072,اسنادخزانه-م7بودجه00-030912,6,281,165178960,592490,562890,591120,-1370,-0.23,587830,-4660,-0.79,562890,591660
گنجينه,صندوق س. گنجينه داريوش-د,6,58228,592084760,10364,10132,10170,-194,-1.87,10168,-196,-1.89,10132,10170
ضملت3014,اختيارخ وبملت-4500-1401/03/18,6,142,4251000,33,30,40,7,21.21,30,-3,-9.09,1,40
فسديد,لوله‌وتجهيزات‌ سديد - ورشكسته,6,7463,363448100,48250,48700,48700,450,0.93,48300,50,0.1,48700,48700
اخزا8152,اسنادخزانه-م15بودجه98-010406,6,208,203176700,980210,979400,976480,-3730,-0.38,976810,-3400,-0.35,970600,979400
ضشنا8017,اختيارخ شپنا-7350-1401/08/29,6,31,21080000,700,680,680,-20,-2.86,680,-20,-2.86,680,680
ضحافرين1203,اختيارخ حافرين-2500-14011214,5,12,19320000,1850,1610,1610,-240,-12.97,1610,-240,-12.97,1610,1610
زعف0110پ21,زعفران0110نگين ملل(پ),5,4030,1572700000,390000,390000,390500,500,0.13,390248,248,0.06,390000,390500
شتولي,تولي‌پرس‌,5,3667,61018880,16320,16640,16640,320,1.96,16640,320,1.96,16640,16640
ضصاد3012,اختيارخ وبصادر-1400-1401/03/11,5,152,116738000,790,760,769,-21,-2.66,768,-22,-2.78,760,769
ثبات2,صندوق س. ثبات ويستا -د,5,24900000,24900000,11579,1,1,-11578,-99.99,1,-11578,-99.99,1,1
پشاهن,توليدي پلاستيك‌ شاهين,5,50202,2615524200,50600,52100,52100,1500,2.96,52100,1500,2.96,52100,52100
ضملت3011,اختيارخ وبملت-3000-1401/03/18,5,177,177000000,960,1000,1000,40,4.17,1000,40,4.17,1000,1000
ضذوب8004,اختيارخ ذوب-2740-1401/08/04,5,500,305000000,1,600,610,609,60900,610,609,60900,600,620
ضذوب8003,اختيارخ ذوب-2540-1401/08/04,5,275,208750000,900,850,750,-150,-16.67,759,-141,-15.67,750,850
طسپا3015,اختيارف خساپا-2000-1401/03/25,5,350,13600000,40,41,40,0,0,39,-1,-2.5,35,41
افران2,صندوق س افرا نماد پايدار-ثابت,5,23900000,23900000,16370,1,1,-16369,-99.99,1,-16369,-99.99,1,1
داوه4,داروسازي آوه سينا,4,4000000,33360000000,8190,8340,8340,150,1.83,8340,150,1.83,8340,8340
ضفلا3009,اختيارخ فولاد-7000-1401/03/18,4,20,100851000,7145,5000,5250,-1895,-26.52,5043,-2102,-29.42,5000,5250
اخزا8202,اسنادخزانه-م20بودجه98-020806,4,100,74528580,749410,742500,743010,-6400,-0.85,745290,-4120,-0.55,742500,751310
ضهمن3002,اختيارخ خبهمن-1600-1401/03/11,4,4,1381000,403,350,311,-92,-22.83,345,-58,-14.39,311,370
ضپلا4006,اختيارخ پالايش-80000-01/04/29,4,110,7800000,8015,7000,8000,-15,-0.19,7091,-924,-11.53,7000,8000
ضسپا8054,اختيارخ خساپا-2400-1401/08/25,4,40,8000000,1,200,200,199,19900,200,199,19900,200,200
ضكاريس304,اختيارخ كاريس-15000-14010331,4,94,70476000,718,749,750,32,4.46,750,32,4.46,749,750
ضخود5005,اختيارخ خودرو-2400-1401/05/12,4,251,57730000,237,225,230,-7,-2.95,230,-7,-2.95,225,235
ضستر3004,اختيارخ خگستر-3250-1401/03/22,4,14,8880000,556,650,630,74,13.31,634,78,14.03,630,650
ضخود5006,اختيارخ خودرو-2600-1401/05/12,4,115,14936000,129,130,129,0,0,130,1,0.78,129,130
اخزا0092,اسناد خزانه-م9بودجه00-031101,4,232,133267480,575830,574250,574230,-1600,-0.28,574430,-1400,-0.24,574230,574690
اخزا9112,اسنادخزانه-م11بودجه99-020906,4,167,123180400,736970,737200,738000,1030,0.14,737610,640,0.09,737200,738000
اخزا0034,اسنادخزانه-م3بودجه00-030418,4,115758,74455545600,643810,643200,643200,-610,-0.09,643200,-610,-0.09,643200,643200
ضسپا3014,اختيارخ خساپا-1800-1401/03/25,4,115,44100000,400,60,380,-20,-5,383,-17,-4.25,60,400
كابگن,توليدي و صنعتي آبگينه‌,4,5998,51762740,8710,8630,8630,-80,-0.92,8710,0,0,8630,8630
پست0108پ04,پسته فندقي32-30سبزدانه0108(پ),4,11,27671420,2408162,2500000,2528570,120408,5,2515584,107422,4.46,2500000,2528570
اوج,صندوق س.اوج دماوند-س,4,30443,349670070,11614,11490,11486,-128,-1.1,11486,-128,-1.1,11486,11490
اخزا0082,اسنادخزانه-م8بودجه00-030919,3,174,100867920,589940,589020,566800,-23140,-3.92,579700,-10240,-1.74,566800,589040
گواهي ظرفيت,گواهي ظرفيت نقدي,3,6200000,249835200000,38378,40296,40296,1918,5,38828,450,1.17,40296,40296
ضملي3012,اختيارخ فملي-6000-1401/03/02,3,140,210000000,1045,1500,1500,455,43.54,1500,455,43.54,1500,1500
ضملت3012,اختيارخ وبملت-3500-1401/03/18,3,115,58550000,535,505,510,-25,-4.67,509,-26,-4.86,505,510
شكام2,صنايع شيميايي كيمياگران امروز,3,6098257,209475127950,35150,34350,34350,-800,-2.28,34350,-800,-2.28,34350,34350
اخزا9032,اسنادخزانه-م3بودجه99-011110,3,92,79794480,866770,867300,868990,2220,0.26,867330,560,0.06,867010,868990
كمند2,صندوق س. با درآمد ثابت كمند,3,249600000,249600000,10090,1,1,-10089,-99.99,1,-10089,-99.99,1,1
زعف0110پ19,زعفران0110نگين تروند قاينات(پ),3,4050,1579500100,390002,390002,390000,-2,0,390000,-2,0,390000,390002
ضفلا7012,اختيارخ فولاد-4588-1401/07/24,3,15,61000000,4085,4050,4100,15,0.37,4067,-18,-0.44,4050,4100
اخزا0102,اسناد خزانه-م10بودجه00-031115,3,152,86665810,571670,571120,570110,-1560,-0.27,570170,-1500,-0.26,570110,571120
اخزا906,اسنادخزانه-م6بودجه99-020321,3,300,243132000,806950,810410,810510,3560,0.44,810440,3490,0.43,810400,810510
تسه9903,امتياز تسهيلات مسكن خرداد99,3,401,508668500,1335263,1268500,1268500,-66763,-5,1268500,-66763,-5,1268500,1268500
ضملت3009,اختيارخ وبملت-2000-1401/03/18,3,64,127900000,1900,1995,2000,100,5.26,1998,98,5.16,1995,2000
ضستر3003,اختيارخ خگستر-3000-1401/03/22,3,65,72900000,1143,1150,1100,-43,-3.76,1122,-21,-1.84,1100,1150
ضذوب3000,اختيارخ ذوب-2000-1401/03/04,3,11,9379000,1099,850,879,-220,-20.02,853,-246,-22.38,850,879
ثهام,صندوق س ثروت هامرز-سهام,3,9450,114234990,11970,12080,12100,130,1.09,12090,120,1,12080,12100
اخزا8142,اسنادخزانه-م14بودجه98-010318,3,59,57822060,989100,941300,985840,-3260,-0.33,980030,-9070,-0.92,941300,985840
اخزا818,اسنادخزانه-م18بودجه98-010614,3,1200,1129894000,942000,941510,941680,-320,-0.03,941580,-420,-0.04,941500,941680
اراد96,مرابحه عام دولت96-ش.خ030414,2,10100,9731370000,965430,963000,1013700,48270,5,963500,-1930,-0.2,963000,1013700
اخزا0014,اسنادخزانه-م1بودجه00-030821,2,240598,144398381400,599170,600900,599300,130,0.02,600164,994,0.17,599300,600900
شپنا2,پالايش نفت اصفهان,2,15000000,99000000000,6520,6600,6600,80,1.23,6600,80,1.23,6600,6600
ضملت8052,اختيارخ وبملت-3081-1401/08/18,2,80,44000000,630,500,600,-30,-4.76,550,-80,-12.7,500,600
ضرنا4011,اختيارخ ورنا-7000-1401/04/22,2,20,5000000,400,200,300,-100,-25,250,-150,-37.5,200,300
ضحافرين1200,اختيارخ حافرين-1000-14011214,2,13,36620000,2850,2890,2700,-150,-5.26,2817,-33,-1.16,2700,2890
ضسپا3011,اختيارخ خساپا-1200-1401/03/25,2,126,118180000,1007,940,930,-77,-7.65,938,-69,-6.85,930,940
كمان,س.خ.كمان كاريزما 35% تاديه,2,95160,39562484520,415508,415747,415747,239,0.06,415747,239,0.06,415747,415747
دالبر2,البرزدارو,2,14700000,148470000000,10510,10100,10100,-410,-3.9,10100,-410,-3.9,10100,10100
اراد99,مرابحه عام دولت99-ش.خ050723,2,50000,50000000000,1000000,1000000,1000000,0,0,1000000,0,0,1000000,1000000
كهربا2,صندوق س.پشتوانه سكه طلا كهربا,2,400000,400000,12147,1,1,-12146,-99.99,1,-12146,-99.99,1,1
طخود4013,اختيارف خودرو-2400-1401/04/08,2,200,22000000,101,110,110,9,8.91,110,9,8.91,110,110
طخود3058,اختيارف خودرو-2500-1401/03/04,2,85,11425000,92,125,135,43,46.74,134,42,45.65,125,135
ضخود5000,اختيارخ خودرو-1700-1401/05/12,2,2,1149000,969,899,250,-719,-74.2,574,-395,-40.76,250,899
ضپاس7039,اختيارخ وپارس-2000-1401/07/27,2,105,42000000,420,400,400,-20,-4.76,400,-20,-4.76,400,400
كارا2,صندوق س. كارا -د,2,12000000,12000000,11373,1,1,-11372,-99.99,1,-11372,-99.99,1,1
ضستا7006,اختيارخ شستا-1300-1401/07/17,2,200,8000000,39,40,40,1,2.56,40,1,2.56,40,40
ضذوب3003,اختيارخ ذوب-3500-1401/03/04,2,17,110000,80,7,4,-76,-95,6,-74,-92.5,4,7
ضهاي7006,اختيارخ هاي وب-2648-01/07/10,2,9,21000000,2095,2500,2200,105,5.01,2333,238,11.36,2200,2500
ضشنا8011,اختيارخ شپنا-4350-1401/08/29,2,22,22112000,2403,1016,1004,-1399,-58.22,1005,-1398,-58.18,1004,1016
ضهاي7007,اختيارخ هاي وب-2950-01/07/10,2,16,28800000,1400,1800,1800,400,28.57,1800,400,28.57,1800,1800
اخزا9042,اسنادخزانه-م4بودجه99-011215,2,23,19573000,851660,851000,851000,-660,-0.08,851000,-660,-0.08,851000,851000
اخزا9072,اسنادخزانه-م7بودجه99-020704,2,55,41962800,761100,762960,762960,1860,0.24,762960,1860,0.24,762960,762960
اخزا9142,اسنادخزانه-م14بودجه99-021025,2,62,43342200,717630,682150,713000,-4630,-0.65,699070,-18560,-2.59,682150,713000
اخزا9102,اسنادخزانه-م10بودجه99-020807,2,80,56956260,748100,711960,711950,-36150,-4.83,711950,-36150,-4.83,711950,711960
كرونا2,تامين مالي جمعي صرفا اهداي سود,2,449,4490000,10000,10000,10000,0,0,10000,0,0,10000,10000
اخزا816,اسنادخزانه-م16بودجه98-010503,2,2100,2025600000,962920,964550,965000,2080,0.22,964570,1650,0.17,964550,965000
سحرا021,سلف موازي برق نيروي برق حرارتي,2,47190,16001562720,338935,339088,339088,153,0.05,339088,153,0.05,339088,339088
زير0103پ04,زيره سبز0103شركت مينوبذر(پ),2,18,22644000,1234603,1258000,1258000,23397,1.9,1258000,23397,1.9,1258000,1258000
ضخود4016,اختيارخ خودرو-3000-1401/04/08,2,70,2450000,40,35,35,-5,-12.5,35,-5,-12.5,35,35
اراد69,مرابحه عام دولت69-ش.خ0310,2,25000,23750000000,969990,950000,950000,-19990,-2.06,950000,-19990,-2.06,950000,950000
ضستر3006,اختيارخ خگستر-3750-1401/03/22,2,40,16040000,580,401,401,-179,-30.86,401,-179,-30.86,401,401
ضذوب3001,اختيارخ ذوب-2500-1401/03/04,2,65,26200000,500,450,400,-100,-20,403,-97,-19.4,400,450
اخزا8182,اسنادخزانه-م18بودجه98-010614,2,57,53311940,942000,934420,935420,-6580,-0.7,935300,-6700,-0.71,934420,935420
اخزا0064,اسنادخزانه-م6بودجه00-030723,2,3385000,2079334650000,608960,610500,614430,5470,0.9,614279,5319,0.87,610500,614430
اراد35,مرابحه عام دولت3-ش.خ 0103,1,100,100000000,999090,1000000,1000000,910,0.09,1000000,910,0.09,1000000,1000000
اخزا9182,اسنادخزانه-م18بودجه99-010323,1,59,58174590,986950,986010,986010,-940,-0.1,986010,-940,-0.1,986010,986010
پاكشو2,گروه صنعتي پاكشو,1,25000000,167750000000,6710,6710,6710,0,0,6710,0,0,6710,6710
سپيدما4,صندوق س. سپيد دماوند-د,1,79367000,999944833000,12583,12599,12599,16,0.13,12599,16,0.13,12599,12599
اخزا904,اسنادخزانه-م4بودجه99-011215,1,100,85170000,851660,851700,851700,40,0,851700,40,0,851700,851700
سمتا025,سلف موازي متانول بوشهر 025,1,100,103602900,1035547,1036029,1036029,482,0.05,1036029,482,0.05,1036029,1036029
اراد46,مرابحه عام دولت4-ش.خ 0302,1,5000,5000000000,1000000,1000000,1000000,0,0,1000000,0,0,1000000,1000000
تملي709,تسهيلات مسكن ب. ملي-آذر97,1,22,10315756,493576,468898,468898,-24678,-5,468898,-24678,-5,468898,468898
كارا4,صندوق س. كارا -د,1,27000000,307260000000,11373,11380,11380,7,0.06,11380,7,0.06,11380,11380
ارزش4,صندوق س ارزش آفرين بيدار-سهام,1,13200000,149952000000,11360,11360,11360,0,0,11360,0,0,11360,11360
اخزا0054,اسنادخزانه-م5بودجه00-030626,1,128441,79453602600,618320,618600,618600,280,0.05,618600,280,0.05,618600,618600
سمتا024,سلف موازي متانول بوشهر 024,1,100,91108000,910657,911080,911080,423,0.05,911080,423,0.05,911080,911080
آبين4,كشت و صنعت آبشيرين,1,20000000,93440000000,4536,4672,4672,136,3,4672,136,3,4672,4672
اخزا9052,اسنادخزانه-م5بودجه99-020218,1,42,34232520,824010,815060,815060,-8950,-1.09,815060,-8950,-1.09,815060,815060
سنفت021,سلف موازي نفت.س صادر اروند 021,1,100,211776700,2116782,2117767,2117767,985,0.05,2117767,985,0.05,2117767,2117767
اراد614,مرابحه عام دولت61-ش.خ0309,1,180000,180000000000,1000000,1000000,1000000,0,0,1000000,0,0,1000000,1000000
سمتا023,سلف موازي استاندارد سمتا023,1,100,93399900,933565,933999,933999,434,0.05,933999,434,0.05,933999,933999
طهرم6003,اختيارف اهرم-13000-1401/06/30,1,45,112500,1,250,250,249,24900,250,249,24900,250,250
ضستر3009,اختيارخ خگستر-5000-1401/03/22,1,100,3300000,67,33,33,-34,-50.75,33,-34,-50.75,33,33
وبوعلي2,سرمايه‌گذاري‌بوعلي‌,1,149500000,754975000000,5100,5050,5050,-50,-0.98,5050,-50,-0.98,5050,5050
ضصاد3011,اختيارخ وبصادر-1200-1401/03/11,1,5,4750000,950,950,950,0,0,950,0,0,950,950
ضرنا4006,اختيارخ ورنا-4500-1401/04/22,1,3,3000000,1299,1000,1000,-299,-23.02,1000,-299,-23.02,1000,1000
ضملي3010,اختيارخ فملي-4500-1401/03/02,1,1,4000000,3534,4000,4000,466,13.19,4000,466,13.19,4000,4000
سمتا011,سلف موازي استاندارد سمتا011,1,10,90118060,9008086,9011806,9011806,3720,0.04,9011806,3720,0.04,9011806,9011806
ضبدر3010,اختيارخ شبندر-4500-1401/03/29,1,3,13500000,3560,4500,4500,940,26.4,4500,940,26.4,4500,4500
طملي3013,اختيارف فملي-7000-1401/03/02,1,40,40000,280,1,1,-279,-99.64,1,-279,-99.64,1,1
ضهرم6003,اختيارخ اهرم-13000-1401/06/30,1,1,33000,1,3300,3300,3299,329900,3300,3299,329900,3300,3300
متا0105,آتي متانول -1401/05/17,1,100,93900000,940000,939000,939000,-1000,-0.11,939000,-1000,-0.11,939000,939000
ضهاي7005,اختيارخ هاي وب-2347-01/07/10,1,10,32600000,3033,3260,3260,227,7.48,3260,227,7.48,3260,3260
نسب0106,آتي نفتاي سبك-1401/06/17,1,100,239750000,2398000,2397500,2397500,-500,-0.02,2397500,-500,-0.02,2397500,2397500
هبساز103,اختيارف ت ثبهساز-2226-01/03/18,1,6144,3495936,550,569,569,19,3.45,569,19,3.45,569,569
متا0106,آتي متانول -1401/06/17,1,100,94500000,950000,945000,945000,-5000,-0.53,945000,-5000,-0.53,945000,945000
ضپلا4009,اختيارخ پالايش-110000-01/04/29,1,100,1900000,1,1900,1900,1899,189900,1900,1899,189900,1900,1900
ضذوب8006,اختيارخ ذوب-3190-1401/08/04,1,50,20000000,500,400,400,-100,-20,400,-100,-20,400,400
ضپنا7053,اختيارخ رمپنا-16000-1401/07/12,1,1,3700000,3500,3700,3700,200,5.71,3700,200,5.71,3700,3700
زعف0110پ16,زعفران0110نگين بيرجند(پ),1,620,241800000,390000,390000,390000,0,0,390000,0,0,390000,390000
مشير112,مشاركت شهرداري شيراز-3ماهه18%,1,5,5025000,1000000,1005000,1005000,5000,0.5,1005000,5000,0.5,1005000,1005000
سمتا022,سلف موازي استاندارد سمتا022,1,100,93044500,930012,930445,930445,433,0.05,930445,433,0.05,930445,930445
اخزا918,اسنادخزانه-م18بودجه99-010323,1,100,98749000,986950,987490,987490,540,0.05,987490,540,0.05,987490,987490
اخزا817,اسنادخزانه-م17بودجه98-010512,1,100,96000000,959010,960000,960000,990,0.1,960000,990,0.1,960000,960000
اخزا9092,اسنادخزانه-م9بودجه99-020316,1,50,38486000,809730,769720,769720,-40010,-4.94,769720,-40010,-4.94,769720,769720
كگهر2,سنگ آهن گهرزمين,1,3000000,150000000000,50000,50000,50000,0,0,50000,0,0,50000,50000
اخزا9022,اسنادخزانه-م2بودجه99-011019,1,9,7830000,878870,870000,870000,-8870,-1.01,870000,-8870,-1.01,870000,870000
اراد874,مرابحه عام دولت87-ش.خ030304,1,300000,281550000000,932000,938500,938500,6500,0.7,938500,6500,0.7,938500,938500
كمند4,صندوق س. با درآمد ثابت كمند,1,70000000,706790000000,10090,10097,10097,7,0.07,10097,7,0.07,10097,10097
اخزا0024,اسنادخزانه-م2بودجه00-031024,1,121962,70567213200,577880,578600,578600,720,0.12,578600,720,0.12,578600,578600
وتوكا2,سرمايه‌گذاري‌توكافولاد(هلدينگ,1,10000000,102000000000,10010,10200,10200,190,1.9,10200,190,1.9,10200,10200
ضخود5010,اختيارخ خودرو-3500-1401/05/12,1,1,70000,80,70,70,-10,-12.5,70,-10,-12.5,70,70
زعف0110پ08,زعفران0110نگين روستا(پ),1,40,15640200,390000,391005,391005,1005,0.26,391005,1005,0.26,391005,391005
ضملت8047,اختيارخ وبملت-2133-1401/08/18,1,36,57600000,1,1600,1600,1599,159900,1600,1599,159900,1600,1600
ضشنا8015,اختيارخ شپنا-6350-1401/08/29,1,10,10000000,1070,1000,1000,-70,-6.54,1000,-70,-6.54,1000,1000
ضرنا4009,اختيارخ ورنا-6000-1401/04/22,1,10,6000000,600,600,600,0,0,600,0,0,600,600
نسب0105,آتي نفتاي سبك-1401/05/17,1,100,239850000,2399000,2398500,2398500,-500,-0.02,2398500,-500,-0.02,2398500,2398500
ضكاريس902,اختيارخ كاريس-14000-14010930,1,1,4350000,2000,4350,4350,2350,117.5,4350,2350,117.5,4350,4350
سمتا021,سلف موازي استاندارد سمتا021,1,100,92832400,927893,928324,928324,431,0.05,928324,431,0.05,928324,928324
ضسپا8052,اختيارخ خساپا-2000-1401/08/25,1,40,18400000,1,460,460,459,45900,460,459,45900,460,460
ضرنا4004,اختيارخ ورنا-3750-1401/04/22,1,50,108750000,1500,2175,2175,675,45,2175,675,45,2175,2175
ضترا3016,اختيارخ شتران-6000-1401/03/08,1,27,2700000,550,100,100,-450,-81.82,100,-450,-81.82,100,100
ضملت8048,اختيارخ وبملت-2291-1401/08/18,1,20,28400000,1,1420,1420,1419,141900,1420,1419,141900,1420,1420
ضپنا7052,اختيارخ رمپنا-15000-1401/07/12,1,1,4500000,4300,4500,4500,200,4.65,4500,200,4.65,4500,4500
ضسپا8050,اختيارخ خساپا-1800-1401/08/25,1,2,1220000,640,610,610,-30,-4.69,610,-30,-4.69,610,610
آرام4,صندوق س شاخصي آرام مفيد,1,10000000,112900000000,11190,11290,11290,100,0.89,11290,100,0.89,11290,11290
اراد65,مرابحه عام دولتي65-ش.خ0210,1,100,98500000,975000,985000,985000,10000,1.03,985000,10000,1.03,985000,985000
اراد86,مرابحه عام دولت86-ش.خ020404,1,10000,9650000000,980000,965000,965000,-15000,-1.53,965000,-15000,-1.53,965000,965000
صنم2,ص.س.صندوق در صندوق صنم,1,200000,200000,11588,1,1,-11587,-99.99,1,-11587,-99.99,1,1
صفارس147,صكوك اجاره فارس147- 3ماهه18%,1,152,150480000,990000,990000,990000,0,0,990000,0,0,990000,990000
اراد61,مرابحه عام دولت61-ش.خ0309,1,10000,10000000000,1000000,1000000,1000000,0,0,1000000,0,0,1000000,1000000
ساروج2,بين المللي ساروج بوشهر,1,2400000,41688000000,17730,17370,17370,-360,-2.03,17370,-360,-2.03,17370,17370
سصوفي2,سيمان‌ صوفيان‌,1,54950000,1031411500000,17710,18770,18770,1060,5.99,18770,1060,5.99,18770,18770
اخزا9144,اسنادخزانه-م14بودجه99-021025,1,138692,99927586000,717630,720500,720500,2870,0.4,720500,2870,0.4,720500,720500
وبصادر2,بانك صادرات ايران,1,22500000,49860000000,2216,2216,2216,0,0,2216,0,0,2216,2216
متا0104,آتي متانول -1401/04/17,1,100,94350000,945000,943500,943500,-1500,-0.16,943500,-1500,-0.16,943500,943500
ضپلا4005,اختيارخ پالايش-74000-01/04/29,1,1,140000,10000,14000,14000,4000,40,14000,4000,40,14000,14000
ضرنا4005,اختيارخ ورنا-4000-1401/04/22,1,4,10316000,2400,2579,2579,179,7.46,2579,179,7.46,2579,2579
سميعا101,سلف موازي استاندارد سميعا101,1,100,131063300,1310112,1310633,1310633,521,0.04,1310633,521,0.04,1310633,1310633
ضملت8046,اختيارخ وبملت-1975-1401/08/18,1,20,35400000,1,1770,1770,1769,176900,1770,1769,176900,1770,1770
طخود3060,اختيارف خودرو-3500-1401/03/04,1,1,2000000,1,2000,2000,1999,199900,2000,1999,199900,2000,2000
سميعا102,سلف موازي استاندارد سميعا102,1,100,142349900,1422929,1423499,1423499,570,0.04,1423499,570,0.04,1423499,1423499
غدشت2,دشت‌ مرغاب‌,1,3729611,65864930260,16820,17660,17660,840,4.99,17660,840,4.99,17660,17660
اخزا8212,اسنادخزانه-م21بودجه98-020906,1,20,14760200,737930,738010,738010,80,0.01,738010,80,0.01,738010,738010
نسب0104,آتي نفتاي سبك-1401/04/17,1,100,239950000,2400000,2399500,2399500,-500,-0.02,2399500,-500,-0.02,2399500,2399500
ضپنا7051,اختيارخ رمپنا-14000-1401/07/12,1,10,49000000,4862,4900,4900,38,0.78,4900,38,0.78,4900,4900
ضخود3053,اختيارخ خودرو-1200-1401/03/04,1,2,2994000,1875,1497,1497,-378,-20.16,1497,-378,-20.16,1497,1497
كاريس4,صندوق س.سپند كاريزما-س,1,12500000,194375000000,15444,15550,15550,106,0.69,15550,106,0.69,15550,15550
مارون2,پتروشيمي مارون,1,150000,28500000000,191050,190000,190000,-1050,-0.55,190000,-1050,-0.55,190000,190000
اخزا0084,اسنادخزانه-م8بودجه00-030919,1,128770,75974300000,589940,590000,590000,60,0.01,590000,60,0.01,590000,590000
فولاد2,فولاد مباركه اصفهان,1,8000000,100000000000,12550,12500,12500,-50,-0.4,12500,-50,-0.4,12500,12500
اراد87,مرابحه عام دولت87-ش.خ030304,1,2300,2185000000,932000,950000,950000,18000,1.93,950000,18000,1.93,950000,950000
كارين4,صندوق س نگين سامان-ثابت,1,17633000,176435798000,10177,10006,10006,-171,-1.68,10006,-171,-1.68,10006,10006
تملي801,تسهيلات مسكن ب. ملي-فروردين98,1,10,5445210,573179,544521,544521,-28658,-5,544521,-28658,-5,544521,544521
اخزا820,اسنادخزانه-م20بودجه98-020806,1,8200,6160906000,749410,751330,751330,1920,0.26,751330,1920,0.26,751330,751330
اوصتا4,صندوق انديشه ورزان صباتامين -د,1,8369950,189964385200,22682,22696,22696,14,0.06,22696,14,0.06,22696,22696
ثروتم2,صندوق س. ثروت آفرين پارسيان-س,1,500000,500000,98470,1,1,-98469,-100,1,-98469,-100,1,1
