نماد,نام,تعداد,حجم,ارزش,دیروز,اولین,آخرین معامله - مقدار,آخرین معامله - تغییر,آخرین معامله - درصد,قیمت پایانی - مقدار,قیمت پایانی - تغییر,قیمت پایانی - درصد,کمترین,بیشترین
فروسيل,فروسيليسيم خمين,82162,38342006,1361141213000,33850,35500,35500,1650,4.87,35500,1650,4.87,35500,35500
ددانا,داروسازي دانا,46450,3320123,116702323450,33200,35150,35150,1950,5.87,35150,1950,5.87,35150,35150
شستا,سرمايه گذاري تامين اجتماعي,23027,1223923316,1239748383534,1039,1039,1009,-30,-2.89,1013,-26,-2.5,1002,1044
بهير,س. توسعه تجارت هيرمند,18849,23051251,176809455730,7730,7940,7960,230,2.98,7670,-60,-0.78,7500,7960
خودرو,ايران‌ خودرو,18384,720657574,1626897902319,2360,2350,2243,-117,-4.96,2258,-102,-4.32,2242,2353
خساپا,سايپا,18221,919913865,1878244655587,2137,2101,2033,-104,-4.87,2042,-95,-4.45,2031,2128
پالايش,صندوق پالايشي يكم-سهام,17292,18473631,1421241722790,79350,79010,76550,-2800,-3.53,76930,-2420,-3.05,75740,79010
خگستر,گسترش‌سرمايه‌گذاري‌ايران‌خودرو,15862,724597187,2758805106365,4038,3900,3797,-241,-5.97,3807,-231,-5.72,3796,3940
حگهر,حمل و نقل گهرترابر سيرجان,12917,48069860,425389985160,9100,9500,8560,-540,-5.93,8850,-250,-2.75,8560,9500
شپنا,پالايش نفت اصفهان,12340,196362049,1264501848940,6570,6600,6490,-80,-1.22,6440,-130,-1.98,6320,6640
دارا يكم,صندوق واسطه گري مالي يكم-سهام,11029,6747743,783209189000,118900,118680,114990,-3910,-3.29,116070,-2830,-2.38,114510,118680
كدما,معدني‌ دماوند,10825,8460262,782729171040,91670,96250,93000,1330,1.45,92520,850,0.93,87230,96250
اسياتك,انتقال داده هاي آسياتك,10139,7397314,99863739000,12860,13500,13500,640,4.98,13500,640,4.98,13500,13500
مديريت,س. و خدمات مديريت صند. ب كشوري,9954,70385050,666715390020,9820,9820,9250,-570,-5.8,9470,-350,-3.56,9240,10100
كرمان,س. توسعه و عمران استان كرمان,9818,475323050,457929747118,1016,1002,960,-56,-5.51,963,-53,-5.22,956,1016
شتران,پالايش نفت تهران,9759,180150675,974521006280,5590,5600,5390,-200,-3.58,5410,-180,-3.22,5320,5620
شبندر,پالايش نفت بندرعباس,9256,131801664,1157310259700,9000,9010,8800,-200,-2.22,8780,-220,-2.44,8600,9120
وسديد,گروه ‌صنعتي‌سديد,8925,193419471,271570475817,1365,1405,1405,40,2.93,1404,39,2.86,1361,1405
قثابت,قند ثابت‌ خراسان‌,8728,258554773,801657743123,2990,3139,3139,149,4.98,3101,111,3.71,2959,3139
فولاد,فولاد مباركه اصفهان,8431,100386697,1245281441210,12540,12550,12330,-210,-1.67,12400,-140,-1.12,12270,12580
وتجارت,بانك تجارت,7760,292012823,620455351637,2252,2175,2118,-134,-5.95,2125,-127,-5.64,2117,2175
فملي,ملي‌ صنايع‌ مس‌ ايران‌,7431,116217564,868870481830,7550,7560,7490,-60,-0.79,7480,-70,-0.93,7370,7580
خپارس,پارس‌ خودرو,6682,366878707,432160480768,1231,1217,1173,-58,-4.71,1178,-53,-4.31,1170,1225
حكشتي,كشتيراني جمهوري اسلامي ايران,6672,39228583,826864396870,20880,21500,21450,570,2.73,21080,200,0.96,20110,21770
وبصادر,بانك صادرات ايران,6403,248526801,534623741324,2209,2220,2115,-94,-4.26,2151,-58,-2.63,2103,2220
بركت,گروه دارويي بركت,6387,24958800,438190116970,16940,17200,17700,760,4.49,17560,620,3.66,16920,17850
وبملت,بانك ملت,6343,223323400,862393143782,3956,3960,3820,-136,-3.44,3862,-94,-2.38,3782,3998
كمند,صندوق س. با درآمد ثابت كمند,6263,285950565,2888553668122,10097,10101,10101,4,0.04,10102,5,0.05,10101,10102
وخارزم,سرمايه گذاري خوارزمي,6137,94305027,448687394890,5020,5000,4740,-280,-5.58,4760,-260,-5.18,4720,5000
سآبيك,سيمان آبيك,6065,1600241,22675414970,13500,14170,14170,670,4.96,14170,670,4.96,14170,14170
خبهمن,گروه‌بهمن‌,5854,218408718,402248974462,1935,1940,1854,-81,-4.19,1842,-93,-4.81,1819,1940
فرابورس,فرابورس ايران,5828,36950323,525870375470,15050,15040,14220,-830,-5.51,14230,-820,-5.45,14150,15050
خبنيان,بنيان ديزل,5434,146299967,604808130108,4177,4052,4054,-123,-2.94,4134,-43,-1.03,4052,4302
كالا,بورس كالاي ايران,5401,17128073,445493811200,27450,27450,25860,-1590,-5.79,26010,-1440,-5.25,25810,27500
ذوب,ذوب آهن اصفهان,5295,133654363,380446962098,2946,2960,2825,-121,-4.11,2846,-100,-3.39,2800,2991
غدام,خوراك‌  دام‌ پارس‌,5229,5482728,327878552460,61490,62670,58420,-3070,-4.99,59800,-1690,-2.75,58420,64560
هاي وب,داده گسترعصرنوين-هاي وب,4922,40504179,390437026250,10110,10100,9570,-540,-5.34,9640,-470,-4.65,9510,10250
انرژي,بورس انرژي ايران,4858,5482804,331994781690,63320,63990,60390,-2930,-4.63,60550,-2770,-4.37,60160,63990
سپيد,سپيد ماكيان,4698,23760652,537734352290,23730,23340,22550,-1180,-4.97,22630,-1100,-4.64,22550,23490
وليزح,ح . ليزينگ‌ايران‌,4554,2060941330,3382004722530,1641,1641,1641,0,0,1641,0,0,1641,1641
تجلي,تجلي توسعه معادن و فلزات,4462,148196304,223743471353,1576,1576,1521,-55,-3.49,1510,-66,-4.19,1498,1579
غگل,گلوكوزان‌,4409,49230606,253798399120,5090,5240,5150,60,1.18,5160,70,1.38,4990,5340
آريا,پليمر آريا ساسول,4376,2788500,220746108100,79900,80150,79200,-700,-0.88,79150,-750,-0.94,77600,80900
پارس,پتروشيمي پارس,4329,135812864,369679083091,2723,2750,2728,5,0.18,2722,-1,-0.04,2685,2806
تسه1401,امتيازتسهيلات مسكن سال1401,4174,159702,190246923924,1253960,1191262,1191262,-62698,-5,1191262,-62698,-5,1191262,1191262
فاذر,صنايع‌ آذرآب‌,4045,238122784,245861618526,1071,1060,1039,-32,-2.99,1032,-39,-3.64,1018,1083
بورس,بورس اوراق بهادار تهران,4014,38859086,340213304620,9220,9330,8820,-400,-4.34,8760,-460,-4.99,8670,9330
پترول,گ.س.وت.ص.پتروشيمي خليج فارس,4006,81441515,190366106362,2409,2430,2293,-116,-4.82,2337,-72,-2.99,2282,2444
زقيام,كشت و دام قيام اصفهان,3934,100306349,252715811220,2409,2500,2553,144,5.98,2519,110,4.57,2351,2553
كاما,باما,3922,46464141,302618934580,6870,6830,6490,-380,-5.53,6510,-360,-5.24,6460,6870
شپاكسا,پاكسان‌,3836,70861202,196694776073,2723,2880,2755,32,1.18,2776,53,1.95,2631,2880
خزاميا,زامياد,3787,61623274,574839182600,9790,9650,9320,-470,-4.8,9330,-460,-4.7,9310,9880
نوري,پتروشيمي نوري,3786,2297800,270714595740,119340,120000,119000,-340,-0.28,117810,-1530,-1.28,116370,120000
بترانس,ايران‌ ترانسفو,3760,132044493,334226789061,2679,2650,2519,-160,-5.97,2531,-148,-5.52,2519,2650
سبزوا,سيمان لار سبزوار,3639,58116153,234191129625,4041,4200,4025,-16,-0.4,4030,-11,-0.27,3871,4255
غزر,صنعتي زر ماكارون,3580,18164384,188670088710,10590,10600,10070,-520,-4.91,10390,-200,-1.89,10070,10830
وساپا,سرمايه‌گذاري‌ سايپا,3515,133449664,655917741740,5220,4950,4910,-310,-5.94,4920,-300,-5.75,4910,5100
كيان,صندوق س. با درآمد ثابت كيان,3416,32394518,1132255508609,34932,34951,34953,21,0.06,34952,20,0.06,34950,34954
آبين,كشت و صنعت آبشيرين,3335,97272917,453816280720,4672,4812,4792,120,2.57,4665,-7,-0.15,4532,4812
بپيوند,برق و انرژي پيوندگستر پارس,3326,9778375,119192979340,12010,12530,12100,90,0.75,12190,180,1.5,11660,12640
شوينده,مديريت صنعت شوينده ت.ص.بهشهر,3265,8690029,200077288040,22120,22950,23440,1320,5.97,23020,900,4.07,21220,23440
اعتماد,صندوق س.اعتماد آفرين پارسيان-د,3229,43665120,1940744574170,44417,44445,44447,30,0.07,44446,29,0.07,44445,44448
وسپهر,سرمايه گذاري مالي سپهرصادرات,3225,20229744,162532322790,7600,7520,8050,450,5.92,8030,430,5.66,7520,8050
سمگا,گروه سرمايه گذاري ميراث فرهنگي,3200,25476312,234473067160,9650,9780,9080,-570,-5.91,9200,-450,-4.66,9080,9780
هماي,صندوق س هماي آگاه-ثابت,3125,76243700,763448015282,10007,10013,10014,7,0.07,10013,6,0.06,10011,10014
سنير,سيمان‌ سفيد ني‌ريز,3093,9004681,346317784800,36930,38770,38770,1840,4.98,38460,1530,4.14,37030,38770
ثاميد,توسعه و عمران اميد,3067,79415961,124672123247,1642,1600,1560,-82,-4.99,1570,-72,-4.38,1560,1636
وكبهمن,مديريت سرمايه گذاري كوثربهمن,3048,17015817,102370471480,6330,6450,5960,-370,-5.85,6020,-310,-4.9,5960,6450
غنوش,نوش‌ مازندران‌,3022,16426933,180756543850,11070,11250,11160,90,0.81,11000,-70,-0.63,10520,11590
فباهنر,مس‌ شهيدباهنر,2952,11748452,378194344460,33980,33560,32010,-1970,-5.8,32190,-1790,-5.27,31950,33560
وگستر,گسترش سرمايه گذاري ايرانيان,2938,20612072,149259734160,6950,7350,7150,200,2.88,7240,290,4.17,6950,7360
وآذر,سرمايه‌گذاري‌توسعه‌آذربايجان‌,2905,3683544,393449448260,102230,104000,107340,5110,5,106810,4580,4.48,101100,107340
شگويا,پتروشيمي تندگويان,2860,14290438,173340603030,12510,12420,12350,-160,-1.28,12130,-380,-3.04,11900,12550
شبريز,پالايش نفت تبريز,2820,14351261,320612210310,22780,22900,22300,-480,-2.11,22340,-440,-1.93,22060,23140
امين يكم,صندوق درآمد ثابت امين يكم فردا,2774,62604076,626481328068,10000,10005,10010,10,0.1,10007,7,0.07,10005,10010
وپارس,بانك‌پارسيان‌,2765,107282109,213101425735,2082,2080,1978,-104,-5,1986,-96,-4.61,1978,2098
كچاد,معدني‌وصنعتي‌چادرملو,2714,13723206,225932372590,16970,16970,16460,-510,-3.01,16460,-510,-3.01,16100,17100
كلر,كلر پارس,2682,1935924,175951692050,94750,97150,90800,-3950,-4.17,90900,-3850,-4.06,89100,97150
صباح,ح . گروه مالي صبا تامين,2611,42777485,99992695165,2423,2428,2340,-83,-3.43,2338,-85,-3.51,2282,2449
فجهان,مجتمع جهان فولاد سيرجان,2546,11793409,40127120727,3534,3528,3379,-155,-4.39,3474,-60,-1.7,3341,3528
ختوقا,قطعات‌ اتومبيل‌ ايران‌,2542,63667248,205068621859,3408,3370,3204,-204,-5.99,3221,-187,-5.49,3204,3380
سكرد,سيمان كردستان,2525,25231688,242244689080,9280,9740,9530,250,2.69,9600,320,3.45,9290,9740
فخوز,فولاد  خوزستان,2506,47525009,288074671160,6200,6200,6020,-180,-2.9,6060,-140,-2.26,6000,6250
فنفت,صنايع تجهيزات نفت,2499,15701494,509284594900,33350,32400,32350,-1000,-3,32450,-900,-2.7,32350,33950
بوعلي,پتروشيمي بوعلي سينا,2492,1124661,98418898540,88240,88250,87600,-640,-0.73,87510,-730,-0.83,86050,89900
وغدير,سرمايه‌گذاري‌غدير(هلدينگ‌,2462,16330781,238357698830,14870,14750,14540,-330,-2.22,14600,-270,-1.82,14400,15000
وبرق,س.کارکنان صنعت برق زنجان وقزوي,2459,2416534,206226264150,86150,88600,84700,-1450,-1.68,85350,-800,-0.93,83600,88700
سيتا,سرمايه گذاري سيمان تامين,2436,12588464,141944682120,11780,11790,11230,-550,-4.67,11280,-500,-4.24,11200,11900
فسبزوار,پارس فولاد سبزوار,2402,2546235,69866667550,28020,28000,27340,-680,-2.43,27440,-580,-2.07,27200,28220
ثشاهد,سرمايه‌ گذاري‌ شاهد,2390,23522314,214132715770,9590,9550,9020,-570,-5.94,9100,-490,-5.11,9020,9780
ختور,رادياتور ايران‌,2385,9901597,132882346690,13470,14180,13270,-200,-1.48,13420,-50,-0.37,12850,14180
افران,صندوق س افرا نماد پايدار-ثابت,2370,48083699,788170654718,16381,16391,16391,10,0.06,16392,11,0.07,16391,16393
چدن,توليدي چدن سازان,2370,76660544,191730427721,2397,2430,2454,57,2.38,2501,104,4.34,2392,2540
ديران,ايران‌دارو,2363,7982386,169775577850,20710,21300,20960,250,1.21,21270,560,2.7,20250,21740
گدنا,تهيه توزيع غذاي دنا آفرين فدك,2362,8068190,114627165260,14900,15130,14160,-740,-4.97,14210,-690,-4.63,14160,15180
غبشهر,صنعتي‌ بهشهر,2360,71357452,288490140582,4272,4101,4030,-242,-5.66,4043,-229,-5.36,4016,4272
ثبهساز,بهساز كاشانه تهران,2353,30483287,47445235272,1627,1629,1547,-80,-4.92,1556,-71,-4.36,1546,1629
ومدير,گ.مديريت ارزش سرمايه ص ب كشوري,2289,24078280,106138993277,4475,4530,4400,-75,-1.68,4408,-67,-1.5,4304,4539
فجهانح,ح. مجتمع جهان فولاد سيرجان,2286,6513039,11916630013,1856,1856,1816,-40,-2.16,1830,-26,-1.4,1807,1898
توسن,توسعه سامانه ي نرم افزاري نگين,2286,4213070,89124338600,22350,22250,21300,-1050,-4.7,21150,-1200,-5.37,21050,22250
كفپارس,فرآورده‌هاي‌ نسوز پارس‌,2278,50880418,234836378375,4432,4653,4653,221,4.99,4615,183,4.13,4438,4653
خفولا,خدمات فني فولاد يزد,2259,10395073,184477172900,17460,17980,17980,520,2.98,17750,290,1.66,16940,17980
كيمياتك,آريان كيميا تك,2228,2760743,74338359860,27170,27500,26390,-780,-2.87,26930,-240,-0.88,25820,27920
خكاوه,سايپا ديزل,2215,39035642,347105605790,8670,8930,8920,250,2.88,8890,220,2.54,8470,8930
لپارس,پارس‌ الكتريك‌,2200,1119197,122601058440,114450,113000,108730,-5720,-5,109540,-4910,-4.29,108730,115500
صبا,گروه مالي صبا تامين,2198,24571423,119873884380,5020,5000,4840,-180,-3.59,4880,-140,-2.79,4760,5020
شاروم,پتروشيمي اروميه,2194,4359825,67571290390,16180,16300,15420,-760,-4.7,15500,-680,-4.2,15380,16300
فارس,صنايع پتروشيمي خليج فارس,2185,25387623,214323682530,8460,8480,8470,10,0.12,8440,-20,-0.24,8290,8520
پارند,صندوق س. پارند پايدار سپهر,2174,72046451,727795133257,10095,10102,10102,7,0.07,10102,7,0.07,10101,10102
فجر,فولاد اميركبيركاشان,2165,6016328,121761938640,20960,20980,20460,-500,-2.39,20240,-720,-3.44,19710,20990
قرن,پديده شيمي قرن,2140,5141178,127810500840,26010,26600,24930,-1080,-4.15,24860,-1150,-4.42,24450,26600
خاور,ايران خودرو ديزل,2131,66534769,111452101377,1724,1711,1673,-51,-2.96,1675,-49,-2.84,1673,1711
فاراك,ماشين‌ سازي‌ اراك‌,2114,106273956,170833045585,1683,1672,1599,-84,-4.99,1607,-76,-4.52,1599,1699
ولساپا,ليزينگ رايان‌ سايپا,2113,77143900,125442698218,1640,1642,1600,-40,-2.44,1626,-14,-0.85,1571,1694
سصفها,سيمان‌اصفهان‌,2100,4336063,235556991560,52610,54880,54640,2030,3.86,54330,1720,3.27,52610,54880
سيمرغ,سيمرغ,2070,12008314,323434984020,28540,28000,26830,-1710,-5.99,26930,-1610,-5.64,26830,28440
ضخود3058,اختيارخ خودرو-2500-1401/03/04,2064,102693,211408000,8,6,1,-7,-87.5,2,-6,-75,1,7
آرام,صندوق س شاخصي آرام مفيد,2052,11948349,132165797130,11260,11320,10990,-270,-2.4,11060,-200,-1.78,10970,11320
كماسه,تامين‌ ماسه‌ ريخته‌گري‌,1995,38273423,147830229702,3698,3840,3882,184,4.98,3862,164,4.43,3770,3882
اخابر,مخابرات ايران,1993,25574212,198498130800,8180,8000,7700,-480,-5.87,7760,-420,-5.13,7690,8150
وتوكا,سرمايه‌گذاري‌توكافولاد(هلدينگ,1982,21865418,223153715610,10200,10090,10400,200,1.96,10210,10,0.1,9910,10450
ولقمان,سرمايه گذاري لقمان,1964,9056464,44309196452,4763,4905,4905,142,2.98,4893,130,2.73,4621,4905
دسانكو,داروسازي سبحان انكولوژي,1950,10002228,113099971530,11740,11600,11280,-460,-3.92,11310,-430,-3.66,11160,12100
شيران,س. صنايع‌شيميايي‌ايران,1904,8918255,178287056580,20380,20400,19990,-390,-1.91,19990,-390,-1.91,19220,20900
ونوين,بانك‌اقتصادنوين‌,1881,43539530,167159419766,4021,4033,3820,-201,-5,3839,-182,-4.53,3820,4050
جم پيلن,پتروشيمي جم پيلن,1880,2183809,294817386190,138700,138710,134660,-4040,-2.91,135000,-3700,-2.67,132500,139500
فزرين,زرين معدن آسيا,1875,15738215,111620622800,7480,7570,7080,-400,-5.35,7090,-390,-5.21,7040,7600
كوير,توليدي فولاد سپيد فراب كوير,1865,25852531,109369573496,4418,4350,4250,-168,-3.8,4231,-187,-4.23,4198,4490
شفارس,صنايع‌ شيميايي‌ فارس‌,1853,47419635,66141514609,1430,1470,1398,-32,-2.24,1395,-35,-2.45,1345,1490
طلا,صندوق س.پشتوانه طلاي لوتوس,1839,1606796,161763399168,101852,101500,101280,-572,-0.56,100675,-1177,-1.16,99800,101500
بشهاب,لامپ‌  پارس‌ شهاب‌,1810,878338,80267034890,95810,95010,91020,-4790,-5,91390,-4420,-4.61,91020,96150
پتاير,ايران‌ تاير,1810,50095998,80125565500,1683,1668,1583,-100,-5.94,1599,-84,-4.99,1583,1700
ثفارس,عمران‌وتوسعه‌فارس‌,1808,16654022,111724014110,6530,6730,6500,-30,-0.46,6710,180,2.76,6420,6850
خنصير,مهندسي‌نصيرماشين‌,1798,7959927,128896773360,16870,16950,16030,-840,-4.98,16190,-680,-4.03,16030,17080
قچار,فراوردههاي غذايي وقند چهارمحال,1792,10599708,115717636940,11360,11420,10810,-550,-4.84,10920,-440,-3.87,10800,11420
فتوسا,توليد و توسعه سرب روي ايرانيان,1784,11678040,89029296550,7600,7690,7490,-110,-1.45,7620,20,0.26,7400,7870
ثرود,سرمايه‌گذاري مسكن زاينده رود,1771,11707421,145508341180,13170,12380,12380,-790,-6,12430,-740,-5.62,12380,12790
شجم,صنايع پتروشيمي تخت جمشيد,1753,15858497,187349021960,12370,12210,11760,-610,-4.93,11810,-560,-4.53,11760,12210
رنيك,جنرال مكانيك,1749,8076075,114295318040,13810,14170,13960,150,1.09,14150,340,2.46,13130,14500
فيروزا,صندوق ارمغان فيروزه آسيا-ثابت,1748,23347813,656909553422,28121,28136,28135,14,0.05,28136,15,0.05,28135,28137
ساينا,صنايع بهداشتي ساينا,1703,1457507,129318403300,88900,90300,89450,550,0.62,88750,-150,-0.17,83600,93800
غكورش,صنعت غذايي كورش,1693,3407462,154237322200,47290,47290,44930,-2360,-4.99,45260,-2030,-4.29,44930,47300
هرمز,فولاد هرمزگان جنوب,1688,5591310,92552652560,17180,17100,16570,-610,-3.55,16680,-500,-2.91,16330,17230
سخواف,سيمان مجد خواف,1671,14166770,121432015130,8440,8580,8680,240,2.84,8570,130,1.54,8190,8690
سدبير,س. تدبيرگران فارس وخوزستان,1663,4034027,122990256400,32200,32150,30300,-1900,-5.9,30500,-1700,-5.28,30300,32150
غچين,كشت‌ و صنعت‌ چين‌ چين,1639,12714901,163929056370,12370,12650,12980,610,4.93,12890,520,4.2,12300,12980
فروي,ذوب روي اصفهان,1631,5156821,87696144400,17960,18190,17100,-860,-4.79,17010,-950,-5.29,16890,18190
ملت,بيمه ملت,1628,82798616,105428294004,1340,1321,1271,-69,-5.15,1273,-67,-5,1260,1340
البرز,بيمه البرز,1616,79515374,189517646250,2448,2440,2400,-48,-1.96,2383,-65,-2.66,2314,2440
تليسه,دامداري تليسه نمونه,1616,21448065,97247392886,4733,4700,4450,-283,-5.98,4534,-199,-4.2,4450,4800
شبريزح,ح. پالايش نفت تبريز,1608,8363967,125184777130,15350,15350,15010,-340,-2.21,14970,-380,-2.48,14750,15500
زنجان,صنايع كشاورزي وكود زنجان,1590,16292315,68203063393,4191,4244,4152,-39,-0.93,4186,-5,-0.12,4066,4316
ثاخت,بين‌المللي‌توسعه‌ساختمان,1551,44396525,102900267867,2402,2400,2282,-120,-5,2318,-84,-3.5,2282,2460
ولراز,ليزينگ رازي,1541,3927681,108056507450,27800,27000,27050,-750,-2.7,27500,-300,-1.08,27000,28600
كقزوي,شيشه‌ قزوين‌,1538,39374586,596394240550,14710,15150,15150,440,2.99,15150,440,2.99,14730,15150
فرآور,فرآوري‌موادمعدني‌ايران‌,1534,3460671,115967526920,35490,34700,33370,-2120,-5.97,33510,-1980,-5.58,33370,35450
كزغال,زغال سنگ پروده طبس,1508,2673912,52617189900,20350,20100,20000,-350,-1.72,19700,-650,-3.19,19150,20200
بگيلان,توسعه مسير برق گيلان,1506,922241,12920368000,14550,14700,14010,-540,-3.71,14260,-290,-1.99,13830,14700
تملت,تامين سرمايه بانك ملت,1503,21102931,78620390706,3705,3782,3710,5,0.13,3726,21,0.57,3500,3900
تاپيكو,س. نفت و گاز و پتروشيمي تأمين,1502,10128611,167045039260,16860,17000,16400,-460,-2.73,16490,-370,-2.19,16290,17000
ختراك,ريخته‌گري‌ تراكتورسازي‌ ايران‌,1491,24534756,165075271470,6430,6750,6670,240,3.73,6730,300,4.67,6430,6750
درهآور,دارويي ره آورد تامين,1470,4662915,168306847500,34850,35600,36900,2050,5.88,36100,1250,3.59,34750,36900
فلوله,لوله‌وماشين‌سازي‌ايران‌,1464,43949778,89776938232,2121,2100,2015,-106,-5,2043,-78,-3.68,2015,2199
ضخود3057,اختيارخ خودرو-2000-1401/03/04,1454,69399,17599157000,350,330,228,-122,-34.86,254,-96,-27.43,214,335
كگل,معدني و صنعتي گل گهر,1448,7923715,107799871160,13830,14000,13700,-130,-0.94,13620,-210,-1.52,13260,14000
خكار,ايركا پارت صنعت,1443,28227363,76035446594,2797,2783,2680,-117,-4.18,2694,-103,-3.68,2630,2840
ورنا,سرمايه‌گذاري‌ رنا(هلدينگ‌,1436,42320490,246559224330,6180,5880,5810,-370,-5.99,5830,-350,-5.66,5810,6020
چكاپا,گروه صنايع كاغذ پارس,1419,23113082,76262934803,3421,3422,3250,-171,-5,3300,-121,-3.54,3250,3530
ضسپا3016,اختيارخ خساپا-2500-1401/03/25,1411,75897,947108000,27,19,16,-11,-40.74,12,-15,-55.56,9,21
كهمدا,شيشه‌ همدان‌,1405,15928896,203545550040,13200,13150,13000,-200,-1.52,12780,-420,-3.18,12430,13210
اپال,فرآوري معدني اپال كاني پارس,1396,1587180,32187969450,20750,20470,20400,-350,-1.69,20620,-130,-0.63,19930,20950
لطيف,محصولات كاغذي لطيف,1396,688069,30913416050,46450,45600,45000,-1450,-3.12,44950,-1500,-3.23,44150,47300
شاراك,پتروشيمي شازند,1395,2478457,115245519530,46930,47500,46200,-730,-1.56,46500,-430,-0.92,45880,47950
قلرست,قند لرستان‌,1394,2855877,69250314050,24960,25530,23720,-1240,-4.97,24250,-710,-2.84,23720,25530
بجهرم,توسعه مولد نيروگاهي جهرم,1386,35570190,82273207741,2419,2400,2300,-119,-4.92,2313,-106,-4.38,2299,2430
فگستر,گسترش صنايع روي ايرانيان,1383,3394821,25939789670,7900,7890,7670,-230,-2.91,7640,-260,-3.29,7510,8090
پيزد,مجتمع صنايع لاستيك يزد,1375,2613934,33518499320,13400,13390,12860,-540,-4.03,12820,-580,-4.33,12730,13390
چخزر,صنايع چوب خزر كاسپين,1368,1227512,37207849200,31750,31750,30200,-1550,-4.88,30300,-1450,-4.57,30200,31750
آگاس,صندوق س.هستي بخش آگاه-س,1363,2035296,176758272036,88713,89489,86500,-2213,-2.49,86846,-1867,-2.1,86050,89489
شكربن,كربن‌ ايران‌,1361,21914843,86828094514,4150,4072,3943,-207,-4.99,3962,-188,-4.53,3943,4110
خموتور,موتورسازان‌تراكتورسازي‌ايران‌,1356,36596921,171677473095,4470,4693,4693,223,4.99,4691,221,4.94,4513,4693
كيسون,شركت كيسون,1354,55065857,92307350207,1697,1722,1684,-13,-0.77,1676,-21,-1.24,1648,1722
غمارگ,مارگارين‌,1351,34438158,113410021546,3484,3450,3275,-209,-6,3293,-191,-5.48,3275,3495
سرو,صندوق س سروسودمند مدبران-سهام,1347,2424791,188891361590,80290,80680,77710,-2580,-3.21,77900,-2390,-2.98,77000,80680
فاسمين,كالسيمين‌,1340,6903584,143020834220,21270,21080,21010,-260,-1.22,20720,-550,-2.59,20380,21390
كسرا,سراميك‌هاي‌صنعتي‌اردكان‌,1330,27819474,207740586770,7360,7270,7320,-40,-0.54,7470,110,1.49,7220,7600
ماديرا,صنايع ماديران,1324,18610211,62411635990,3473,3514,3300,-173,-4.98,3354,-119,-3.43,3300,3570
اعتلا,شركت سرمايه گذاري اعتلاء البرز,1323,24789579,110819866823,4223,4439,4476,253,5.99,4470,247,5.85,4302,4476
دتوليد,داروسازي توليد دارو,1318,8334975,80063203200,9920,9900,9350,-570,-5.75,9610,-310,-3.13,9330,10130
غاذر,كشت‌وصنعت‌پياذر,1315,2213413,125344305400,56780,59550,56090,-690,-1.22,56630,-150,-0.26,55130,59550
وتوصا,گروه س توسعه صنعتي ايران,1313,6721419,68878842140,10760,10500,10120,-640,-5.95,10250,-510,-4.74,10120,10820
فسرب,ملي‌ سرب‌وروي‌ ايران‌,1308,33149597,58176147447,1839,1849,1748,-91,-4.95,1755,-84,-4.57,1748,1849
وسينا,بانك سينا,1307,63425228,155289090664,2587,2614,2432,-155,-5.99,2448,-139,-5.37,2432,2614
غمينو,شركت صنايع غذايي مينو شرق,1299,10733721,65167707880,5950,6200,6020,70,1.18,6070,120,2.02,5750,6300
كارا,صندوق س. كارا -د,1294,70370915,801238891208,11379,11385,11386,7,0.06,11386,7,0.06,11385,11387
امين,تامين سرمايه امين,1288,905108,9749058440,10770,10770,10770,0,0,10770,0,0,10770,10780
وبانك,سرمايه گذاري گروه توسعه ملي,1281,16036704,164215135770,10680,10680,10240,-440,-4.12,10240,-440,-4.12,10040,10680
بخاور,بيمه زندگي خاورميانه,1277,20558103,54447362041,2598,2680,2640,42,1.62,2648,50,1.92,2519,2729
زنگان,صنعت روي زنگان,1255,1661235,91013617450,57050,59950,53650,-3400,-5.96,54800,-2250,-3.94,53650,59950
آبادا,توليد نيروي برق آبادان,1249,2111439,25949451210,12800,12950,12160,-640,-5,12290,-510,-3.98,12160,12950
شسپا,نفت سپاهان,1247,21636946,72429879306,3411,3450,3340,-71,-2.08,3350,-61,-1.79,3274,3475
شغدير,پتروشيمي غدير,1231,805180,75102864630,94700,95780,93200,-1500,-1.58,93270,-1430,-1.51,92520,95780
شپديس,پتروشيمي پرديس,1215,969488,171986862420,177890,179000,175700,-2190,-1.23,177400,-490,-0.28,175500,179100
ولشرق,ليزينگ ايران و شرق,1212,26008308,62564213786,2289,2426,2426,137,5.99,2406,117,5.11,2300,2426
تسه9904,امتياز تسهيلات مسكن تير99,1212,14654,17722725259,1251790,1189201,1191000,-60790,-4.86,1209412,-42378,-3.39,1189201,1314000
سهرمز,سيمان‌هرمزگان‌,1212,4389026,94776363480,21600,21600,22050,450,2.08,21590,-10,-0.05,21040,22070
كپارس,كاشي‌ پارس‌,1204,12595141,134992683890,11030,10650,10480,-550,-4.99,10720,-310,-2.81,10480,11010
غصينو,صنعتي مينو,1200,5673937,89701050680,16500,16610,15680,-820,-4.97,15810,-690,-4.18,15680,16610
كرازي,كارخانجات‌توليدي‌شيشه‌رازي‌,1192,40101333,65658120055,1673,1650,1600,-73,-4.36,1637,-36,-2.15,1577,1699
مفاخر,توسعه فناوري اطلاعات خوارزمي,1192,1965569,100012642750,53350,54000,51200,-2150,-4.03,50900,-2450,-4.59,50150,54200
بالاس,مهندسي ساختمان تاسيسات راه آهن,1188,1778862,53623541850,31350,32550,29800,-1550,-4.94,30150,-1200,-3.83,29800,32550
كيميا,معدني كيمياي زنجان گستران,1180,6774395,46326016520,7030,7190,6840,-190,-2.7,6840,-190,-2.7,6620,7200
ونيرو,سرمايه‌گذاري‌نيرو,1176,30566390,85027671989,2931,2980,2757,-174,-5.94,2782,-149,-5.08,2756,2999
شسينا,صنايع‌شيميايي‌سينا,1169,21439600,43474813031,2105,2080,2000,-105,-4.99,2028,-77,-3.66,2000,2129
اهرم,صندوق س سهامي كاريزما- اهرمي,1148,10036285,141526245340,14420,14240,13890,-530,-3.68,14100,-320,-2.22,13600,14790
كحافظ,كاشي‌ وسراميك‌ حافظ‌,1137,12225567,60676339451,5121,5002,5000,-121,-2.36,4963,-158,-3.09,4865,5193
خشرق,الكتريك‌ خودرو شرق‌,1132,6205461,94049341170,15030,15750,14860,-170,-1.13,15160,130,0.86,14370,15750
ورازي,بيمه رازي,1126,53759079,109195946535,2088,2040,2026,-62,-2.97,2031,-57,-2.73,2026,2088
تسه1400,امتيازتسهيلات مسكن سال1400,1123,32912,39126523406,1248524,1186098,1200000,-48524,-3.89,1188822,-59702,-4.78,1186098,1230000
پاكشو,گروه صنعتي پاكشو,1121,6891469,46452482890,6740,6850,6680,-60,-0.89,6740,0,0,6500,6970
وپويا,سرمايه گذاري پويا,1116,15928460,37916273586,2360,2233,2351,-9,-0.38,2380,20,0.85,2233,2492
ثالوند,سرمايه گذاري مسكن الوند,1110,13875188,107625358590,7480,7650,7920,440,5.88,7760,280,3.74,7060,7920
سپيدما,صندوق س. سپيد دماوند-د,1107,52446258,661529426104,12599,12614,12613,14,0.11,12613,14,0.11,12613,12619
خاذين,سايپاآذين‌,1107,28520598,57440747966,2097,2112,1995,-102,-4.86,2014,-83,-3.96,1993,2112
ثمسكن,سرمايه‌گذاري‌ مسكن‌,1103,28910933,117204102530,4171,4350,4100,-71,-1.7,4054,-117,-2.81,3921,4350
ستران,سيمان‌ تهران‌,1100,3041784,82137243650,27510,27970,26730,-780,-2.84,27000,-510,-1.85,25860,28800
پارسيان,بيمه پارسيان,1091,47543412,170144092634,3791,3815,3565,-226,-5.96,3579,-212,-5.59,3564,3819
تاپكيش,تجارت الكترونيك پارسيان كيش,1074,5023969,68811125000,14450,14050,13590,-860,-5.95,13700,-750,-5.19,13590,14490
ونفت,سرمايه‌گذاري‌ صنعت‌ نفت‌,1072,16190213,70515863093,4601,4561,4325,-276,-6,4355,-246,-5.35,4325,4600
ولكار,ليزينگ كارآفرين,1070,829792,5346306680,6470,6470,6520,50,0.77,6460,-10,-0.15,6400,6610
فسازان,غلتك سازان سپاهان,1064,9841161,57151000190,5940,5940,5830,-110,-1.85,5810,-130,-2.19,5650,6090
وپست,پست بانك ايران,1064,20039187,81808087045,4153,4200,4020,-133,-3.2,4082,-71,-1.71,3980,4240
حگردش,ريل گردش ايرانيان,1054,20285509,54171578238,2748,2735,2666,-82,-2.98,2670,-78,-2.84,2666,2785
غدشت,دشت‌ مرغاب‌,1053,4136571,69636115370,17600,17760,17050,-550,-3.13,16830,-770,-4.38,16720,17760
ثغرب,شركت سرمايه گذاري مسكن شمالغرب,1053,34011918,162988566455,4524,4795,4795,271,5.99,4792,268,5.92,4700,4795
قشرين,قند شيرين خراسان,1052,10804345,58563847160,5500,5590,5340,-160,-2.91,5420,-80,-1.45,5340,5650
واحصا,احياء صنايع خراسان,1049,1427640,145889423250,105200,102050,102050,-3150,-2.99,102200,-3000,-2.85,102050,103700
آسيا,بيمه آسيا,1049,56131396,103085624886,1830,1830,1866,36,1.97,1837,7,0.38,1790,1920
زدشت,كشت و صنعت دشت خرم دره,1044,4939975,128100856650,27250,25700,25650,-1600,-5.87,25950,-1300,-4.77,25650,26850
خلنت,لنت‌ ترمزايران‌,1042,1283853,44575034360,34410,34870,35250,840,2.44,34720,310,0.9,33250,35730
وملي,گروه‌ صنعتي‌ ملي‌ (هلدينگ‌,1033,373007,55253178440,154330,152000,146620,-7710,-5,148130,-6200,-4.02,146620,155390
لپيام,گسترش صنايع پيام,1031,2837008,67247084500,23100,23750,23750,650,2.81,23700,600,2.6,23150,23750
وسنا,سرمايه گذاري نيروگاهي ايران,1025,22921743,231584733960,10200,10500,9930,-270,-2.65,10100,-100,-0.98,9900,10500
تاصيكو,سرمايه گذاري صدرتامين,1019,10113748,109157782740,11080,10860,10730,-350,-3.16,10800,-280,-2.53,10590,11090
زگلدشت,كشت و دام گلدشت نمونه اصفهان,1013,5656458,61867911480,11510,11350,10820,-690,-5.99,10940,-570,-4.95,10820,11620
كساوه,صنايع‌ كاشي‌ و سراميك‌ سينا,1012,3715869,182566435350,51850,52350,49300,-2550,-4.92,49130,-2720,-5.25,48740,52980
وسبحان,سرمايه گذاري سبحان,1007,23392715,89945542014,3862,3851,3799,-63,-1.63,3845,-17,-0.44,3712,4060
خريخت,صنايع‌ريخته‌گري‌ايران‌,1005,48775018,164714581713,3218,3378,3378,160,4.97,3377,159,4.94,3300,3378
غديس,پاكديس,999,5431865,65923470800,12810,12610,12060,-750,-5.85,12140,-670,-5.23,12050,13050
فولاي,صنايع فولاد آلياژي يزد,994,9716594,91391913790,9780,9990,9450,-330,-3.37,9410,-370,-3.78,9200,9990
رانفور,خدمات‌انفورماتيك‌,983,22363701,96091814629,4284,4251,4330,46,1.07,4297,13,0.3,4180,4350
پارسان,گسترش نفت و گاز پارسيان,978,7526302,227159180320,31020,31030,30800,-220,-0.71,30180,-840,-2.71,29870,31200
كاوه,فولاد كاوه جنوب كيش,977,4000845,51563416430,13200,13000,12770,-430,-3.26,12990,-210,-1.59,12600,13300
شصدف,صنعتي دوده فام,973,1656023,56941937400,35850,35400,34100,-1750,-4.88,34400,-1450,-4.04,34100,35850
ونيكي,سرمايه‌گذاري‌ ملي‌ايران‌,968,9673555,95787899680,10180,10200,9830,-350,-3.44,9900,-280,-2.75,9720,10200
ومهان,گروه توسعه مالي مهر آيندگان,967,21320398,119482029580,5770,5780,5590,-180,-3.12,5600,-170,-2.95,5490,5780
شبصير,توليدات پتروشيمي قائد بصير,965,573591,66614426350,119350,120800,114750,-4600,-3.85,116150,-3200,-2.68,114200,120800
سپاها,سيمان‌سپاهان‌,962,6385567,65310129730,10730,10740,10090,-640,-5.96,10230,-500,-4.66,10090,10910
تيپيكو,سرمايه گذاري دارويي تامين,961,10240106,223005106860,22840,22700,21670,-1170,-5.12,21780,-1060,-4.64,21470,22940
خاهن,آهنگري‌ تراكتورسازي‌ ايران‌,959,10140260,61702863350,6420,6500,6040,-380,-5.92,6080,-340,-5.3,6040,6500
فسپا,گروه‌صنعتي‌سپاهان‌,956,5296618,84234274580,16620,16840,15810,-810,-4.87,15900,-720,-4.33,15790,16840
سفار,سيمان‌فارس‌,946,2623524,228005441040,82830,86970,86970,4140,5,86910,4080,4.93,85200,86970
وصنعت,سرمايه گذاري توسعه صنعت وتجارت,946,17377954,40191561571,2359,2400,2324,-35,-1.48,2313,-46,-1.95,2240,2403
تمحركه,ماشين سازي نيرو محركه,944,3749506,46374430480,12420,12660,12180,-240,-1.93,12370,-50,-0.4,12180,12660
سشرق,سيمان‌ شرق‌,943,6746568,60496578670,9220,9160,8850,-370,-4.01,8970,-250,-2.71,8750,9330
كرماشا,صنايع پتروشيمي كرمانشاه,943,1593778,104483398540,66300,67100,65170,-1130,-1.7,65560,-740,-1.12,64840,67100
گشان,توسعه بين المللي پديده شانديز,943,2709977,55640622300,20900,21100,20300,-600,-2.87,20550,-350,-1.67,20300,21250
كبافق,معادن‌ بافق‌,940,1596880,60901730050,39980,39510,37990,-1990,-4.98,38140,-1840,-4.6,37990,39510
غشهداب,كشت و صنعت شهداب ناب خراسان,939,15074783,42284920210,2927,2902,2752,-175,-5.98,2805,-122,-4.17,2752,2979
دبالك,مواد اوليه دارويي البرز بالك,936,4513995,47383604330,10270,10880,10310,40,0.39,10500,230,2.24,10140,10880
شلعاب,لعابيران‌,934,7457898,47146480920,6580,6660,6260,-320,-4.86,6320,-260,-3.95,6260,6780
وآفر,سرمايه گذاري ارزش آفرينان,929,13767915,448519588900,32400,33350,31450,-950,-2.93,32600,200,0.62,31450,33350
ثنور,سرمايه گذاري كوه نور,928,6076219,48091506940,8110,8230,7870,-240,-2.96,7910,-200,-2.47,7870,8230
غويتا,ويتانا,927,7916343,43275256960,5710,5580,5430,-280,-4.9,5470,-240,-4.2,5430,5790
بكاب,صنايع‌جوشكاب‌يزد,922,515807,34988129550,70900,69990,67360,-3540,-4.99,67830,-3070,-4.33,67360,70840
آكورد,صندوق س. آرمان آتي كوثر-د,921,7965681,309423831977,38822,38844,38845,23,0.06,38845,23,0.06,38844,38847
آپ,آسان پرداخت پرشين,918,6581796,46994648950,7390,7490,7030,-360,-4.87,7140,-250,-3.38,7030,7490
واحيا,م .صنايع و معادن احياء سپاهان,917,8952922,177676915620,20380,20030,19850,-530,-2.6,19850,-530,-2.6,19770,20300
حپترو,حمل و نقل پتروشيمي( سهامي عام,916,1478096,37661807100,25890,26970,25000,-890,-3.44,25480,-410,-1.58,24600,26970
هجرت,پخش هجرت,915,3301369,103449732800,32550,32800,31500,-1050,-3.23,31350,-1200,-3.69,30950,32800
افق,فروشگاههاي زنجيره اي افق كوروش,915,1275804,60360946080,49380,49320,46920,-2460,-4.98,47310,-2070,-4.19,46920,49330
ماديراح,ح صنايع ماديران,897,12780169,21609781822,1761,1750,1673,-88,-5,1691,-70,-3.98,1673,1753
غپينو,پارس‌ مينو,893,17232448,45303394439,2769,2778,2603,-166,-5.99,2629,-140,-5.06,2603,2780
قاسم,قاسم ايران,889,12244396,56607482290,4820,4750,4690,-130,-2.7,4620,-200,-4.15,4580,4920
وملل,اعتباري ملل,888,6526260,51661534210,7990,8190,7960,-30,-0.38,7920,-70,-0.88,7600,8280
خمحركه,نيرو محركه‌,887,12036201,48963694874,4288,4210,4031,-257,-5.99,4068,-220,-5.13,4031,4280
ثبات,صندوق س. ثبات ويستا -د,880,37293263,432336163131,11586,11592,11593,7,0.06,11593,7,0.06,11592,11593
خرينگ,رينگ‌سازي‌مشهد,875,3131208,74411068560,24850,25000,23610,-1240,-4.99,23760,-1090,-4.39,23610,25230
بهپاك,صنعتي بهپاك,874,17944615,138323413760,7680,7840,7700,20,0.26,7710,30,0.39,7540,7970
ركيش,كارت اعتباري ايران كيش,871,9135907,47740235230,5460,5420,5200,-260,-4.76,5230,-230,-4.21,5190,5580
وصنا,گروه‌صنايع‌بهشهرايران‌,867,17468446,60403835368,3650,3600,3431,-219,-6,3458,-192,-5.26,3431,3680
فگسترح,ح . گسترش صنايع روي ايرانيان,865,585437,2821037166,4906,4890,4770,-136,-2.77,4819,-87,-1.77,4740,5000
دلقما,دارويي‌ لقمان‌,858,22260302,46231428031,2167,2178,2114,-53,-2.45,2077,-90,-4.15,2059,2210
ومعلم,بيمه معلم,857,14459682,32561077004,2184,2179,2271,87,3.98,2252,68,3.11,2123,2293
ثنوسا,نوسازي‌وساختمان‌تهران‌,855,10288188,51655760570,5240,5300,4980,-260,-4.96,5020,-220,-4.2,4980,5300
بكام,كارخانجات توليدي شهيد قندي,853,22589949,42965625568,2001,2036,1889,-112,-5.6,1902,-99,-4.95,1881,2036
اطلس,صندوق س.توسعه اطلس مفيد-س,851,405623,112141205286,282848,283899,276100,-6748,-2.39,276467,-6381,-2.26,274601,283899
نتوس,پشم‌ بافي‌ توس,849,4233440,43643025440,10130,10390,10430,300,2.96,10310,180,1.78,10040,10430
پلاست,كارخانجات توليدي پلاستيران,849,3946865,64317500150,16300,16780,16780,480,2.94,16300,0,0,15820,16780
كامياب,صندوق س. كامياب آشنا-د,849,17063235,206678959352,12106,12113,12113,7,0.06,12113,7,0.06,12112,12114
وسپه,سرمايه‌گذاري‌ سپه‌,845,4364419,39137955590,9090,9110,8940,-150,-1.65,8980,-110,-1.21,8800,9180
گكوثر,هتل پارسيان كوثر اصفهان,834,24652244,41304643305,1772,1721,1666,-106,-5.98,1675,-97,-5.47,1666,1751
شگل,گلتاش‌,833,7742423,47628637090,6290,6360,6000,-290,-4.61,6150,-140,-2.23,5940,6580
فوكا,فولاد كاويان,832,6292985,95064716870,15470,15550,15110,-360,-2.33,15110,-360,-2.33,15010,15640
دلر,داروسازي‌ اكسير,829,1738686,78782820200,46130,46880,45310,-820,-1.78,45310,-820,-1.78,44000,47300
زماهان,مجتمع توليد گوشت مرغ ماهان,827,6524452,59179793860,9510,9530,8940,-570,-5.99,9070,-440,-4.63,8940,9530
وهنر,گروه توسعه هنر ايران,826,14360592,34991405964,2389,2389,2401,12,0.5,2437,48,2.01,2341,2460
وثوق,سرمايه گذاري وثوق امين,825,10528407,88045255910,8150,8340,8390,240,2.94,8360,210,2.58,7930,8390
شپتروح,ح . پتروشيمي آبادان,824,54186231,58257305613,1108,1075,1075,-33,-2.98,1075,-33,-2.98,1075,1104
ميهن,بيمه ميهن,823,19200046,67990607984,3664,3700,3481,-183,-4.99,3541,-123,-3.36,3481,3789
شپلي,پلي اكريل ايران,823,7016961,55383797240,8020,7990,7780,-240,-2.99,7890,-130,-1.62,7780,8200
فپنتا,سپنتا,821,84564,57481652980,689560,691000,659800,-29760,-4.32,679740,-9820,-1.42,659000,720000
زفكا,كشت و دامداري فكا,821,9702588,102345007440,11180,11000,10510,-670,-5.99,10550,-630,-5.64,10510,11180
نوين,بيمه نوين,819,13441966,27865816650,2188,2210,2073,-115,-5.26,2073,-115,-5.26,2057,2210
تبرك,گروه كارخانجات صنعتي تبرك,817,8423374,80987694390,10100,10000,9600,-500,-4.95,9610,-490,-4.85,9600,10000
ثباغ,شهر سازي و خانه سازي باغميشه,816,5831757,47951976470,8660,8670,8180,-480,-5.54,8220,-440,-5.08,8150,8780
وبشهر,توسعه‌ صنايع‌ بهشهر(هلدينگ,815,10293049,87686539070,9010,9060,8490,-520,-5.77,8520,-490,-5.44,8470,9100
حتايد,تايدواترخاورميانه,813,9197582,53838314990,5970,5900,5800,-170,-2.85,5850,-120,-2.01,5660,6040
فنوال,نورد آلومينيوم‌,813,3068779,98840853590,33580,33970,31710,-1870,-5.57,32210,-1370,-4.08,31570,34140
كمرجان,بازرگاني و توليدي مرجان كار,808,8434734,52003165030,6490,6400,6110,-380,-5.86,6170,-320,-4.93,6110,6560
سدشت,صنايع سيمان دشتستان,807,1580923,53166443000,32270,33880,33650,1380,4.28,33630,1360,4.21,31780,33880
وآوا,سرمايه گذاري آوا نوين,802,9231394,33440507084,3810,3799,3582,-228,-5.98,3622,-188,-4.93,3582,3898
زمگسا,كشاورزي‌ ودامپروي‌ مگسال‌,800,2173327,56637928680,27250,26400,25890,-1360,-4.99,26060,-1190,-4.37,25890,27670
دكوثر,داروسازي‌ كوثر,798,12908945,46857660490,3782,3796,3600,-182,-4.81,3630,-152,-4.02,3556,3939
قشير,قند شيروان قوچان و بجنورد,796,5354061,36790512080,7200,7300,6810,-390,-5.42,6870,-330,-4.58,6770,7450
فافزا,فولاد افزا سپاهان,788,896411,48580991550,52850,54400,54400,1550,2.93,54200,1350,2.55,52850,54400
شخارك,پتروشيمي‌ خارك‌,787,1691346,79629971950,47690,47700,47200,-490,-1.03,47170,-520,-1.09,45900,47710
جم,پتروشيمي جم,779,1562417,73551122830,47940,48690,46950,-990,-2.07,47280,-660,-1.38,46250,48690
رافزا,رايان هم افزا,778,409295,22342176750,57150,56600,54300,-2850,-4.99,54600,-2550,-4.46,54300,58000
خفناور,مهندسي صنعتي روان فن آور,778,2309085,79071872550,33300,34250,34250,950,2.85,34250,950,2.85,33950,34250
ضستا7003,اختيارخ شستا-1000-1401/07/17,775,39548,6547553000,183,181,168,-15,-8.2,166,-17,-9.29,160,181
زبينا,كشاورزي و دامپروري بينالود,767,12934965,42501389308,3453,3460,3246,-207,-5.99,3286,-167,-4.84,3246,3460
همراه,شركت ارتباطات سيار ايران,766,6730291,66325175170,10090,10000,9960,-130,-1.29,9960,-130,-1.29,9710,10090
مدير,ص.س.مديريت ثروت ص.بازنشستگي-س,764,5206919,58531361745,11329,11480,11129,-200,-1.77,11241,-88,-0.78,11022,11480
توريل,توكاريل,764,5971977,53758433290,9440,9440,8970,-470,-4.98,9000,-440,-4.66,8970,9440
زپارس,ملي كشت و صنعت و دامپروري پارس,763,2895759,105824157290,37190,37120,36980,-210,-0.56,36540,-650,-1.75,35350,38000
شمواد,توليد مواداوليه الياف مصنوعي,763,947084,70862877500,74450,75900,73000,-1450,-1.95,74800,350,0.47,73000,75900
بنو,بيمه تجارت نو,762,5800413,35145277570,6270,6310,5960,-310,-4.94,6060,-210,-3.35,5960,6380
پسهند,صنايع‌ لاستيكي‌  سهند,750,1831424,66177946140,34510,34570,36230,1720,4.98,36130,1620,4.69,34570,36230
حسير,ريل سير كوثر,748,2231183,43677750200,20450,20200,19250,-1200,-5.87,19600,-850,-4.16,19250,20650
ثزاگرس,سرمايه گذاري توسعه عمران زاگرس,744,1487837,48297138450,32300,31900,33250,950,2.94,32450,150,0.46,31350,33250
دزهراوي,داروسازي‌زهراوي‌,744,10014548,50932288990,5310,5390,5120,-190,-3.58,5090,-220,-4.14,5050,5410
ضخود4011,اختيارخ خودرو-2000-1401/04/08,733,32610,10934934000,439,404,320,-119,-27.11,335,-104,-23.69,311,423
تكشا,گسترش‌صنايع‌وخدمات‌كشاورزي‌,730,1456709,53057701400,37760,36380,36900,-860,-2.28,36420,-1340,-3.55,35880,39600
اتكام,بيمه اتكايي امين,726,14825469,62824851276,4334,4286,4340,6,0.14,4238,-96,-2.22,4118,4390
حآفرين,ريل پرداز نو آفرين,725,10265569,37903380659,3869,3860,3685,-184,-4.76,3692,-177,-4.57,3676,3900
پخش,پخش البرز,717,2081690,71804724850,35100,35600,34400,-700,-1.99,34500,-600,-1.71,33350,35600
ضسپا3015,اختيارخ خساپا-2000-1401/03/25,712,31951,4814537000,224,205,150,-74,-33.04,151,-73,-32.59,135,205
والبر,سرمايه‌ گذاري‌ البرز(هلدينگ‌,704,6147168,43787141920,7340,7480,6990,-350,-4.77,7120,-220,-3,6940,7480
لسرما,سرما آفرين‌,700,1774741,47941171690,27560,26500,26190,-1370,-4.97,27010,-550,-2,26190,28120
خودكفا,اقتصادي و خودكفايي آزادگان,698,7061317,53902928870,7800,7740,7570,-230,-2.95,7630,-170,-2.18,7570,7940
ثتران,سرمايه گذاري مسكن تهران,695,12718180,42100149029,3460,3499,3288,-172,-4.97,3310,-150,-4.34,3287,3499
غشصفا,شيرپاستوريزه‌پگاه‌اصفهان‌,694,1058563,21896153960,21820,21600,20520,-1300,-5.96,20680,-1140,-5.22,20520,21600
رمپنا,گروه مپنا (سهامي عام),691,4275230,70854011800,17150,17150,16680,-470,-2.74,16800,-350,-2.04,16230,17350
كارين,صندوق س نگين سامان-ثابت,684,23769456,238024400228,10008,10015,10017,9,0.09,10014,6,0.06,10011,10017
غگيلا,شيرپاستوريزه پگاه گيلان,683,1332176,20611185020,16150,15880,15350,-800,-4.95,15470,-680,-4.21,15350,16380
بنيرو,نيروترانس‌,680,19816693,48276396821,2443,2450,2520,77,3.15,2436,-7,-0.29,2351,2520
سنوين,سرمايه گذاري اقتصاد نوين,676,7646122,48657557970,6360,6290,6170,-190,-2.99,6360,0,0,6170,6550
سكرما,سيمان‌ كرمان‌,670,4131461,55093673520,13220,13440,13520,300,2.27,13340,120,0.91,12680,13580
شفن,پتروشيمي فناوران,669,3069343,36732970910,12330,12330,12020,-310,-2.51,12220,-110,-0.89,11600,12330
بكهنوج,توليد برق ماهتاب كهنوج,667,23313123,27392683739,1230,1206,1169,-61,-4.96,1175,-55,-4.47,1169,1210
تپكو,توليدتجهيزات‌سنگين‌هپكو,665,16997794,29246543249,1765,1731,1713,-52,-2.95,1721,-44,-2.49,1713,1738
وامير,گروه صنعتي و معدني امير,662,35057,13292801500,379350,370550,375000,-4350,-1.15,379200,-150,-0.04,368000,387000
قزوين,كارخانجات‌ قند قزوين‌,659,6959196,37492654830,5500,5650,5270,-230,-4.18,5390,-110,-2,5230,5700
دفارا,داروسازي‌ فارابي‌,659,3314385,44457707960,14030,13510,13330,-700,-4.99,13410,-620,-4.42,13330,14000
سامان,بانك سامان,657,25743636,91409831592,3499,3501,3603,104,2.97,3551,52,1.49,3395,3603
فروس,فروسيليس‌ ايران‌,654,5087519,37572116050,7600,7700,7400,-200,-2.63,7390,-210,-2.76,7250,7700
تماوند,تامين سرمايه دماوند,654,15991594,87241559700,5720,5670,5440,-280,-4.9,5460,-260,-4.55,5440,5700
زكوثر,سرمايه گذاري كشاورزي كوثر,650,1795291,29899172690,17310,17020,16280,-1030,-5.95,16650,-660,-3.81,16280,17300
ميدكو,توسعه معادن وص.معدني خاورميانه,650,3676018,167507851420,45540,45550,45550,10,0.02,45570,30,0.07,45500,46000
غشان,شيرپاستوريزه‌پگاه‌خراسان‌,650,6148508,25721995275,4389,4300,4159,-230,-5.24,4183,-206,-4.69,4126,4440
تسه0011,امتيازتسهيلات مسكن بهمن 1400,648,11300,13517108071,1238648,1176800,1176717,-61931,-5,1196204,-42444,-3.43,1176716,1300580
آباد,توريستي ورفاهي آبادگران ايران,644,1052389,35106111800,34950,34600,33210,-1740,-4.98,33360,-1590,-4.55,33210,34600
شبهرن,نفت‌ بهران‌,642,3362685,48240268180,14660,14700,14340,-320,-2.18,14440,-220,-1.5,14100,14750
حريل,ريل پردازسير,642,9677794,27091490275,2840,2896,2800,-40,-1.41,2799,-41,-1.44,2749,2924
نيرو,نيرو سرمايه,641,2978415,75809314500,24900,25000,25600,700,2.81,25450,550,2.21,24350,25600
كشرق,صنعتي و معدني شمال شرق شاهرود,639,338342,33170580800,96750,97600,98800,2050,2.12,98050,1300,1.34,96750,101900
پلاسك,پلاسكوكار,636,13756927,43774933179,3341,3250,3174,-167,-5,3182,-159,-4.76,3174,3330
شكام,صنايع شيميايي كيمياگران امروز,631,1697576,58238199850,34700,35500,34700,0,0,34300,-400,-1.15,33500,35500
ثجوان,تامين مسكن جوانان,631,9627241,42666014748,4545,4680,4409,-136,-2.99,4432,-113,-2.49,4409,4680
تكمبا,كمباين‌ سازي‌ ايران‌,629,10826235,46632269137,4553,4531,4280,-273,-6,4307,-246,-5.4,4280,4700
خصدرا,صنعتي‌ دريايي‌ ايران‌,629,18033670,35843808115,2040,2018,1979,-61,-2.99,1988,-52,-2.55,1979,2025
وبوعلي,سرمايه‌گذاري‌بوعلي‌,627,7604951,39199474930,5230,5240,5200,-30,-0.57,5150,-80,-1.53,5030,5350
سحرخيز,صندوق س. گروه زعفران سحرخيز,626,1785000,33771962726,18832,18925,18990,158,0.84,18920,88,0.47,18726,19220
ولپارس,ليزينگ پارسيان,624,2934333,9821870745,3462,3420,3289,-173,-5,3381,-81,-2.34,3289,3460
ارزش,صندوق س ارزش آفرين بيدار-سهام,623,4846459,53922642960,11430,11360,11190,-240,-2.1,11130,-300,-2.62,10900,11480
دحاوي,الحاوي,619,3091177,18664689330,6020,6170,6030,10,0.17,6040,20,0.33,5910,6200
شدوص,دوده‌ صنعتي‌ پارس‌,615,2845815,34937384830,12780,12880,12300,-480,-3.76,12280,-500,-3.91,12150,12980
كروي,توسعه‌ معادن‌ روي‌ ايران‌,615,3181280,81676198660,26460,26050,26000,-460,-1.74,25670,-790,-2.99,25200,26900
فنرژي,گسترش صنايع انرژي آذرآب,613,3259984,25952903910,7850,8000,8000,150,1.91,7960,110,1.4,7710,8000
غگلستا,شير پاستوريزه پگاه گلستان,612,3221113,37435197350,12200,12010,11510,-690,-5.66,11620,-580,-4.75,11470,12300
كپرور,فرآوري زغال سنگ پروده طبس,610,2766620,29894931000,11250,11400,10800,-450,-4,10810,-440,-3.91,10690,11400
زشريف,كشت وصنعت شريف آباد,609,7640568,32747496620,4504,4540,4234,-270,-5.99,4286,-218,-4.84,4234,4540
چكارن,كارتن‌ ايران‌,601,15845123,47315586296,3120,3079,2964,-156,-5,2986,-134,-4.29,2964,3080
دماوند,توليد نيروي برق دماوند,596,1736344,34917581600,20850,21200,19850,-1000,-4.8,20250,-600,-2.88,19850,21250
وبيمه,سرمايه‌ گذاري‌ صنعت‌ بيمه‌,595,10936768,19110221129,1833,1830,1724,-109,-5.95,1747,-86,-4.69,1724,1856
دسبحا,گروه دارويي سبحان,595,1980368,37928159740,19270,19410,18500,-770,-4,19150,-120,-0.62,18320,19770
حآسا,آسيا سير ارس,593,2539899,36031908230,14860,14960,13970,-890,-5.99,14190,-670,-4.51,13970,14960
مداران,داده‌پردازي‌ايران‌,593,1556085,30079922030,19640,20080,19900,260,1.32,19330,-310,-1.58,18700,20200
خكمك,كمك‌فنرايندامين‌,589,2815533,63205419960,23470,24190,22300,-1170,-4.99,22450,-1020,-4.35,22300,24190
ساروم,سيمان‌اروميه‌,587,1407059,39046495360,29210,29800,27840,-1370,-4.69,27750,-1460,-5,27460,29800
بزاگرس,نيروگاه زاگرس كوثر,579,9135331,43110110730,4899,5080,4658,-241,-4.92,4719,-180,-3.67,4655,5080
كاذر,فرآورده‌هاي‌نسوزآذر,576,4214173,61287037530,15010,15090,14730,-280,-1.87,14540,-470,-3.13,14260,15100
بپاس,بيمه پاسارگاد,574,3431794,170562178100,49700,49750,49750,50,0.1,49700,0,0,49650,49750
سرچشمه,سرمايه گذاري مس سرچشمه,569,11591962,50760450362,4489,4500,4405,-84,-1.87,4379,-110,-2.45,4345,4510
آ س پ,آ.س.پ,568,4267364,23663986700,5820,6020,5480,-340,-5.84,5550,-270,-4.64,5480,6020
سكه0312پ01,تمام سكه طرح جديد0312 رفاه,568,185000,268614748600,1462193,1445000,1461000,-1193,-0.08,1451972,-10221,-0.7,1435103,1463000
اتكاي,بيمه اتكايي ايرانيان,567,7372168,101263333410,13760,13760,13720,-40,-0.29,13740,-20,-0.15,13500,13800
كلوند,كاشي‌ الوند,566,1726628,42334248380,25350,25980,24270,-1080,-4.26,24520,-830,-3.27,24090,25980
غپاك,لبنيات‌ پاك‌,566,1772028,22014703100,12990,12840,12350,-640,-4.93,12420,-570,-4.39,12350,12840
تنوين,تامين سرمايه نوين,565,4645959,20765842121,4558,4600,4411,-147,-3.23,4507,-51,-1.12,4331,4600
زكشت,كشاورزي مكانيزه اصفهان كشت,564,1007099,23599965850,24600,23750,23150,-1450,-5.89,23450,-1150,-4.67,23150,24850
وهور,مديريت انرژي اميد  تابان هور,563,14534158,20169797708,1429,1398,1380,-49,-3.43,1406,-23,-1.61,1362,1442
كوثر,بيمه كوثر,562,16242224,66795975168,4115,4123,4120,5,0.12,4112,-3,-0.07,4066,4180
هامرز,صندوق س اعتماد هامرز-ثابت,560,25421408,256783839619,10096,10102,10102,6,0.06,10101,5,0.05,10101,10102
زيتون,صندوق س زيتون نماد پايا- مختلط,557,6159606,76442908820,12500,12530,12400,-100,-0.8,12410,-90,-0.72,12300,12980
لابسا,آبسال‌,556,3667113,26139533770,7370,7300,7180,-190,-2.58,7130,-240,-3.26,7010,7450
نطرين,عطرين نخ قم,556,2942953,17342774690,6170,6030,5800,-370,-6,5890,-280,-4.54,5800,6100
غگلپا,شير پاستوريزه پگاه گلپايگان,550,663709,34073593500,53800,53800,50600,-3200,-5.95,51350,-2450,-4.55,50600,55450
كتوكا,توليدي و خدمات صنايع نسوز توكا,550,2673306,23460613330,9030,8920,8970,-60,-0.66,8780,-250,-2.77,8490,9380
دتماد,توليدمواداوليه‌داروپخش‌,546,912133,37647375650,42720,43000,40910,-1810,-4.24,41270,-1450,-3.39,40500,43200
آريان,سرمايه گذاري پارس آريان,545,6159776,43310747350,7150,7190,7050,-100,-1.4,7100,-50,-0.7,6950,7190
خراسان,پتروشيمي خراسان,539,365559,48083800140,132990,134900,132000,-990,-0.74,132250,-740,-0.56,129000,135500
ساوه,سيمان ساوه,538,545458,28195160600,54000,55000,52050,-1950,-3.61,51700,-2300,-4.26,51300,55000
قشكر,شكرشاهرود,537,12913598,29790714440,2399,2410,2289,-110,-4.59,2307,-92,-3.83,2280,2485
پكوير,كوير تاير,537,6220292,33492269410,5660,5570,5330,-330,-5.83,5380,-280,-4.95,5330,5750
داوه,داروسازي آوه سينا,535,4948040,39074317980,8340,8380,7840,-500,-6,7900,-440,-5.28,7840,8380
غشهد,شهد ايران ‌,534,5844894,33769936700,5950,5790,5790,-160,-2.69,5780,-170,-2.86,5660,6000
غشوكو,شوكو پارس,532,6149583,54802075930,9020,9290,9020,0,0,8910,-110,-1.22,8750,9290
رتاپ,تجارت الكترونيك  پارسيان,530,3978221,20001108100,5130,5010,4950,-180,-3.51,5030,-100,-1.95,4920,5130
بالبر,كابل‌ البرز,529,1018514,33303242790,33450,34070,32990,-460,-1.38,32700,-750,-2.24,31780,34070
قصفها,قنداصفهان‌,529,389323,37761224210,100660,105400,97900,-2760,-2.74,96990,-3670,-3.65,95630,105400
غفارس,شير پاستوريزه پگاه فارس,522,2997889,18612894440,6480,6500,6160,-320,-4.94,6210,-270,-4.17,6160,6500
خمهر,مهركام‌پارس‌,521,22546774,48656792949,2267,2185,2154,-113,-4.98,2158,-109,-4.81,2154,2240
تپمپي,پمپ‌ سازي‌ ايران‌,519,2444245,45840987260,19260,19000,18330,-930,-4.83,18750,-510,-2.65,18300,19400
فولاژ,فولاد آلياژي ايران,512,2550553,23199993550,9260,9120,9130,-130,-1.4,9220,-40,-0.43,8900,9400
نمرينو,ايران‌ مرينوس‌,510,157468,13802893540,91470,88990,86900,-4570,-5,87660,-3810,-4.17,86900,93100
حفارس,حمل و نقل بين المللي خليج فارس,509,5692427,50875072470,9350,9390,8890,-460,-4.92,8940,-410,-4.39,8890,9390
افرا,افرانت,506,1342646,49610769700,38850,36950,36950,-1900,-4.89,36950,-1900,-4.89,36950,36950
ريشمك,توليد و صادرات ريشمك,496,1482227,39783930400,27950,28650,26950,-1000,-3.58,26850,-1100,-3.94,26550,28650
كنور,توسعه معدني و صنعتي صبانور,492,1128809,22059491180,19980,20130,19780,-200,-1,19880,-100,-0.5,19260,20130
غگرجي,بيسكويت‌  گرجي‌,492,10674049,20874084751,2042,2043,1940,-102,-5,1956,-86,-4.21,1940,2065
دكپسول,توليد ژلاتين كپسول ايران,491,967579,37741242850,39100,38300,38800,-300,-0.77,39000,-100,-0.26,38050,39800
فردا,صندوق س آواي فرداي زاگرس-ثابت,490,18588568,243658015197,13100,13107,13108,8,0.06,13108,8,0.06,13107,13108
شپترو,پتروشيمي آبادان,483,11124703,25238383274,2329,2356,2260,-69,-2.96,2269,-60,-2.58,2260,2356
زر,صندوق س.پشتوانه سكه طلاي زر,483,535184,33250732988,62725,62500,62000,-725,-1.16,62130,-595,-0.95,61600,63000
سصوفي,سيمان‌ صوفيان‌,483,2017801,37510050810,18660,18790,18600,-60,-0.32,18590,-70,-0.38,18170,19390
غالبر,لبنيات‌ كالبر,482,1797630,20356716580,11870,11510,11280,-590,-4.97,11320,-550,-4.63,11280,11860
عيار,صندوق طلاي عيار مفيد,478,1472390,53477400749,36619,36450,36705,86,0.23,36320,-299,-0.82,36000,36705
شنفت,نفت‌ پارس‌,478,2908869,25564594590,9060,9000,8740,-320,-3.53,8940,-120,-1.32,8670,9090
پرديس,سرمايه گذاري پرديس,477,6572125,20278909131,3173,3135,3087,-86,-2.71,3086,-87,-2.74,3022,3171
بميلا,توسعه سرمايه گذاري ميلاد پارس,477,7302529,81541985280,10910,11230,11230,320,2.93,11170,260,2.38,10640,11230
وشهر,بانك شهر,476,7038365,32842891919,4769,4690,4640,-129,-2.7,4666,-103,-2.16,4626,4898
فجام,جام‌دارو,475,5866859,27534999567,4826,4852,4704,-122,-2.53,4693,-133,-2.76,4585,4990
شرانل,نفت ايرانول,474,503905,26864944400,54650,55300,54000,-650,-1.19,53800,-850,-1.56,52100,56000
جهرم,پتروشيمي جهرم,474,16184722,14264418889,885,909,870,-15,-1.69,881,-4,-0.45,859,910
كسرام,پارس‌ سرام‌,474,4923720,30254163550,6210,6110,6060,-150,-2.42,6140,-70,-1.13,5920,6440
وسكاب,س.ص.بازنشستگي كاركنان بانكها,473,7177485,21395587735,3054,3054,2961,-93,-3.05,2981,-73,-2.39,2914,3054
ساذري,آذريت‌,473,3669121,21544569720,6030,6090,5850,-180,-2.99,5870,-160,-2.65,5850,6090
قيستو,شركت قند بيستون,470,2949759,72355240550,23850,24500,24550,700,2.94,24550,700,2.94,23850,24550
سخزر,سيمان‌ خزر,468,1100984,26129061130,24250,24300,24100,-150,-0.62,23730,-520,-2.14,23020,24400
شكلر,نيروكلر,465,711126,33057045270,46840,46140,46970,130,0.28,46490,-350,-0.75,44750,47940
وايران,ليزينگ ايرانيان,464,6907696,18987001421,2878,2807,2706,-172,-5.98,2749,-129,-4.48,2706,2869
دتوزيع,توزيع دارو پخش,461,2865347,99329447500,36350,36900,34550,-1800,-4.95,34650,-1700,-4.68,34550,36900
سخاش,سيمان‌خاش‌,461,274115,17869668460,65220,67990,65290,70,0.11,65190,-30,-0.05,63800,67990
وبهمن,سرمايه‌گذاري‌بهمن‌,461,1747284,27785230250,16760,15930,15780,-980,-5.85,15900,-860,-5.13,15760,16750
ولغدر,ليزينگ‌خودروغدير,461,3885733,42187001830,11490,11550,10810,-680,-5.92,10860,-630,-5.48,10810,11550
وثنو,سرمايه گذاري ساختماني نوين,460,7167763,16867380666,2420,2362,2348,-72,-2.98,2353,-67,-2.77,2348,2410
تايرا,تراكتورسازي‌ايران‌,459,3127281,53395207320,18040,18330,16970,-1070,-5.93,17070,-970,-5.38,16960,18330
فايرا,آلومينيوم‌ايران‌,459,2055504,40422815750,19940,20180,20000,60,0.3,19790,-150,-0.75,19410,20180
وپاسار,بانك  پاسارگاد,456,11903637,106658986180,8960,8960,8960,0,0,8960,0,0,8950,8970
دروز,داروسازي‌ روزدارو,452,938178,25575258820,28340,27400,26930,-1410,-4.98,27260,-1080,-3.81,26930,28980
ثپرديس,سرمايه گذاري مسكن پرديس,448,7859201,35296331538,4673,4393,4600,-73,-1.56,4491,-182,-3.89,4393,4689
گوهر,صندوق سكه طلاي كيان,445,428425,30686071244,71785,72500,71960,175,0.24,71625,-160,-0.22,70740,72500
خفنر,فنرسازي‌خاور,442,3836311,25467419560,6800,7040,6460,-340,-5,6640,-160,-2.35,6460,7040
سشمال,سيمان‌ شمال‌,437,5503567,68429785260,13090,13000,12310,-780,-5.96,12430,-660,-5.04,12310,13160
شيراز,پتروشيمي‌شيراز,437,803408,62283321810,78690,78600,78000,-690,-0.88,77950,-740,-0.94,75720,79440
پاسا,ايران‌ياساتايرورابر,436,2177723,27412497920,13100,12750,12590,-510,-3.89,12590,-510,-3.89,12450,13490
دشيمي,شيمي‌ داروئي‌ داروپخش‌,436,2295353,61676196670,26870,26650,27200,330,1.23,26870,0,0,26100,27380
ثعمرا,عمران و توسعه شاهد,436,5304461,39370745430,7860,8080,7390,-470,-5.98,7420,-440,-5.6,7390,8080
وصندوق,سرمايه‌گذاري‌صندوق‌بازنشستگي‌,436,6039208,87788166340,14970,14970,14700,-270,-1.8,14640,-330,-2.2,14410,14970
پلوله,گازلوله‌,431,1741116,43210580900,24200,24900,24800,600,2.48,24800,600,2.48,23650,24900
فاما,صنعتي‌ آما,431,1976864,18180740200,9640,9480,9070,-570,-5.91,9200,-440,-4.56,9070,9680
سمازن,سيمان‌مازندران‌,429,1880454,21475514430,11370,11410,11500,130,1.14,11420,50,0.44,11070,11770
دسبحان,سبحان دارو,429,4310469,40530174220,9760,9840,9280,-480,-4.92,9400,-360,-3.69,9280,9840
وتوسم,سرمايه‌گذاري‌توسعه‌ملي‌,425,4881121,22037877434,4601,4616,4490,-111,-2.41,4515,-86,-1.87,4447,4655
ولصنم,ليزينگ‌صنعت‌ومعدن‌,424,5858024,15805536244,2839,2829,2674,-165,-5.81,2698,-141,-4.97,2669,2839
زشگزا,شير و گوشت زاگرس شهركرد,417,3674674,25382096260,7250,7290,6820,-430,-5.93,6910,-340,-4.69,6820,7290
ضستا7005,اختيارخ شستا-1200-1401/07/17,415,23027,1625561000,80,76,70,-10,-12.5,71,-9,-11.25,67,80
تسه0010,امتيازتسهيلات مسكن دي1400,412,4377,5215817715,1246488,1184164,1184164,-62324,-5,1191642,-54846,-4.4,1184164,1250000
فلامي,لاميران‌,411,917359,18007434960,20520,21180,19500,-1020,-4.97,19630,-890,-4.34,19500,21180
ولبهمن,شركت بهمن ليزينگ,410,3705726,13636591904,3839,3721,3620,-219,-5.7,3680,-159,-4.14,3611,3860
غمهرا,توليدي‌مهرام‌,403,2667353,32145919270,12590,12950,11970,-620,-4.92,12050,-540,-4.29,11970,12950
تسه9905,امتياز تسهيلات مسكن مرداد99,401,6185,7610945305,1265829,1202538,1210006,-55823,-4.41,1230549,-35280,-2.79,1202538,1329120
فالوم,آلومتك‌,400,1987163,29224536950,14970,14560,14530,-440,-2.94,14710,-260,-1.74,14530,15050
خبازرس,بازرسي مهندسي و صنعتي ايران,399,1080271,18420190200,17430,17560,16910,-520,-2.98,17050,-380,-2.18,16910,17840
پارتا,مجتمع‌صنعتي‌آرتاويل‌تاير,399,1099600,20080847010,17960,17510,17900,-60,-0.33,18260,300,1.67,17510,18490
كي بي سي,شركت كي بي سي,397,2046031,25634269140,13000,13270,12380,-620,-4.77,12530,-470,-3.62,12350,13270
سلام,صندوق س سلام فارابي-سهام,397,2894607,28971595740,10070,10010,10000,-70,-0.7,10010,-60,-0.6,10000,10090
وارس,سرمايه گذاري ارس صبا,395,2114476,36063967950,16830,17300,16900,70,0.42,17060,230,1.37,16330,17330
خاتم,صندوق س خاتم ايساتيس پويا-ثابت,395,16462176,222740668145,13524,13530,13531,7,0.05,13530,6,0.04,13529,13532
وخاور,بانك خاورميانه,392,10051274,60016838840,5940,5830,5940,0,0,5970,30,0.51,5820,6000
ولانا,شركت ليزينگ آريا دانا,384,1254552,17687690280,14210,14050,14000,-210,-1.48,14100,-110,-0.77,13790,14600
كساپا,سايپاشيشه‌,382,2388439,38795369780,17060,17070,16210,-850,-4.98,16240,-820,-4.81,16210,17070
گپارس,امور رفاهي كارگزاران پارس,381,144640,16223600900,109600,112750,112850,3250,2.97,112150,2550,2.33,110000,112850
ثعتما,س. ساختماني اعتماد گستر,381,1340080,21431255340,16320,15930,15840,-480,-2.94,15990,-330,-2.02,15840,16440
شلرد,كود شيميايي اوره لردگان,380,4819330,59952465200,12080,12440,12440,360,2.98,12440,360,2.98,12440,12440
كطبس,ذغال‌سنگ‌ نگين‌ ط‌بس‌,379,2738726,54270200140,20690,20480,19720,-970,-4.69,19820,-870,-4.2,19660,20960
آساميد,صندوق س.مشترك آسمان اميد -د,379,6349497,94446465756,14867,14875,14874,7,0.05,14875,8,0.05,14874,14875
كمنگنز,معادن‌منگنزايران‌,378,1886166,31255920980,16790,16410,16520,-270,-1.61,16570,-220,-1.31,16190,17250
سغرب,سيمان‌غرب‌,377,2061773,40862080490,19830,19710,19300,-530,-2.67,19820,-10,-0.05,19000,20210
وتوس,توسعه‌شهري‌توس‌گستر,377,4859287,39805272770,8270,8230,8200,-70,-0.85,8190,-80,-0.97,8100,8300
دقاضي,داروسازي شهيد قاضي,375,711946,22513608950,32500,32200,31900,-600,-1.85,31600,-900,-2.77,31550,32400
وپترو,سرمايه‌گذاري صنايع پتروشيمي‌,374,1927871,21257829400,11400,11400,11050,-350,-3.07,11030,-370,-3.25,10850,11510
تسه9906,امتياز تسهيلات مسكن شهريور99,372,6036,7496482824,1272305,1208690,1275007,2702,0.21,1241962,-30343,-2.38,1208690,1335920
فن آوا,گروه فن آوا,372,1783487,15508836560,8870,9000,8610,-260,-2.93,8700,-170,-1.92,8610,9000
خكرمان,سرمايه گذاري آرمان گستر پاريز,371,10785269,36810536533,3504,3570,3399,-105,-3,3413,-91,-2.6,3399,3570
پكرمان,گروه‌ صنعتي‌ بارز,370,2016561,34927810840,17860,17890,17010,-850,-4.76,17320,-540,-3.02,16970,18000
سفارس,سيمان فارس و خوزستان,368,3775493,79923436980,22280,22280,20950,-1330,-5.97,21170,-1110,-4.98,20950,22280
چفيبر,فيبر ايران‌,367,2819801,17241802860,6340,6110,6030,-310,-4.89,6110,-230,-3.63,6030,6370
شتوكا,توكا رنگ فولاد سپاهان,366,554048,9234299550,17350,17500,16510,-840,-4.84,16900,-450,-2.59,16320,17790
داسوه,داروسازي‌ اسوه‌,364,1326071,62079097060,45790,45250,47700,1910,4.17,46810,1020,2.23,43550,47990
شزنگ,تجهيزنيروي‌زنگان‌,363,213855,18437435700,88450,88950,85800,-2650,-3,86200,-2250,-2.54,85800,89500
اميد,تامين سرمايه اميد,362,2195996,12585190300,5930,5790,5680,-250,-4.22,5860,-70,-1.18,5660,5940
لخزر,پارس‌ خزر,361,125783,15941910470,129820,133100,127990,-1830,-1.41,126740,-3080,-2.37,123330,133100
سپ,پرداخت الكترونيك سامان كيش,361,1020036,22816321190,22230,22220,22840,610,2.74,22270,40,0.18,21490,23180
ضهرم6002,اختيارخ اهرم-12000-1401/06/30,359,27131,930742500,3906,4308,3230,-676,-17.31,3431,-475,-12.16,3200,4308
حپارسا,توسعه حمل و نقل ريلي پارسيان,357,550274,21268604850,39950,39200,38700,-1250,-3.13,38650,-1300,-3.25,37600,40950
كگهر,سنگ آهن گهرزمين,356,840574,41860853950,50050,51000,50000,-50,-0.1,49950,-100,-0.2,48550,51000
خوساز,محورسازان‌ايران‌خودرو,355,4271806,34725942700,8510,8350,8090,-420,-4.94,8130,-380,-4.47,8090,8590
قهكمت,قندهكمتان‌,353,3866287,28046945990,7530,7280,7160,-370,-4.91,7250,-280,-3.72,7160,7500
كسعدي,كاشي‌ سعدي‌,350,1920943,17530660580,9420,9600,8950,-470,-4.99,9130,-290,-3.08,8950,9600
ثامان,سامان‌ گستراصفهان‌,349,1979223,28746490720,15150,15550,14400,-750,-4.95,14520,-630,-4.16,14400,15550
غبهنوش,بهنوش‌ ايران‌,348,476390,27690972880,60710,61900,57680,-3030,-4.99,58130,-2580,-4.25,57680,61900
ماني,صندوق س. با درآمد ثابت ماني,343,5826190,68349905170,11725,11733,11732,7,0.06,11731,6,0.05,11731,11733
سبجنو,سيمان‌ بجنورد,342,1535699,63414090030,43020,43240,42040,-980,-2.28,41290,-1730,-4.02,40870,43500
لوتوس,تامين سرمايه لوتوس پارسيان,341,4473408,31943255110,7160,7190,7150,-10,-0.14,7150,-10,-0.14,6850,7270
ضستا7000,اختيارخ شستا-700-1401/07/17,340,21568,8605997000,425,420,395,-30,-7.06,399,-26,-6.12,395,420
تسه0009,امتيازتسهيلات مسكن آذر 1400,339,4306,5095524101,1237519,1175665,1176500,-61019,-4.93,1183354,-54165,-4.38,1175644,1235000
حفاري,حفاري شمال,339,13772998,64912139574,5013,4713,4713,-300,-5.98,4713,-300,-5.98,4713,4713
ياقوت,صندوق س ياقوت آگاه-ثابت,335,2287418,33959749472,14834,14842,14846,12,0.08,14846,12,0.08,14842,14850
وليز,ليزينگ‌ايران‌,335,7542968,14506515972,2022,2000,1921,-101,-5,1928,-94,-4.65,1921,2000
ساربيل,سيمان آرتا اردبيل,332,900703,26619689250,30710,32080,29180,-1530,-4.98,29550,-1160,-3.78,29180,32080
ضخود4013,اختيارخ خودرو-2400-1401/04/08,332,15428,1513708000,151,127,84,-67,-44.37,98,-53,-35.1,80,138
غبهار,كشت وصنعت بهاران گلبهار خراسان,332,801673,12772328410,16330,16010,15850,-480,-2.94,15930,-400,-2.45,15850,16300
سبهان,سيمان‌ بهبهان‌,330,390856,18796962730,48340,45950,47730,-610,-1.26,48090,-250,-0.52,45950,50090
پدرخش,درخشان‌ تهران‌,330,1912461,14806360750,8090,7940,7690,-400,-4.94,7740,-350,-4.33,7690,8160
كترام,توليدي‌ كاشي‌ تكسرام‌,329,868297,26141700810,31420,30000,29850,-1570,-5,30110,-1310,-4.17,29850,31500
فراز,صندوق س.سهام فراز داريك-س,326,2253672,34510009277,15297,15300,15348,51,0.33,15313,16,0.1,15297,15350
دابور,داروسازي‌ ابوريحان‌,322,1184748,28882593170,25140,24890,24010,-1130,-4.49,24380,-760,-3.02,23890,25120
قشهد,شهد,319,1336764,19691636640,15330,15340,14570,-760,-4.96,14730,-600,-3.91,14570,15650
وشمال,س. چشم انداز توسعه شمال,318,730363,17456375700,24350,23900,23900,-450,-1.85,23900,-450,-1.85,23900,24000
بساما,بيمه سامان,312,3332060,39787923800,12060,12220,11710,-350,-2.9,11940,-120,-1,11460,12220
حسينا,توسعه خدمات دريايي وبندري سينا,312,502949,27799514850,56500,56600,56500,0,0,55250,-1250,-2.21,53350,57550
چافست,افست‌,311,1877239,9397669380,5210,5130,4950,-260,-4.99,5080,-130,-2.5,4950,5270
داراب,پتروشيمي داراب,310,7447892,7123308668,966,986,946,-20,-2.07,959,-7,-0.72,939,986
سپر,صندوق س سپر سرمايه بيدار- ثابت,309,8229657,119482548267,14511,14521,14518,7,0.05,14519,8,0.06,14518,14521
سخاشح,ح . سيمان‌خاش‌,308,241924,12725492970,52140,52550,52400,260,0.5,52600,460,0.88,51200,54000
ضستا7001,اختيارخ شستا-800-1401/07/17,307,15530,4822632000,340,349,317,-23,-6.76,311,-29,-8.53,310,349
وحكمت,بيمه حكمت صبا,307,7435519,11372647229,1576,1587,1529,-47,-2.98,1530,-46,-2.92,1529,1587
ولملت,واسپاري ملت,305,3529224,13504358494,3848,3700,3901,53,1.38,3829,-19,-0.49,3700,3930
سمايه,بانك سرمايه,302,2214872,8572663339,3939,3999,3821,-118,-3,3882,-57,-1.45,3821,3999
ضخود4012,اختيارخ خودرو-2200-1401/04/08,301,12812,2388369000,276,240,180,-96,-34.78,186,-90,-32.61,161,269
گنجينه,صندوق س. گنجينه داريوش-د,300,14835259,149840505230,10168,10180,10100,-68,-0.67,10100,-68,-0.67,10100,10180
تپولا,مهندسي مرآت پولاد,300,1149941,17394168810,14740,15000,15180,440,2.99,15130,390,2.65,14800,15180
باران,بيمه زندگي باران,299,2390689,8435675833,4520,3440,3543,-977,-21.62,3529,-991,-21.92,3337,3543
فسا,پتروشيمي فسا,296,7763115,7263588626,917,943,904,-13,-1.42,930,13,1.42,900,944
وتعاون,بيمه تعاون,295,7158558,10807311253,1576,1590,1539,-37,-2.35,1525,-51,-3.24,1498,1590
دارو,كارخانجات‌داروپخش‌,294,457431,13788274640,31140,31140,30070,-1070,-3.44,30380,-760,-2.44,29590,31200
درسا,صندوق سرمايه گذاري درسا - سهام,291,7851646,78516460000,10000,10000,10000,0,0,10000,0,0,10000,10000
درازك,دارويي‌ رازك‌,290,1212492,19836183950,17080,17580,16490,-590,-3.45,16360,-720,-4.22,16230,17580
كگاز,شيشه‌ و گاز,289,664918,10725826270,16580,17000,15920,-660,-3.98,16250,-330,-1.99,15910,17000
حشكوه,دليجان طلايي شكوه پارس,285,6671102,16956163323,2617,2619,2539,-78,-2.98,2542,-75,-2.87,2539,2619
لكما,كارخانجات‌مخابراتي‌ايران‌,285,12991977,11890116384,943,920,915,-28,-2.97,915,-28,-2.97,915,930
فاهواز,نورد و لوله اهواز,284,4173645,23326127510,5630,5570,5590,-40,-0.71,5590,-40,-0.71,5520,5700
كمينا,شيشه سازي مينا,284,2850313,29425042730,10080,10380,10380,300,2.98,10320,240,2.38,9850,10380
تشتاد,صنايع توليدي اشتاد ايران‌,284,3170997,18063291140,5540,5690,5700,160,2.89,5700,160,2.89,5550,5700
شليا,شركت مواد ويژه ليا,282,1020951,29422774450,28050,28850,28850,800,2.85,28800,750,2.67,27950,28850
اوان,مبين وان كيش,281,2107094,24224869310,12180,11710,11460,-720,-5.91,11500,-680,-5.58,11450,12060
سباقر,سيمان باقران,274,1391466,18656753240,13590,13750,13440,-150,-1.1,13410,-180,-1.32,13190,13890
نهال,صندوق س. طلاي سرخ نوويرا,273,817389,16589431396,19891,19901,20350,459,2.31,20296,405,2.04,19900,20480
زعف0110پ11,زعفران0110نگين سحرخيز(پ),273,137020,52265397626,375046,380502,382300,7254,1.93,381444,6398,1.71,380500,384000
پاداش,صندوق س. ارزش پاداش-د,272,12361973,125986230108,10186,10191,10192,6,0.06,10191,5,0.05,10191,10192
گوهران,سرمايه گذاري توسعه گوهران اميد,271,1485625,8332350070,5700,5780,5550,-150,-2.63,5650,-50,-0.88,5510,5780
تكنار,مجتمع معادن مس تكنار,270,255007,14951425950,60050,60000,59000,-1050,-1.75,58650,-1400,-2.33,58250,61000
چكاوه,صنايع‌كاغذسازي‌كاوه‌,269,2318160,17660954960,7920,8100,7530,-390,-4.92,7620,-300,-3.79,7530,8100
واميد,گروه مديريت سرمايه گذاري اميد,267,1611625,23691410810,14760,14000,14880,120,0.81,14750,-10,-0.07,14000,14970
سجام,مجتمع سيمان غرب آسيا,264,2937459,7476135955,2575,2637,2516,-59,-2.29,2552,-23,-0.89,2498,2650
آوا,صندوق س.سهام آواي معيار-س,263,1184610,10215199689,8821,8811,8597,-224,-2.54,8623,-198,-2.24,8480,8843
شفا,سرمايه گذاري شفادارو,263,1699814,27480343650,16870,16980,16030,-840,-4.98,16170,-700,-4.15,16030,17000
ثتوسا,س.توسعه و عمران استان اردبيل,262,899172,13658010350,15620,15700,15160,-460,-2.94,15190,-430,-2.75,15160,15700
كاردان,صندوق س تجارت شاخصي كاردان,261,109401,24573247730,229270,229500,223500,-5770,-2.52,224620,-4650,-2.03,222050,229900
تسه0008,امتيازتسهيلات مسكن آبان1400,260,2753,3308220015,1249540,1187063,1187063,-62477,-5,1201678,-47862,-3.83,1187063,1250000
سفارود,كارخانه فارسيت درود,258,1684195,11020658810,6650,6760,6520,-130,-1.95,6540,-110,-1.65,6520,6760
ثنام,س ساختماني ب نام آوران مهندسي,256,1312717,8037063960,6250,6360,6070,-180,-2.88,6140,-110,-1.76,6070,6360
وپخش,داروپخش‌ (هلدينگ‌,254,765079,26099764530,34040,34550,34250,210,0.62,34080,40,0.12,32010,34600
وتوشه,سرمايه‌ گذاري‌ پارس‌ توشه‌,254,1628063,10821213060,6990,6620,6600,-390,-5.58,6740,-250,-3.58,6580,7000
ويسا,سرمايه گذاري ايساتيس پويا,252,1906386,12541064980,6700,6870,6680,-20,-0.3,6580,-120,-1.79,6510,6870
سدور,سيمان‌ دورود,249,2310190,17266928370,7810,7620,7270,-540,-6.91,7470,-340,-4.35,7250,7650
كاسپين,داروسازي كاسپين تامين,249,895767,20331323250,23800,23150,22700,-1100,-4.62,22700,-1100,-4.62,22650,23500
وآرين,شركت توسعه اقتصادي آرين,248,5926236,7012134001,1216,1192,1180,-36,-2.96,1192,-24,-1.97,1180,1208
دشيري,شيرين دارو,244,99036,9921687900,102550,103700,99500,-3050,-2.97,100200,-2350,-2.29,99500,103700
تسه0007,امتيازتسهيلات مسكن مهر1400,241,2318,2760401626,1239200,1235741,1177777,-61423,-4.96,1190855,-48345,-3.9,1177240,1280000
كاريس,صندوق س.سپند كاريزما-س,236,1397442,21271988808,15512,15648,15061,-451,-2.91,15222,-290,-1.87,14953,15648
تسه0006,امتيازتسهيلات مسكن شهريور1400,234,3596,4302097043,1243120,1304990,1180964,-62156,-5,1196356,-46764,-3.76,1180964,1304990
دالبر,البرزدارو,234,1268487,12447722090,10310,10350,9800,-510,-4.95,9970,-340,-3.3,9700,10490
سيدكو,سرمايه گذاري توسعه صنايع سيمان,234,1665367,13105262810,8080,8030,7870,-210,-2.6,7930,-150,-1.86,7700,8190
ثشرق,سرمايه گذاري مسكن شمال شرق,231,4675767,18004567318,3986,3940,3787,-199,-4.99,3851,-135,-3.39,3787,4000
تصميم,صندوق س با درآمد ثابت تصميم,230,2358440,46763860070,19794,19807,19810,16,0.08,19828,34,0.17,19807,20898
سارومح,ح . سيمان‌اروميه‌,229,686782,17463857890,25960,25880,24970,-990,-3.81,25430,-530,-2.04,24900,26320
اپرداز,آتيه داده پرداز,229,1091778,15686704730,15040,15200,14290,-750,-4.99,14370,-670,-4.45,14290,15200
شستان,پتروشيمي گلستان,228,1308428,5311083961,3986,4050,4065,79,1.98,4059,73,1.83,3951,4065
حتوكا,حمل‌ونقل‌توكا,227,599568,9936844840,17240,17300,16380,-860,-4.99,16770,-470,-2.73,16380,17300
واعتبار,سرمايه گذاري اعتبار ايران,227,2625574,8214977614,3285,3160,3121,-164,-4.99,3197,-88,-2.68,3121,3172
مثقال,صندوق س.پشتوانه طلاي زرين آگاه,226,780733,8761884691,11303,11180,11268,-35,-0.31,11223,-80,-0.71,11162,11290
دفرا,فرآورده‌هاي‌ تزريقي‌ ايران‌,224,874169,15281700080,17770,16910,17400,-370,-2.08,17480,-290,-1.63,16910,18330
ضخود4014,اختيارخ خودرو-2600-1401/04/08,223,10587,547546000,87,85,47,-40,-45.98,52,-35,-40.23,44,85
سقاين,سيمان‌ قائن‌,221,149962,6836963230,46770,47750,45190,-1580,-3.38,46220,-550,-1.18,44670,47750
شفارا,پتروشيمي فارابي,217,1513837,8724808320,5900,6040,5730,-170,-2.88,5780,-120,-2.03,5730,6040
پرداخت,به پرداخت ملت,216,528928,11857171820,22940,22300,22000,-940,-4.1,22710,-230,-1,21950,23180
سهگمت,سيمان‌هگمتان‌,216,462773,11577551450,26320,24750,24770,-1550,-5.89,25110,-1210,-4.6,24750,26430
كباده,توليد خاك نسوزاستقلال آباده,215,1895678,34311771800,17580,18100,18100,520,2.96,18100,520,2.96,18100,18100
ضستا7004,اختيارخ شستا-1100-1401/07/17,209,13301,1427696000,122,115,107,-15,-12.3,107,-15,-12.3,105,115
رتكو,كنترل‌خوردگي‌تكين‌كو,205,1091299,9290065880,8790,8550,8370,-420,-4.78,8610,-180,-2.05,8360,8980
شپاس,نفت پاسارگاد,205,762959,14005355830,18940,19500,18500,-440,-2.32,18480,-460,-2.43,18200,19500
وجامي,سرمايه گذاري جامي,204,2397678,10612708445,4548,4440,4412,-136,-2.99,4426,-122,-2.68,4412,4520
سرود,سيمان‌شاهرود,204,777482,16461892700,21360,21700,21000,-360,-1.69,21170,-190,-0.89,20820,21700
دعبيد,لابراتوارداروسازي‌  دكترعبيدي‌,203,328842,7881156720,24320,24800,24760,440,1.81,24260,-60,-0.25,23310,24800
سغدير,توسعه سرمايه و صنعت غدير,200,1281255,16799851010,13690,13340,13090,-600,-4.38,13140,-550,-4.02,13010,13880
فافق,صنايع مس افق كرمان,197,3346145,16047363680,4920,4930,4780,-140,-2.85,4800,-120,-2.44,4780,4930
شساخت,مهندسي و ساختمان صنايع نفت,196,314987,13864329000,45150,43900,43900,-1250,-2.77,44800,-350,-0.78,43800,44700
تسه9908,امتياز تسهيلات مسكن آبان99,195,2542,3033102295,1249261,1186798,1186798,-62463,-5,1193195,-56066,-4.49,1186798,1311724
تداوم,صندوق تداوم اطمينان تمدن-ثابت,195,7806640,78832074904,10092,10098,10098,6,0.06,10098,6,0.06,10098,10100
فبيرا,بسته‌ بندي‌ ايران‌,194,3539816,5912292351,1674,1642,1641,-33,-1.97,1670,-4,-0.24,1641,1707
فكمند,گسترش قطعه سازي كمند,194,476179,11147240500,24050,23350,23350,-700,-2.91,23400,-650,-2.7,23350,24500
غپونه,نوش پونه مشهد,194,465144,6976645590,15260,15330,14810,-450,-2.95,15080,-180,-1.18,14810,15330
سفانو,سيمان فارس نو,194,399055,13564565890,34900,35550,33630,-1270,-3.64,34060,-840,-2.41,33110,35550
ومشان,س. فني و مهندسي مشانير,190,134829,8362160500,62850,61550,62800,-50,-0.08,62000,-850,-1.35,61000,64600
حخزر,كشتيراني درياي خزر,187,526553,9113551020,18060,18390,17160,-900,-4.98,17570,-490,-2.71,17160,18600
آرمان,بيمه آرمان,184,1656165,6856398583,4266,4144,4139,-127,-2.98,4176,-90,-2.11,4139,4184
وزمين,بانك ايران زمين,181,899930,8772989970,9640,9790,9730,90,0.93,9700,60,0.62,9460,9830
آساس,صندوق س.آسمان آرماني سهام-س,179,33527,7169455734,215096,215000,210700,-4396,-2.04,213841,-1255,-0.58,210700,217250
فمراد,آلومراد,175,457111,11967165980,24940,26180,26180,1240,4.97,25810,870,3.49,26180,26180
تسه0005,امتيازتسهيلات مسكن مرداد 1400,171,1826,2176525568,1234292,1185000,1180000,-54292,-4.4,1191964,-42328,-3.43,1172578,1296006
ساروج,بين المللي ساروج بوشهر,165,593040,9960269770,17580,17250,16710,-870,-4.95,17030,-550,-3.13,16710,17250
تابا,تابان نيرو سپاهان,163,500072,11676681200,22700,23350,23350,650,2.86,23350,650,2.86,23350,23350
سمتاز,سيمان ممتازان كرمان,161,553196,10960009510,19390,19000,19580,190,0.98,19810,420,2.17,19000,19970
خمحور,توليدمحورخودرو,158,4576555,12297266619,2823,2747,2682,-141,-4.99,2704,-119,-4.22,2682,2751
دسينا,داروسازي‌ سينا,158,995574,25558921310,26600,27000,25270,-1330,-5,25670,-930,-3.5,25270,27150
بمپنا,توليد برق عسلويه  مپنا,158,1865522,13189232100,7330,7220,7050,-280,-3.82,7170,-160,-2.18,6970,7400
برن0104پ01,برنج طارم0104تجارت مازندران(پ),157,8638,7013632740,780545,819572,819572,39027,5,811951,31406,4.02,781600,819572
اخزا002,اسنادخزانه-م2بودجه00-031024,155,335500,194252407000,578440,578440,580100,1660,0.29,578990,550,0.1,577250,580100
سيستم,همكاران سيستم,153,513948,3191536930,6210,6390,6170,-40,-0.64,6210,0,0,6050,6390
سيلام,سيمان‌ ايلام‌,152,2470955,19078825700,8110,8440,7710,-400,-4.93,7720,-390,-4.81,7710,8440
بايكا,كارخانجات كابلسازي ‌ايران‌,150,302269,4759656520,16020,16400,15540,-480,-3,15880,-140,-0.87,15540,16450
تسه9907,امتياز تسهيلات مسكن مهر99,149,1445,1760494461,1239873,1177880,1190008,-49865,-4.02,1218335,-21538,-1.74,1177880,1301866
تسه9911,امتياز تسهيلات مسكن بهمن99,146,2239,2646405148,1241385,1179316,1179316,-62069,-5,1181958,-59427,-4.79,1179316,1225000
بسويچ,پارس‌سويچ‌,145,372003,5877320520,16470,16170,15850,-620,-3.76,16200,-270,-1.64,15650,16390
هم وزن,صندوق س. شاخصي كيان-س,145,916284,9162840000,10000,10000,10000,0,0,10000,0,0,10000,10000
اخزا006,اسنادخزانه-م6بودجه00-030723,141,275800,168117080000,609390,606830,609650,260,0.04,609560,170,0.03,606830,611000
ما,بيمه  ما,140,611914,3019373030,5210,4910,5000,-210,-4.03,5150,-60,-1.15,4900,5050
كهربا,صندوق س.پشتوانه سكه طلا كهربا,140,882751,10855250502,12355,12404,12399,44,0.36,12297,-58,-0.47,12211,12404
فيروزه,صندوق شاخص30 شركت فيروزه- سهام,140,111729,21732978880,194510,194900,194510,0,0,194520,10,0.01,194510,194900
وگردش,بانك گردشگري,140,624967,6883535050,11340,11100,11000,-340,-3,11310,-30,-0.26,11000,11100
قپيرا,فرآورده‌هاي‌غدايي‌وقندپيرانشهر,138,1202676,10237434980,8550,8430,8850,300,3.51,8520,-30,-0.35,8320,8850
وكار,بانك‌ كارآفرين‌,137,3783732,12632342434,3342,3359,3349,7,0.21,3341,-1,-0.03,3301,3359
تسه0003,امتيازتسهيلات مسكن خرداد1400,136,2314,2765523026,1243279,1181116,1181200,-62079,-4.99,1195127,-48152,-3.87,1181116,1251000
تسه9910,امتياز تسهيلات مسكن دي99,134,1016,1202096327,1243684,1181500,1181500,-62184,-5,1183166,-60518,-4.87,1181500,1243440
شرنگي,شيميايي رنگين,131,19889,6795365800,351700,351700,341150,-10550,-3,346700,-5000,-1.42,341150,351700
تسه0004,امتيازتسهيلات مسكن تير1400,131,1652,1971885739,1236531,1174800,1190060,-46471,-3.76,1193635,-42896,-3.47,1174800,1200500
ضپلا4007,اختيارخ پالايش-90000-01/04/29,130,7760,181200000,4000,3000,2000,-2000,-50,2335,-1665,-41.63,2000,3000
گكيش,توريستي ورفاهي آبادگران كيش,129,313819,10905210250,35800,34750,34750,-1050,-2.93,34750,-1050,-2.93,34750,34750
تسه9912,امتياز تسهيلات مسكن اسفند99,129,1583,1889590277,1240207,1200000,1180200,-60007,-4.84,1193677,-46530,-3.75,1178197,1230000
ثنظام,س. ساختماني نظام مهندسي ايران,128,348958,6069293620,17920,17450,17390,-530,-2.96,17430,-490,-2.73,17390,17460
سكارون,سيمان كارون,122,167372,8846036700,54400,52800,52800,-1600,-2.94,52950,-1450,-2.67,52800,54250
وثخوز,سرمايه گذاري و توسعه خوزستان,119,176227,5981056650,34450,33600,33900,-550,-1.6,34150,-300,-0.87,33450,34850
انار,صندوق س.انارنماد ارزش-درسهام,119,281793,3167828580,11650,11650,11170,-480,-4.12,11240,-410,-3.52,11010,11770
تسه9909,امتياز تسهيلات مسكن آذر99,119,1307,1541928158,1234410,1172700,1180008,-54402,-4.41,1179746,-54664,-4.43,1172700,1200000
غناب,روغن‌ نباتي‌ ناب,118,22170,4133808050,188750,185000,185000,-3750,-1.99,186800,-1950,-1.03,185000,192300
وكادو,تكادو,117,338051,6344721480,19250,18810,18680,-570,-2.96,18940,-310,-1.61,18680,19260
وسين,بيمه سينا,116,1698180,4212887342,2551,2521,2475,-76,-2.98,2521,-30,-1.18,2475,2535
زرين,صندوق س. سهام زرين كوروش-س,115,454288,6157042955,13795,13750,13595,-200,-1.45,13553,-242,-1.75,13299,13963
داريك,صندوق س.اعتماد داريك-د,114,1795405,22744725342,12647,12669,12669,22,0.17,12668,21,0.17,12665,12710
دپارس,پارس‌ دارو,107,355144,11125294220,31710,31050,31470,-240,-0.76,31420,-290,-0.91,30600,32390
وملت,سرمايه گذاري ملت,106,1666054,3847530375,2349,2307,2348,-1,-0.04,2317,-32,-1.36,2303,2379
زعف0110پ18,زعفران0110نگين بهرامن(پ),105,21496,8193852079,376043,380101,381510,5467,1.45,381180,5137,1.37,380000,383000
تسه0001,امتيازتسهيلات مسكن فروردين1400,105,1284,1591452728,1299166,1234208,1255000,-44166,-3.4,1239449,-59717,-4.6,1234208,1255000
مارون,پتروشيمي مارون,104,40353,7646237300,190950,192500,190900,-50,-0.03,190850,-100,-0.05,186900,192500
ضخود4017,اختيارخ خودرو-3250-1401/04/08,103,4230,55864000,17,25,12,-5,-29.41,13,-4,-23.53,5,25
دارا,صندوق س. دارا الگوريتم-د,102,3661390,36654053222,10006,10011,10011,5,0.05,10011,5,0.05,10010,10011
اوصتا,صندوق انديشه ورزان صباتامين -د,101,3354482,76173718957,22695,22708,22709,14,0.06,22708,13,0.06,22708,22709
ضهرم6004,اختيارخ اهرم-14000-1401/06/30,100,10000,230000000,1,2300,2300,2299,229900,2300,2299,229900,2300,2300
هامرز2,صندوق س اعتماد هامرز-ثابت,100,10000000,10000000,10096,1,1,-10095,-99.99,1,-10095,-99.99,1,1
قاروم,قند اروميه,99,15466,2997310800,199767,193800,193800,-5967,-2.99,198400,-1367,-0.68,193800,193800
وآتوس,توسعه س. كشاورزي آرين توسكا,94,793298,19554795700,23950,24650,24650,700,2.92,24650,700,2.92,24650,24650
حاريا,كشتيراني آريا,93,496835,2829723150,5800,5710,5690,-110,-1.9,5740,-60,-1.03,5690,5780
سكه0112پ03,تمام سكه طرح جديد0112سامان,92,14600,21120373300,1459145,1438001,1461970,2825,0.19,1446601,-12544,-0.86,1435000,1461988
ضملي3013,اختيارخ فملي-7000-1401/03/02,89,2668,1053718000,472,451,420,-52,-11.02,395,-77,-16.31,350,451
اخزا004,اسنادخزانه-م4بودجه00-030522,88,221700,140051228000,631220,631000,631300,80,0.01,631720,500,0.08,630010,632870
زعف0110پ21,زعفران0110نگين ملل(پ),86,342371,140246359185,390248,390500,410000,19752,5.06,409633,19385,4.97,390500,410000
الماس,صندوق س.امين تدبيرگران فردا-س,86,58237,7262564687,130764,127603,125232,-5532,-4.23,124707,-6057,-4.63,122000,128002
عيار2,صندوق طلاي عيار مفيد,85,850000,850000,36619,1,1,-36618,-100,1,-36618,-100,1,1
وحافظ,بيمه حافظ,85,1166244,12058962960,10040,10340,10340,300,2.99,10340,300,2.99,10340,10340
سكه0211پ02,تمام سكه طرح جديد0211ملت,85,17500,25347959200,1460501,1449000,1463000,2499,0.17,1448455,-12046,-0.82,1434001,1463000
اخزا005,اسنادخزانه-م5بودجه00-030626,84,248000,153582697000,618770,619000,619010,240,0.04,619290,520,0.08,618800,620000
صنم,ص.س.صندوق در صندوق صنم,83,597423,6843796411,11612,11613,11489,-123,-1.06,11456,-156,-1.34,11350,11613
وپسا,س. پتروشيمي ساختمان  خليج فارس,83,2310424,5346321136,2247,2314,2314,67,2.98,2280,33,1.47,2314,2314
رماس,صندوق س.راهبرد ممتازابن سينا-س,81,634129,8155321706,13234,13490,12797,-437,-3.3,12861,-373,-2.82,12252,13490
معيار ,سرمايه گذاري معيار صنعت پارس,79,263217,19609666500,72350,74500,74500,2150,2.97,74500,2150,2.97,74500,74500
لخانه,لوازم‌ خانگي‌ پارس‌,78,348598,6612904060,18420,18970,18970,550,2.99,18760,340,1.85,18970,18970
ضذوب3002,اختيارخ ذوب-3000-1401/03/04,77,3878,21132000,31,100,7,-24,-77.42,5,-26,-83.87,4,8
اخزا001,اسنادخزانه-م1بودجه00-030821,72,183600,110060014000,599530,599000,599550,20,0,599460,-70,-0.01,598000,601500
خريختح,ح . صنايع‌ريخته‌گري‌ايران‌,72,3843063,8085317300,2100,2310,2100,0,0,2104,4,0.19,2100,2310
كهرام,توليدي گرانيت بهسرام,70,62362,3533074050,57800,56650,56650,-1150,-1.99,56950,-850,-1.47,56650,57250
ضشنا8014,اختيارخ شپنا-5850-1401/08/29,66,2140,2480070000,1265,1200,1170,-95,-7.51,1159,-106,-8.38,1110,1215
شيشه22ن,گواهي شيشه فلوت4بيرنگBآسا,66,90000,48690000000,594248,541000,541000,-53248,-8.96,541000,-53248,-8.96,541000,541000
زعف0110پ09,زعفران0110نگين نوين(پ),65,308000,126255000000,390000,390000,410000,20000,5.13,409919,19919,5.11,390000,410000
وايرا,سرمايه گذاري صنايع ايران,64,1559968,3298994080,2178,2113,2113,-65,-2.98,2156,-22,-1.01,2113,2146
سكه0111پ05,تمام سكه طرح جديد0111آينده,62,16600,24117040300,1459396,1441999,1460797,1401,0.1,1452834,-6562,-0.45,1438000,1460899
وامين,س. امين توان آفرين ساز,61,153851,1762684020,11400,11450,11440,40,0.35,11400,0,0,11400,11500
كيان2,صندوق س. با درآمد ثابت كيان,60,6000000,6000000,34932,1,1,-34931,-100,1,-34931,-100,1,1
اخزا003,اسنادخزانه-م3بودجه00-030418,59,43700,28160910000,643720,643930,644500,780,0.12,644410,690,0.11,643930,644990
ضخود5004,اختيارخ خودرو-2200-1401/05/12,57,2470,644704000,348,345,250,-98,-28.16,261,-87,-25,203,345
شپارس,بين‌ المللي‌ محصولات‌  پارس‌,57,929663,5215409430,5350,5610,5610,260,4.86,5430,80,1.5,5610,5610
سكه0110پ04,تمام سكه طرح جديد 0110 صادرات,56,10500,15232202300,1453847,1441000,1462886,9039,0.62,1450686,-3161,-0.22,1436014,1464900
وبازار,صندوق س شاخصي بازارآشنا,54,144349,1937070250,13920,13690,13340,-580,-4.17,13420,-500,-3.59,13330,13980
قنقش,قند نقش جهان,50,49895,6015531400,122100,120200,120900,-1200,-0.98,120700,-1400,-1.15,119700,122100
ضهرم6000,اختيارخ اهرم-10000-1401/06/30,49,3620,183009000,5512,6000,5000,-512,-9.29,5055,-457,-8.29,5000,6000
آينده,بازرگاني آينده سازان بهشت پارس,49,89966,1134471260,12990,12610,12610,-380,-2.93,12950,-40,-0.31,12610,12610
ارمغان,ص سرمايه گذاري ارمغان ايرانيان,49,578633,5841759409,10087,10093,10103,16,0.16,10096,9,0.09,10092,10103
دجابر,داروسازي‌ جابرابن‌حيان‌,48,250347,3109309740,13210,12420,12420,-790,-5.98,13030,-180,-1.36,12420,12420
بتك,كارخانجات كابل سازي‌ تك‌,48,83035,12604713000,148850,151800,151800,2950,1.98,151800,2950,1.98,151800,151800
ضملت3013,اختيارخ وبملت-4000-1401/03/18,46,1874,76849000,95,40,39,-56,-58.95,41,-54,-56.84,34,70
اخزا0022,اسنادخزانه-م2بودجه00-031024,46,1819,1051125310,578440,578020,578100,-340,-0.06,577860,-580,-0.1,575590,578920
گوهر2,صندوق سكه طلاي كيان,45,450000,450000,71785,1,1,-71784,-100,1,-71784,-100,1,1
سي تيپ2ن17,گواهي سيمان تيپ2ماهان كرمان(ن),45,1128000,8113704000,6499,7193,7193,694,10.68,6851,352,5.42,7193,7193
تسه0002,امتيازتسهيلاتمسكن ارديبهشت1400,45,792,1016768016,1351366,1283798,1283798,-67568,-5,1283798,-67568,-5,1283798,1283798
زعف0110پ16,زعفران0110نگين بيرجند(پ),44,191002,78310472000,390000,390000,410000,20000,5.13,409998,19998,5.13,390000,410000
شكبير,پتروشيمي اميركبير,44,258672,24509172000,97650,94750,94750,-2900,-2.97,96900,-750,-0.77,94750,94750
ضخود4015,اختيارخ خودرو-2800-1401/04/08,44,2001,48066000,41,11,20,-21,-51.22,24,-17,-41.46,11,43
كفرآور,فرآورده هاي سيمان شرق,43,569676,10966263000,19800,19250,19250,-550,-2.78,19250,-550,-2.78,19250,19250
سي تيپ2ن32,گواهي سيمان تيپ2هرمزگان(ن),43,2000000,10798000000,5389,5399,5399,10,0.19,5389,0,0,5399,5399
سايرا,ايرانيت‌,43,158765,4633358100,29350,29050,29300,-50,-0.17,29200,-150,-0.51,28800,29900
ضشنا8013,اختيارخ شپنا-5350-1401/08/29,42,508,694195000,1532,1400,1399,-133,-8.68,1367,-165,-10.77,1330,1500
داريوش,صندوق س. ثروت داريوش -س,41,214692,2419198708,11595,11710,11200,-395,-3.41,11268,-327,-2.82,11200,11710
حبندر,دريايي و کشتيراني خط دريابندر,40,210917,7455915950,34350,35350,35350,1000,2.91,35050,700,2.04,35350,35350
زعف0110پ20,زعفران0110نگين وحدت جام(پ),40,22968,8814946787,400180,398000,382202,-17978,-4.49,383793,-16387,-4.09,380004,398000
افق ملت,صندوق س در سهام افق ملت,39,21592,3384528440,158110,158110,157590,-520,-0.33,156750,-1360,-0.86,155000,159000
آتيمس,صندوق س.آرمان آتيه درخشان مس-س,38,14120,2889379976,208337,206000,204497,-3840,-1.84,204630,-3707,-1.78,202000,206600
اخزا007,اسنادخزانه-م7بودجه00-030912,37,79600,47217256000,592230,593000,593100,870,0.15,593180,950,0.16,592820,593960
اخزا009,اسناد خزانه-م9بودجه00-031101,37,207300,119408103000,576100,573220,576830,730,0.13,576020,-80,-0.01,573220,576830
اخزا010,اسناد خزانه-م10بودجه00-031115,36,57400,32826811100,571671,571671,572900,1229,0.21,571896,225,0.04,571100,572900
شيشه17ن,گواهي شيشه فلوت10بيرنگAكاويان,36,27920,48158119120,1897347,1724861,1724861,-172486,-9.09,1724861,-172486,-9.09,1724861,1724861
ضخود5005,اختيارخ خودرو-2400-1401/05/12,36,2168,353189000,230,180,157,-73,-31.74,163,-67,-29.13,150,180
فسديد,لوله‌وتجهيزات‌ سديد - ورشكسته,36,55258,2693827500,48300,48750,48750,450,0.93,48750,450,0.93,48750,48750
اخزا903,اسنادخزانه-م3بودجه99-011110,34,45300,39441661000,867960,867800,871000,3040,0.35,870680,2720,0.31,867800,871900
آسام,صندوق س.آرمان سپهر آشنا-م,34,270680,3962698330,15019,15019,14790,-229,-1.52,14640,-379,-2.52,14500,15020
ويستا,صندوق س. ويستا -س,34,356758,4547143449,13078,12864,12700,-378,-2.89,12746,-332,-2.54,12651,12999
قجام,فرآوردههاي غذايي وقندتربت‌جام‌,34,521082,3272394960,6400,6280,6280,-120,-1.88,6320,-80,-1.25,6280,6280
يارا,صندوق س. آريا-د,34,726549,7799392530,10728,10735,10735,7,0.07,10735,7,0.07,10734,10735
شيشه60ن,گواهي شيشه فلوت10بيرنگAاردكان,34,30000,84043560000,2801453,2801452,2801452,-1,0,2801452,-1,0,2801452,2801452
شيشه85ن,گواهي شيشه فلوت5بيرنگBآسا,34,12000,8104320000,742896,675360,675360,-67536,-9.09,675360,-67536,-9.09,675360,675360
بذر,صندوق س بذر اميد آفرين-سهام,34,6272,727669930,117080,117530,112860,-4220,-3.6,116020,-1060,-0.91,112610,119000
كصدف,كاشي صدف سرام استقلال آباده,33,72017,2715040900,36650,37700,37700,1050,2.86,36900,250,0.68,37700,37700
اخزا0042,اسنادخزانه-م4بودجه00-030522,33,1206,759774560,631220,616480,630080,-1140,-0.18,630000,-1220,-0.19,616480,630900
ضسپا3013,اختيارخ خساپا-1600-1401/03/25,32,1876,872270000,564,500,455,-109,-19.33,465,-99,-17.55,455,500
شصفها,پتروشيمي‌ اصفهان‌,32,76977,7705397700,102100,100100,100100,-2000,-1.96,100800,-1300,-1.27,100100,100100
زعف0110پ19,زعفران0110نگين تروند قاينات(پ),32,138090,56617247130,390000,413857,413857,23857,6.12,410002,20002,5.13,410000,413857
ضخود5003,اختيارخ خودرو-2000-1401/05/12,32,1300,501260000,522,390,390,-132,-25.29,386,-136,-26.05,322,495
فلات,گروه صنايع معادن فلات ايرانيان,30,359609,3711164880,10020,10320,10320,300,2.99,10130,110,1.1,10320,10320
شيشه48ن,گواهي شيشه فلوت4بيرنگAليا,30,57900,39534756900,751092,682811,682811,-68281,-9.09,682811,-68281,-9.09,682811,682811
وثنوح,ح. سرمايه گذاري ساختماني نوين,28,310120,405016720,1346,1306,1306,-40,-2.97,1306,-40,-2.97,1306,1306
كايتا,ايتالران‌,28,86429,3301587800,37100,38200,38200,1100,2.96,37450,350,0.94,38200,38200
صايند,صندوق س. گنجينه آينده روشن-د,27,312980,3157746070,10090,10090,10094,4,0.04,10089,-1,-0.01,10087,10100
پكويرح,ح. كوير تاير,26,1163939,4655756000,2494,4000,4000,1506,60.38,4000,1506,60.38,4000,4000
ضستا7002,اختيارخ شستا-900-1401/07/17,26,1647,386030000,260,250,229,-31,-11.92,234,-26,-10,225,250
صنوين,صندوق سرمايه‌گذاري صنوين-مختلط,26,2044,256071330,125970,125500,125000,-970,-0.77,125280,-690,-0.55,124770,125960
اخزا008,اسنادخزانه-م8بودجه00-030919,26,29100,17172229000,589190,590040,591490,2300,0.39,590110,920,0.16,589500,591490
پلاستح,ح.كارخانجات توليدي پلاستيران,25,107774,1434004800,14140,14100,13300,-840,-5.94,13310,-830,-5.87,13300,14100
مرواريد,صندوق س. مرواريد بها بازار-س,25,134578,1348548449,10066,10052,10011,-55,-0.55,10021,-45,-0.45,10001,10071
قتربت,قند تربت حيدريه,25,120145,2107343300,17030,17540,17540,510,2.99,17130,100,0.59,17540,17540
وسرمد,بيمه  سرمد,25,1038210,3185228280,3162,3068,3068,-94,-2.97,3130,-32,-1.01,3068,3068
شيشه56ن,گواهي شيشه فلوت4بيرنگAاردكان,25,50000,50820000000,1016400,1016400,1016400,0,0,1016400,0,0,1016400,1016400
ضصاد3016,اختيارخ وبصادر-2500-1401/03/11,25,831,1030000,3,10,1,-2,-66.67,1,-2,-66.67,1,10
سي تيپ2ن34,گواهي سيمان تيپ2ممتازان(ن),24,856000,6876248000,6022,8033,8033,2011,33.39,7651,1629,27.05,8033,8033
شيشه78ن,گواهي شيشه فلوت6بيرنگBآسا,24,13926,10321616976,815294,741176,741176,-74118,-9.09,741176,-74118,-9.09,741176,741176
ولتجار,واسپاري تجار ايرانيان,24,473234,1346350730,2763,2845,2845,82,2.97,2774,11,0.4,2845,2845
ضسپا8057,اختيارخ خساپا-3000-1401/08/25,23,1653,114617000,94,90,79,-15,-15.96,69,-25,-26.6,60,90
ضسپا3017,اختيارخ خساپا-3000-1401/03/25,23,1130,4520000,10,3,5,-5,-50,4,-6,-60,3,5
ضملي3009,اختيارخ فملي-4000-1401/03/02,23,237,789886000,3500,3350,3341,-159,-4.54,3333,-167,-4.77,3310,3400
ضملت3012,اختيارخ وبملت-3500-1401/03/18,22,324,98507000,509,440,300,-209,-41.06,304,-205,-40.28,300,440
ضفلا3013,اختيارخ فولاد-12000-1401/03/18,22,396,264539000,802,800,670,-132,-16.46,668,-134,-16.71,600,800
وآفري,بيمه كارآفرين,22,338189,1273896308,3766,3819,3766,0,0,3766,0,0,3766,3819
ثمين,صندوق س. ثروت افزون ثمين-س,22,83371,995447828,12269,12100,12030,-239,-1.95,11940,-329,-2.68,11800,12150
شيشه87ن,گواهي شيشه فلوت10بيرنگBكاوه,22,13600,22813374400,1845199,1677454,1677454,-167745,-9.09,1677454,-167745,-9.09,1677454,1677454
سي تيپ2ن30,گواهي سيمان تيپ2كرمان(ن),22,683000,5456487000,7101,7989,7989,888,12.51,7609,508,7.15,7989,7989
اخزا0052,اسنادخزانه-م5بودجه00-030626,21,943,582584840,618770,617780,618000,-770,-0.12,617800,-970,-0.16,613730,618230
سيناد,صندوق س.سپهرسودمند سينا-د,21,762647,7627742081,9998,10002,10001,3,0.03,10002,4,0.04,10001,10002
شيشه18ن,گواهي شيشه فلوت10بيرنگBكاويان,20,12920,20639997160,1757275,1597523,1597523,-159752,-9.09,1597523,-159752,-9.09,1597523,1597523
ضفلا3012,اختيارخ فولاد-10000-1401/03/18,20,430,1024250000,2614,2310,2440,-174,-6.66,2382,-232,-8.88,2102,2440
اخزا0012,اسنادخزانه-م1بودجه00-030821,20,1135,678395650,599530,598520,599500,-30,-0.01,597710,-1820,-0.3,585550,600000
اراد50,مرابحه عام دولت5-ش.خ0302,20,280200,280200006000,1000000,1000000,1000000,0,0,1000000,0,0,1000000,1000010
ماني2,صندوق س. با درآمد ثابت ماني,20,2000000,2000000,11725,1,1,-11724,-99.99,1,-11724,-99.99,1,1
ضسپا8051,اختيارخ خساپا-1900-1401/08/25,20,1288,544790000,1,460,440,439,43900,423,422,42200,400,460
ضستر3007,اختيارخ خگستر-4000-1401/03/22,19,436,42284000,217,160,60,-157,-72.35,97,-120,-55.3,60,160
ثهام,صندوق س ثروت هامرز-سهام,19,491911,5912555310,12090,11950,12020,-70,-0.58,12020,-70,-0.58,11770,12050
ضسپا8052,اختيارخ خساپا-2000-1401/08/25,19,960,348000000,460,350,390,-70,-15.22,362,-98,-21.3,350,390
اطلس2,صندوق س.توسعه اطلس مفيد-س,19,190000,190000,282848,1,1,-282847,-100,1,-282847,-100,1,1
اخزا0062,اسنادخزانه-م6بودجه00-030723,18,709,427941730,609390,596680,608520,-870,-0.14,603580,-5810,-0.95,596030,609500
ضشنا8017,اختيارخ شپنا-7350-1401/08/29,18,336,165516000,680,500,500,-180,-26.47,493,-187,-27.5,75,520
ضملي3012,اختيارخ فملي-6000-1401/03/02,18,305,422490000,1500,1351,1400,-100,-6.67,1385,-115,-7.67,1324,1400
خعمرا,توسعه و عمران شهرستان نائين,18,127912,1248421120,9480,9760,9760,280,2.95,9510,30,0.32,9760,9760
شيشه100ن,گواهي شيشه فلوت4بيرنگBدماوند,18,21600,13608000000,693000,630000,630000,-63000,-9.09,630000,-63000,-9.09,630000,630000
شيشه12ن,گواهي شيشه شيت4بيرنگAساوه,18,21700,10701311600,542463,493148,493148,-49315,-9.09,493148,-49315,-9.09,493148,493148
فردا2,صندوق س آواي فرداي زاگرس-ثابت,17,17000000,17000000,13100,1,1,-13099,-99.99,1,-13099,-99.99,1,1
ضهرم6001,اختيارخ اهرم-11000-1401/06/30,17,1700,76728000,4856,4936,4100,-756,-15.57,4513,-343,-7.06,4100,4936
ضپلا4008,اختيارخ پالايش-100000-01/04/29,17,1700,32150000,2026,2000,1900,-126,-6.22,1891,-135,-6.66,1600,2000
ثاژن,سخت آژند,17,88288,388732064,4492,4403,4403,-89,-1.98,4485,-7,-0.16,4403,4403
شيشه86ن,گواهي شيشه فلوت10بيرنگAكاوه,16,12000,22768164000,1897347,1897347,1897347,0,0,1897347,0,0,1897347,1897347
سي تيپ2ن24,گواهي سيمان تيپ2هگمتان(ن),16,650000,3644550000,5607,5607,5607,0,0,5607,0,0,5607,5607
طخود4013,اختيارف خودرو-2400-1401/04/08,16,486,69265000,110,130,130,20,18.18,143,33,30,130,160
شيشه02ن,گواهي شيشه فلوت6بيرنگBكاوه,15,11880,10176918840,942307,856643,856643,-85664,-9.09,856643,-85664,-9.09,856643,856643
شكف,كف,15,20205,932460750,45250,46150,46150,900,1.99,46150,900,1.99,46150,46150
اخزا815,اسنادخزانه-م15بودجه98-010406,15,10100,9903199000,979910,981500,981150,1240,0.13,980510,600,0.06,980090,981500
تكنو,تكنوتار,15,182930,1340876900,6990,7330,7330,340,4.86,7020,30,0.43,7330,7330
شتولي,تولي‌پرس‌,14,30426,516329220,16640,16970,16970,330,1.98,16970,330,1.98,16970,16970
شيشه58ن,گواهي شيشه فلوت6بيرنگAاردكان,14,19536,29784585600,1524600,1524600,1524600,0,0,1524600,0,0,1524600,1524600
اخزا909,اسنادخزانه-م9بودجه99-020316,14,118200,95960529000,812790,811700,811780,-1010,-0.12,811850,-940,-0.12,811700,813500
سي تيپ2ن35,گواهي سيمان تيپ2دشتستان(ن)	,14,624000,3567408000,5717,5717,5717,0,0,5445,-272,-4.76,5717,5717
شيشه49ن,گواهي شيشه فلوت4بيرنگBليا,13,13000,8743020000,672540,672540,672540,0,0,672540,0,0,672540,672540
پادا,صندوق س.پاداش سرمايه پارس-س,13,29800,3496053200,121259,121400,118500,-2759,-2.28,117317,-3942,-3.25,116700,121500
ضخود4010,اختيارخ خودرو-1900-1401/04/08,13,228,96525000,550,480,429,-121,-22,423,-127,-23.09,400,480
شيشه11ن,گواهي شيشه شيت3بيرنگAساوه,13,22743,8775955125,424463,385875,385875,-38588,-9.09,385875,-38588,-9.09,385875,385875
كابگن,توليدي و صنعتي آبگينه‌,13,24297,209683110,8710,8630,8630,-80,-0.92,8700,-10,-0.11,8630,8630
ضهرم6003,اختيارخ اهرم-13000-1401/06/30,13,850,21750000,3300,3000,2500,-800,-24.24,2559,-741,-22.45,2500,3000
اخزا908,اسنادخزانه-م8بودجه99-020606,12,104800,81534391000,777240,778000,778000,760,0.1,778000,760,0.1,777980,778000
ضخود5002,اختيارخ خودرو-1900-1401/05/12,12,554,259388000,594,490,470,-124,-20.88,468,-126,-21.21,450,490
ثروتم,صندوق س. ثروت آفرين پارسيان-س,12,7500,729031720,99158,98905,97204,-1954,-1.97,97204,-1954,-1.97,95711,98905
شيشه99ن,گواهي شيشه فلوت4بيرنگAدماوند,12,18200,12173070000,735735,668850,668850,-66885,-9.09,668850,-66885,-9.09,668850,668850
شيشه01ن,گواهي شيشه فلوت6بيرنگAكاوه,12,9768,8957441592,1008721,917019,917019,-91702,-9.09,917019,-91702,-9.09,917019,917019
فبستم,صنايع ‌بسته‌بندي‌ مشهد,11,18018,346666320,18680,19240,19240,560,3,18700,20,0.11,19240,19240
شيشه112ن,گواهي شيشه فلوت8بيرنگBآسا,11,6500,7230743000,1223664,1112422,1112422,-111242,-9.09,1112422,-111242,-9.09,1112422,1112422
گنجين,صندوق س. گنجينه يكم آويد-د,11,21220,329859316,15532,15545,15537,5,0.03,15545,13,0.08,15537,15545
ضترا3015,اختيارخ شتران-5000-1401/03/08,11,258,74275000,538,350,370,-168,-31.23,288,-250,-46.47,220,450
ضجار7051,اختيارخ وتجارت-2180-1401/07/20,11,230,68722000,384,300,290,-94,-24.48,299,-85,-22.14,290,300
ضستر3005,اختيارخ خگستر-3500-1401/03/22,11,800,269945000,839,400,349,-490,-58.4,337,-502,-59.83,300,400
ضسپا3014,اختيارخ خساپا-1800-1401/03/25,11,260,80100000,383,300,300,-83,-21.67,308,-75,-19.58,300,310
ضذوب3001,اختيارخ ذوب-2500-1401/03/04,10,115,23696000,403,201,190,-213,-52.85,206,-197,-48.88,190,300
شيشه75ن,گواهي شيشه فلوت4بيرنگBكاويان,10,19700,12296917300,624209,624209,624209,0,0,624209,0,0,624209,624209
ثاصفا,شركت‌ ساختمان‌ اصفهان‌,10,138802,1618431320,12020,11660,11660,-360,-3,11960,-60,-0.5,11660,11660
شيشه59ن,گواهي شيشه فلوت8بيرنگAاردكان,10,10000,21344400000,2134440,2134440,2134440,0,0,2134440,0,0,2134440,2134440
ضملي3014,اختيارخ فملي-8000-1401/03/02,10,218,449000,21,2,19,-2,-9.52,2,-19,-90.48,1,19
ضجار7050,اختيارخ وتجارت-1980-1401/07/20,10,372,156272000,515,420,420,-95,-18.45,420,-95,-18.45,420,421
شيشه04ن,گواهي شيشه فلوت8بيرنگBكاوه,10,7450,8287551350,1223665,1112423,1112423,-111242,-9.09,1112423,-111242,-9.09,1112423,1112423
تسه9903,امتياز تسهيلات مسكن خرداد99,10,1058,1274969350,1268500,1205075,1205075,-63425,-5,1205075,-63425,-5,1205075,1205075
سي تيپ2ن02,گواهي سيمان تيپ2صوفيان(ن),10,152000,1121152000,6890,7376,7376,486,7.05,7025,135,1.96,7376,7376
اخزا910,اسنادخزانه-م10بودجه99-020807,9,3300,2475526000,751000,751100,750000,-1000,-0.13,750160,-840,-0.11,749510,751100
ضسپا3011,اختيارخ خساپا-1200-1401/03/25,9,355,315837000,938,915,899,-39,-4.16,890,-48,-5.12,850,915
شيشه80ن,گواهي شيشه فلوت4بيرنگBآذر,9,11200,6526800000,641025,582750,582750,-58275,-9.09,582750,-58275,-9.09,582750,582750
اراد874,مرابحه عام دولت87-ش.خ030304,9,101793714,96011179698863,950000,958319,927800,-22200,-2.34,943194,-6806,-0.72,927800,958319
اخزا0092,اسناد خزانه-م9بودجه00-031101,9,445,255875500,576100,575100,576010,-90,-0.02,575000,-1100,-0.19,574020,576010
ثبات2,صندوق س. ثبات ويستا -د,9,33200000,33200000,11586,1,1,-11585,-99.99,1,-11585,-99.99,1,1
اوج,صندوق س.اوج دماوند-س,9,36440,417523520,11486,11458,11457,-29,-0.25,11458,-28,-0.24,11457,11458
سلار,شركت سيمان لارستان,9,21477,889147800,42650,41400,41400,-1250,-2.93,42550,-100,-0.23,41400,41400
طخود4012,اختيارف خودرو-2200-1401/04/08,9,469,28830000,45,50,70,25,55.56,61,16,35.56,50,70
سي تيپ2ن04,گواهي سيمان تيپ2فارس نو(ن),8,206000,1580844000,7348,7674,7674,326,4.44,7309,-39,-0.53,7674,7674
اخزا8152,اسنادخزانه-م15بودجه98-010406,8,244,234292650,979910,931070,982490,2580,0.26,960220,-19690,-2.01,931070,982490
اراد604,مرابحه عام دولتي6-ش.خ0210,8,29409600,28377017233600,985500,986048,943810,-41690,-4.23,964890,-20610,-2.09,943810,986048
اخزا0032,اسنادخزانه-م3بودجه00-030418,8,374,240420550,643720,642720,642740,-980,-0.15,642840,-880,-0.14,642720,643930
سخند,صندوق س.سپهرخبرگان نفت-د,8,30060,302631800,10061,10071,10070,9,0.09,10068,7,0.07,10062,10071
اخزا0072,اسنادخزانه-م7بودجه00-030912,8,267,157876110,592230,590000,591460,-770,-0.13,591300,-930,-0.16,590000,591470
شيشه03ن,گواهي شيشه فلوت8بيرنگAكاوه,8,8000,10332632000,1291579,1291579,1291579,0,0,1291579,0,0,1291579,1291579
خاتم2,صندوق س خاتم ايساتيس پويا-ثابت,7,6500000,6500000,13524,1,1,-13523,-99.99,1,-13523,-99.99,1,1
اخزا914,اسنادخزانه-م14بودجه99-021025,7,57500,41325800000,719610,718060,718360,-1250,-0.17,718710,-900,-0.13,718060,720350
اراد61,مرابحه عام دولت61-ش.خ0309,7,90000,90000000000,1000000,1000000,1000000,0,0,1000000,0,0,1000000,1000000
سپرمي,پرميت‌,7,7610,200143000,26050,26300,26300,250,0.96,26300,250,0.96,26300,26300
اخزا814,اسنادخزانه-م14بودجه98-010318,7,1000,990697000,990400,990410,990670,270,0.03,990700,300,0.03,990410,991000
اراد864,مرابحه عام دولت86-ش.خ020404,7,115849980,110452907080290,965000,951498,955530,-9470,-0.98,953413,-11587,-1.2,951439,955530
كارا2,صندوق س. كارا -د,7,54000000,54000000,11379,1,1,-11378,-99.99,1,-11378,-99.99,1,1
ضپلا4006,اختيارخ پالايش-80000-01/04/29,7,700,35000000,7091,5000,5000,-2091,-29.49,5000,-2091,-29.49,5000,5000
شيشه91ن,گواهي شيشه فلوت6بيرنگBكاويان,7,4752,3876919200,897435,815850,815850,-81585,-9.09,815850,-81585,-9.09,815850,815850
شيشه74ن,گواهي شيشه فلوت4بيرنگAكاويان,7,12000,7647456000,637288,637288,637288,0,0,637288,0,0,637288,637288
اراد90,مرابحه عام دولت90-ش.خ050217,6,150000,142252500000,968700,948350,948350,-20350,-2.1,948350,-20350,-2.1,948350,948350
اراد404,مرابحه عام دولت4-ش.خ 0207,6,41594080,39599957628850,989990,952009,952500,-37490,-3.79,952058,-37932,-3.83,951913,952500
اخزا902,اسنادخزانه-م2بودجه99-011019,6,3100,2731050000,877850,879800,885800,7950,0.91,880980,3130,0.36,879800,885880
اخزا9012,اسنادخزانه-م1بودجه99-010621,6,234,215370650,938280,891370,938030,-250,-0.03,920390,-17890,-1.91,891370,938030
اراد654,مرابحه عام دولتي65-ش.خ0210,6,58573854,55765190885544,985000,947430,1000000,15000,1.52,952049,-32951,-3.35,945500,1000000
اراد644,مرابحه عام دولتي64-ش.خ0111,6,47920000,46547848110000,957500,971321,970000,12500,1.31,971366,13866,1.45,970000,971400
اخزا0094,اسناد خزانه-م9بودجه00-031101,6,33540000,19078857540000,576100,563138,574560,-1540,-0.27,568839,-7261,-1.26,563106,574560
اخزا817,اسنادخزانه-م17بودجه98-010512,6,2300,2208718000,960000,959510,961600,1600,0.17,960310,310,0.03,959510,961600
اخزا816,اسنادخزانه-م16بودجه98-010503,6,1900,1836232000,964570,963010,967000,2430,0.25,966440,1870,0.19,963010,967000
شتهران,داروسازي تهران شيمي,6,15709,643283550,40150,40950,40950,800,1.99,40950,800,1.99,40950,40950
اراد584,مرابحه عام دولت5-ش.خ 0110,6,43801422,42719081120733,962000,971548,979055,17055,1.77,975290,13290,1.38,971490,979055
شيشه10ن,گواهي شيشه شيت2بيرنگAساوه,6,20000,8824560000,441228,441228,441228,0,0,441228,0,0,441228,441228
شيشه111ن,گواهي شيشه فلوت8بيرنگAآسا,6,4000,5166312000,1291578,1291578,1291578,0,0,1291578,0,0,1291578,1291578
شيشه21ن,گواهي شيشه فلوت4بيرنگAآسا,5,8200,4983574600,668528,607753,607753,-60775,-9.09,607753,-60775,-9.09,607753,607753
افاد744,منفعت دولت7-ش.خاص ساير0204,5,7996000,7758337376000,971520,969162,972170,650,0.07,970277,-1243,-0.13,969122,972170
ضذوب3000,اختيارخ ذوب-2000-1401/03/04,5,45,32675000,853,715,750,-103,-12.08,726,-127,-14.89,701,750
اراد334,مرابحه عام دولت3-ش.خ 0303,5,5723200,5198674796500,980000,892035,1000000,20000,2.04,908351,-71649,-7.31,891963,1000000
سي تيپ2ن19,گواهي سيمان تيپ2غرب آسيا(ن),5,110000,580470000,5277,5277,5277,0,0,5277,0,0,5277,5277
شيشه82ن,گواهي شيشه فلوت10بيرنگA ليا,5,4000,8261980000,2065495,2065495,2065495,0,0,2065495,0,0,2065495,2065495
ثهام2,صندوق س ثروت هامرز-سهام,5,500000,500000,12090,1,1,-12089,-99.99,1,-12089,-99.99,1,1
اخزا8172,اسنادخزانه-م17بودجه98-010512,5,116,108166600,960000,958000,912440,-47560,-4.95,932470,-27530,-2.87,912440,958000
اراد384,مرابحه عام دولت3-ش.خ 0105,5,7381972,7289049723812,987500,986800,988630,1130,0.11,987412,-88,-0.01,986721,988630
اراد364,مرابحه عام دولت3-ش.خ 0104,5,55377800,55061931788000,990000,994001,994640,4640,0.47,994296,4296,0.43,993960,996800
زيتون2,صندوق س زيتون نماد پايا- مختلط,5,1530000,1530000,12500,1,1,-12499,-99.99,1,-12499,-99.99,1,1
ضكاريس304,اختيارخ كاريس-15000-14010331,5,96,57610000,750,610,600,-150,-20,600,-150,-20,600,610
ضخود4009,اختيارخ خودرو-1800-1401/04/08,5,22,11144000,647,544,500,-147,-22.72,507,-140,-21.64,480,544
ضخود5006,اختيارخ خودرو-2600-1401/05/12,5,300,27000000,130,90,90,-40,-30.77,90,-40,-30.77,90,90
اراد854,مرابحه عام دولت85-ش.خ010704,5,69868700,68801252916700,977750,979081,993710,15960,1.63,984722,6972,0.71,979041,993710
شيشه77ن,گواهي شيشه فلوت6بيرنگAآسا,5,5940,5706480780,960687,960687,960687,0,0,960687,0,0,960687,960687
اخزا0082,اسنادخزانه-م8بودجه00-030919,5,190,111947860,589190,589050,589260,70,0.01,589200,10,0,589050,589260
شيشه101ن,گواهي شيشه فلوت5بيرنگAدماوند,5,4720,3949932000,920535,836850,836850,-83685,-9.09,836850,-83685,-9.09,836850,836850
شيشه50ن,گواهي شيشه فلوت6بيرنگAليا,5,5808,5967179856,1130147,1027407,1027407,-102740,-9.09,1027407,-102740,-9.09,1027407,1027407
اخزا901,اسنادخزانه-م1بودجه99-010621,5,700,657756000,938280,937010,940220,1940,0.21,939650,1370,0.15,937010,940220
ضستر3006,اختيارخ خگستر-3750-1401/03/22,5,200,58070000,401,350,280,-121,-30.17,290,-111,-27.68,280,350
زعف0110پ10,زعفران0110نگين طلاي سرخ(پ),4,788,315329992,403845,406499,400000,-3845,-0.95,400165,-3680,-0.91,400000,406500
ضستر3009,اختيارخ خگستر-5000-1401/03/22,4,134,2004000,33,30,12,-21,-63.64,15,-18,-54.55,12,30
ضملت3011,اختيارخ وبملت-3000-1401/03/18,4,20,17050000,1000,850,850,-150,-15,852,-148,-14.8,850,855
شيشه52ن,گواهي شيشه فلوت8بيرنگAليا,4,4000,5275296000,1450707,1318824,1318824,-131883,-9.09,1318824,-131883,-9.09,1318824,1318824
سي تيپ2ن07,گواهي سيمان تيپ 2تهران(ن),4,89000,652459000,6408,7331,7331,923,14.4,6982,574,8.96,7331,7331
اخزا0064,اسنادخزانه-م6بودجه00-030723,4,18830368,11435868691920,609390,606890,607740,-1650,-0.27,607310,-2080,-0.34,606855,607740
اراد964,مرابحه عام دولت96-ش.خ030414,4,11362780,10492204992130,963500,922987,927800,-35700,-3.71,923384,-40116,-4.16,922985,927800
اراد1004,مرابحه عام دولت100-ش.خ021127,4,42424775,39519757482170,980000,934437,926000,-54000,-5.51,931525,-48475,-4.95,926000,934437
اراد424,مرابحه عام دولت4-ش.خ 0106,4,5004600,4935952876500,988500,985952,986660,-1840,-0.19,986283,-2217,-0.22,985895,986660
اراد544,مرابحه عام دولت5-ش.خ 0109,4,32742000,32123859759000,999990,975221,987044,-12946,-1.29,981121,-18869,-1.89,975185,987044
اراد454,مرابحه عام دولت4-ش.خ 0107,4,7316000,7217063758000,1000000,980669,992300,-7700,-0.77,986477,-13523,-1.35,980651,992300
اراد1024,مرابحه عام دولت102-ش.خ031211,4,43345780,39220620669250,918930,903665,906030,-12900,-1.4,904831,-14099,-1.53,903595,906030
ضملت3010,اختيارخ وبملت-2500-1401/03/18,4,86,113950000,1300,1355,1300,0,0,1325,25,1.92,1300,1355
اخزا0044,اسنادخزانه-م4بودجه00-030522,4,5059980,3185726588140,631220,628876,630310,-910,-0.14,629593,-1627,-0.26,628875,630310
اخزا0102,اسناد خزانه-م10بودجه00-031115,4,206,117609800,571671,571000,571000,-671,-0.12,570920,-751,-0.13,570730,571000
اخزا9024,اسنادخزانه-م2بودجه99-011019,4,10985676,9633690810670,877850,874905,878960,1110,0.13,876932,-918,-0.1,874903,878960
ضرنا4009,اختيارخ ورنا-6000-1401/04/22,4,14,5788000,600,400,410,-190,-31.67,413,-187,-31.17,400,420
اراد954,مرابحه عام دولت95-ش.خ020514,4,29999980,28505815996230,971200,949463,950950,-20250,-2.09,950194,-21006,-2.16,949427,950950
افاد44,منفعت دولتي4-شرايط خاص14010729,4,16012000,15899120340000,999990,986017,999890,-100,-0.01,992950,-7040,-0.7,986000,999890
اراد324,مرابحه عام دولت3-ش.خ0211,4,4132776,3798211745664,930000,921458,913900,-16100,-1.73,919046,-10954,-1.18,913800,921458
اراد344,مرابحه عام دولت3-ش.خ 0305,4,38986600,34513881808300,1000000,884151,886400,-113600,-11.36,885275,-114725,-11.47,884151,886400
اخزا9102,اسنادخزانه-م10بودجه99-020807,4,186,132732700,751000,713450,714070,-36930,-4.92,713620,-37380,-4.98,713450,714070
اخزا818,اسنادخزانه-م18بودجه98-010614,4,8500,8020635000,941580,942000,944000,2420,0.26,943600,2020,0.21,942000,944000
هماي2,صندوق س هماي آگاه-ثابت,4,43534000,43534000,10007,1,1,-10006,-99.99,1,-10006,-99.99,1,1
اراد96,مرابحه عام دولت96-ش.خ030414,4,5000,4802000000,963500,963500,963500,0,0,960400,-3100,-0.32,948000,963500
اراد534,مرابحه عام دولت5-ش.خ 0207,4,12500000,12175393750000,994860,995465,952600,-42260,-4.25,974031,-20829,-2.09,952600,995465
اراد914,مرابحه عام دولت91-ش.خ010525,4,54000000,53202417000000,981610,984301,986180,4570,0.47,985230,3620,0.37,984244,986180
اراد494,مرابحه عام دولت4-ش.خ 0206,4,22424000,21490755256000,989990,958080,958700,-31290,-3.16,958382,-31608,-3.19,958063,958700
اراد934,مرابحه عام دولت93-ش.خ010809,4,30000000,29425275000000,975000,973775,987950,12950,1.33,980842,5842,0.6,973715,987950
سي تيپ2ن31,گواهي سيمان تيپ2گيلان سبز(ن),4,115000,644805000,5607,5607,5607,0,0,5607,0,0,5607,5607
ضشنا8018,اختيارخ شپنا-8350-1401/08/29,4,220,58863000,340,331,250,-90,-26.47,268,-72,-21.18,250,331
ضپنا7050,اختيارخ رمپنا-13000-1401/07/12,3,40,205200000,5550,5120,5140,-410,-7.39,5130,-420,-7.57,5120,5140
ضملت3009,اختيارخ وبملت-2000-1401/03/18,3,26,49110000,1998,1888,1889,-109,-5.46,1889,-109,-5.46,1888,1889
گنجينه2,صندوق س. گنجينه داريوش-د,3,13000000,13000000,10168,1,1,-10167,-99.99,1,-10167,-99.99,1,1
اراد99,مرابحه عام دولت99-ش.خ050723,3,60000,60000000000,1000000,1000000,1000000,0,0,1000000,0,0,1000000,1000000
سي تيپ2ن11,گواهي سيمان تيپ2دورود(ن),3,53000,359552000,5887,6784,6784,897,15.24,6461,574,9.75,6784,6784
سي تيپ2ن01,گواهي سيمان تيپ 2 فارس(ن),3,40000,316840000,7343,7921,7921,578,7.87,7544,201,2.74,7921,7921
سي تيپ2ن22,گواهي سيمان تيپ2كردستان(ن),3,128000,778880000,6051,6085,6085,34,0.56,5796,-255,-4.21,6085,6085
رماس2,صندوق س.راهبرد ممتازابن سينا-س,3,219358,219358,13234,1,1,-13233,-99.99,1,-13233,-99.99,1,1
اخزا0014,اسنادخزانه-م1بودجه00-030821,3,4143216,2475243196904,599530,596973,598790,-740,-0.12,597421,-2109,-0.35,596927,598790
شيشه107ن,گواهي شيشه فلوت10بيرنگAدماوند,3,2520,4781455560,2087143,1897403,1897403,-189740,-9.09,1897403,-189740,-9.09,1897403,1897403
طلا2,صندوق س.پشتوانه طلاي لوتوس,3,300000,300000,101852,1,1,-101851,-100,1,-101851,-100,1,1
داريك2,صندوق س.اعتماد داريك-د,3,700000,700000,12647,1,1,-12646,-99.99,1,-12646,-99.99,1,1
اراد944,مرابحه عام دولت94-ش.خ030816,3,6430000,5995553400000,975990,951288,928980,-47010,-4.82,932434,-43556,-4.46,914076,951288
اراد434,مرابحه عام دولت4-ش.خ 0205,3,4136100,3974897014000,960960,960248,961500,540,0.06,961025,65,0.01,960248,961500
طسپا3015,اختيارف خساپا-2000-1401/03/25,3,200,11700000,39,59,59,20,51.28,58,19,48.72,58,59
ضپنا7049,اختيارخ رمپنا-12000-1401/07/12,3,50,301300000,6700,6010,6030,-670,-10,6026,-674,-10.06,6010,6030
اراد554,مرابحه عام دولت5-ش.خ 0209,3,16775019,15917712066261,999490,948784,949160,-50330,-5.04,948894,-50596,-5.06,948729,949160
اراد704,مرابحه عام دولت70-ش.خ0112,3,37228000,36125789944000,943750,969796,965800,22050,2.34,970393,26643,2.82,965800,1000000
طخود3058,اختيارف خودرو-2500-1401/03/04,3,3,581000,134,180,200,66,49.25,194,60,44.78,180,201
ضخود3059,اختيارخ خودرو-3000-1401/03/04,3,35,35000,1,1,1,0,0,1,0,0,1,1
اخزا8154,اسنادخزانه-م15بودجه98-010406,3,4356384,4257697279632,979910,977386,977300,-2610,-0.27,977347,-2563,-0.26,977300,977386
افاد614,منفعت دولت6-ش.خاص140109,3,12999000,12812324473500,975000,982703,990350,15350,1.57,985639,10639,1.09,982682,990350
اخزا8144,اسنادخزانه-م14بودجه98-010318,3,5138502,5076792760554,990400,988046,987870,-2530,-0.26,987991,-2409,-0.24,987870,988046
سي تيپ2ن27,گواهي سيمان تيپ2آبيك(ن),3,62000,418314000,5982,6747,6747,765,12.79,6426,444,7.42,6747,6747
شيشه88ن,گواهي شيشه فلوت5بيرنگAكاوه,3,2000,1595538000,835758,797769,797769,-37989,-4.55,797769,-37989,-4.55,797769,797769
شيشه62ن,گواهي شيشه فلوت4بيرنگAكاوه,3,4000,2673036000,668260,668259,668259,-1,0,668259,-1,0,668259,668259
شيشه76ن,گواهي شيشه فلوت8بيرنگAكاويان,3,2900,3410397100,1293599,1175999,1175999,-117600,-9.09,1175999,-117600,-9.09,1175999,1175999
زر2,صندوق س.پشتوانه سكه طلاي زر,3,300000,300000,62725,1,1,-62724,-100,1,-62724,-100,1,1
شيشه92ن,گواهي شيشه فلوت8بيرنگBكاويان,3,2350,2489707500,1165395,1059450,1059450,-105945,-9.09,1059450,-105945,-9.09,1059450,1059450
شيشه31ن,گواهي شيشه فلوت6بيرنگBآذر,3,2376,1916481600,887260,806600,806600,-80660,-9.09,806600,-80660,-9.09,806600,806600
طفلا3013,اختيارف فولاد-12000-1401/03/18,3,8,1600000,300,200,200,-100,-33.33,200,-100,-33.33,200,200
ضملي3010,اختيارخ فملي-4500-1401/03/02,3,3,8371000,4000,2760,2850,-1150,-28.75,2790,-1210,-30.25,2760,2850
شيشه97ن,گواهي شيشه فلوت3بيرنگAدماوند,3,4522,2853608100,694155,631050,631050,-63105,-9.09,631050,-63105,-9.09,631050,631050
سي تيپ2ن25,گواهي سيمان تيپ2نهاوند(ن),2,31000,179056000,5607,5776,5776,169,3.01,5607,0,0,5776,5776
وخاور2,بانك خاورميانه,2,74999992,446999952320,5940,5960,5960,20,0.34,5960,20,0.34,5960,5960
سي تيپ2ن03,گواهي سيمان تيپ2اروميه(ن),2,90000,563850000,5887,6265,6265,378,6.42,5967,80,1.36,6265,6265
ضصاد3012,اختيارخ وبصادر-1400-1401/03/11,2,60,41700000,768,670,700,-68,-8.85,695,-73,-9.51,670,700
ضصاد3013,اختيارخ وبصادر-1600-1401/03/11,2,26,14820000,660,600,470,-190,-28.79,570,-90,-13.64,470,600
شيشه61ن,گواهي شيشه فلوت12بيرنگAاردكان,2,990,2874960000,2904000,2904000,2904000,0,0,2904000,0,0,2904000,2904000
ضستر3000,اختيارخ خگستر-2400-1401/03/22,2,6,9000000,1650,1500,1500,-150,-9.09,1500,-150,-9.09,1500,1500
زعف0110پ05,زعفران0110نگين زرين(پ),2,74,29230000,392026,395000,395000,2974,0.76,395000,2974,0.76,395000,395000
اراد724,مرابحه عام دولت72-ش.خ0311,2,3196400,3028871881400,977000,967437,927740,-49260,-5.04,947588,-29412,-3.01,927740,967437
سي تيپ2ن10,گواهي سيمان تيپ 2غرب(ن),2,62000,364994000,5887,5887,5887,0,0,5607,-280,-4.76,5887,5887
اراد214,مرابحه عام دولت2ش.خ صادرات0212,2,33056000,31672160144000,960000,965124,951149,-8851,-0.92,958136,-1864,-0.19,951149,965124
تملي703,تسهيلات مسكن ب. ملي-خرداد97,2,19,11580758,595412,625182,595412,0,0,609514,14102,2.37,595412,625182
سي تيپ2ن38,گواهي سيمان تيپ2مازندران(ن),2,94000,622186000,6014,6619,6619,605,10.06,6489,475,7.9,6619,6619
اراد834,مرابحه عام دولت83-ش.خ041220,2,30000000,27189375000000,1000000,905120,907505,-92495,-9.25,906312,-93688,-9.37,905120,907505
سي تيپ2ن21,گواهي سيمان تيپ2زاوه تربت(ن),2,67000,375669000,5607,5607,5607,0,0,5607,0,0,5607,5607
اراد314,مرابحه عام دولت3-ش.خ 0208,2,5000000,4634437500000,929180,926275,927500,-1680,-0.18,926887,-2293,-0.25,926275,927500
ضصاد3015,اختيارخ وبصادر-2000-1401/03/11,2,11,1910000,204,110,180,-24,-11.76,174,-30,-14.71,110,180
ضذوب8004,اختيارخ ذوب-2740-1401/08/04,2,200,100000000,610,500,500,-110,-18.03,500,-110,-18.03,500,500
سي تيپ2ن06,گواهي سيمان تيپ 2شاهرود(ن),2,77000,453299000,5887,5887,5887,0,0,5607,-280,-4.76,5887,5887
اخزا9164,اسنادخزانه-م16بودجه99-020528,2,106662000,83217425745000,791320,779095,781300,-10020,-1.27,780197,-11123,-1.41,779095,781300
اخزا9034,اسنادخزانه-م3بودجه99-011110,2,7303200,6345896544000,867960,868470,869370,1410,0.16,868920,960,0.11,868470,869370
افاد844,منفعت دولت8-ش.خاص ساير0205,2,11999000,11641963755500,950000,969712,970777,20777,2.19,970244,20244,2.13,969712,970777
اخزا9084,اسنادخزانه-م8بودجه99-020606,2,1599980,1239430906920,777240,774538,774770,-2470,-0.32,774654,-2586,-0.33,774538,774770
اراد984,مرابحه عام دولت98-ش.خ050723,2,24000000,21542196000000,1010000,896303,898880,-111120,-11,897591,-112409,-11.13,896303,898880
ضپنا7052,اختيارخ رمپنا-15000-1401/07/12,2,50,184000000,4500,3600,3700,-800,-17.78,3680,-820,-18.22,3600,3700
پتروما,صندوق س.بخشي پتروشيمي دماوند-ب,2,32618,355177402,10888,10889,10889,1,0.01,10889,1,0.01,10889,10889
اراد904,مرابحه عام دولت90-ش.خ050217,2,14000000,12660165000000,968700,903085,905510,-63190,-6.52,904297,-64403,-6.65,903085,905510
اخزا0114,اسناد خزانه-م11بودجه00-030619,2,99979900,62140307287200,604750,622056,621000,16250,2.69,621528,16778,2.77,621000,622056
اخزا8204,اسنادخزانه-م20بودجه98-020806,2,3950162,2957741074849,751330,747229,750300,-1030,-0.14,748764,-2566,-0.34,747229,750300
افاد514,منفعت دولت5-ش.خاص كاردان0108,2,2000000,1980186000000,999999,984606,995580,-4419,-0.44,990093,-9906,-0.99,984606,995580
اراد134,مرابحه عام دولت1-ش.خ ساير0206,2,9999000,9681186784500,963950,968626,967805,3855,0.4,968215,4265,0.44,967805,968626
اخزا9104,اسنادخزانه-م10بودجه99-020807,2,2138560,1598198282720,751000,746639,748010,-2990,-0.4,747324,-3676,-0.49,746639,748010
اخزا8194,اسنادخزانه-م19بودجه98-020322,2,19934694,16195244426010,810300,813330,811500,1200,0.15,812415,2115,0.26,811500,813330
اخزا0034,اسنادخزانه-م3بودجه00-030418,2,2360000,1515444500000,643720,641905,642370,-1350,-0.21,642137,-1583,-0.25,641905,642370
اخزا9074,اسنادخزانه-م7بودجه99-020704,2,2799926,2132038651775,764850,759955,762970,-1880,-0.25,761462,-3388,-0.44,759955,762970
اراد894,مرابحه عام دولت89-ش.خ041120,2,11398000,10348956575000,997000,906795,909130,-87870,-8.81,907962,-89038,-8.93,906795,909130
اراد524,مرابحه عام دولت5-ش.خ 0108,2,12666000,12495610635000,1000000,985005,988090,-11910,-1.19,986547,-13453,-1.35,985005,988090
اراد884,مرابحه عام دولت88-ش.خ041120,2,33100000,30043132250000,1000000,906465,908830,-91170,-9.12,907647,-92353,-9.24,906465,908830
اوصتا2,صندوق انديشه ورزان صباتامين -د,2,11000000,11000000,22695,1,1,-22694,-100,1,-22694,-100,1,1
اخزا8214,اسنادخزانه-م21بودجه98-020906,2,3887676,2862357826302,740670,736529,736000,-4670,-0.63,736264,-4406,-0.59,736000,736529
شيشه93ن,گواهي شيشه فلوت5بيرنگAكاويان,2,3120,2370513600,835758,759780,759780,-75978,-9.09,759780,-75978,-9.09,759780,759780
اراد794,مرابحه عام دولت79-ش.خ010612,2,9571000,9431196403000,974000,985358,985428,11428,1.17,985393,11393,1.17,985358,985428
اخزا0074,اسنادخزانه-م7بودجه00-030912,2,2780000,1642625550000,592230,590595,591150,-1080,-0.18,590872,-1358,-0.23,590595,591150
ضسپا8047,اختيارخ خساپا-1500-1401/08/25,2,100,74500000,878,745,745,-133,-15.15,745,-133,-15.15,745,745
ضشنا8012,اختيارخ شپنا-4850-1401/08/29,2,101,181900000,2058,1900,1800,-258,-12.54,1801,-257,-12.49,1800,1900
ضخود3055,اختيارخ خودرو-1600-1401/03/04,2,4,2400000,920,600,600,-320,-34.78,600,-320,-34.78,600,600
ضپنا7051,اختيارخ رمپنا-14000-1401/07/12,2,20,89000000,4900,4400,4500,-400,-8.16,4450,-450,-9.18,4400,4500
اخزا9064,اسنادخزانه-م6بودجه99-020321,2,17546408,14147335388648,810440,805612,806950,-3490,-0.43,806281,-4159,-0.51,805612,806950
شيشه89ن,گواهي شيشه فلوت5بيرنگBكاوه,2,2000,1485792000,742896,742896,742896,0,0,742896,0,0,742896,742896
اراد814,مرابحه عام دولت81-ش.خ010812,2,42600000,41997976800000,1000000,978936,992800,-7200,-0.72,985868,-14132,-1.41,978936,992800
شيشه73ن,گواهي شيشه شيت6بيرنگAساوه,2,990,757944000,803880,765600,765600,-38280,-4.76,765600,-38280,-4.76,765600,765600
اخزا8142,اسنادخزانه-م14بودجه98-010318,2,26,25164930,990400,1039920,950730,-39670,-4.01,967880,-22520,-2.27,950730,1039920
اراد594,مرابحه عام دولتي5-ش.خ 0309,2,16000000,14853392000000,1000000,926574,930100,-69900,-6.99,928337,-71663,-7.17,926574,930100
اراد394,مرابحه عام دولت3-ش.خ 0204,2,20000000,19223510000000,950000,959801,962550,12550,1.32,961175,11175,1.18,959801,962550
اراد664,مرابحه عام دولت66-ش.خ0310,2,20000000,18561600000000,1000000,927160,929000,-71000,-7.1,928080,-71920,-7.19,927160,929000
شيشه109ن,گواهي شيشه فلوت2بيرنگAدماوند,2,5000,3344250000,735735,668850,668850,-66885,-9.09,668850,-66885,-9.09,668850,668850
اراد1014,مرابحه عام دولت101-ش.خ020711,2,4000000,3853918000000,949000,982659,944300,-4700,-0.5,963479,14479,1.53,944300,982659
ضملت3014,اختيارخ وبملت-4500-1401/03/18,2,31,490000,30,30,8,-22,-73.33,16,-14,-46.67,8,30
ضصاد3014,اختيارخ وبصادر-1800-1401/03/11,2,6,1758000,286,293,293,7,2.45,293,7,2.45,293,293
ضرنا4005,اختيارخ ورنا-4000-1401/04/22,1,30,72000000,2579,2400,2400,-179,-6.94,2400,-179,-6.94,2400,2400
سميعا101,سلف موازي استاندارد سميعا101,1,100,131115300,1310633,1311153,1311153,520,0.04,1311153,520,0.04,1311153,1311153
سي تيپ2ن36,گواهي سيمان تيپ2منددشتي(ن),1,25000,143925000,5483,5757,5757,274,5,5483,0,0,5757,5757
اخزا8212,اسنادخزانه-م21بودجه98-020906,1,80,58800800,740670,735010,735010,-5660,-0.76,735010,-5660,-0.76,735010,735010
پارند4,صندوق س. پارند پايدار سپهر,1,99000000,1000098000000,10095,10102,10102,7,0.07,10102,7,0.07,10102,10102
سميعا102,سلف موازي استاندارد سميعا102,1,100,142406900,1423499,1424069,1424069,570,0.04,1424069,570,0.04,1424069,1424069
صفارس147,صكوك اجاره فارس147- 3ماهه18%,1,152,148960000,990000,980000,980000,-10000,-1.01,980000,-10000,-1.01,980000,980000
افاد554,منفعت دولت5-ش.خاص ساير0108,1,2000000,1969956000000,973159,984978,984978,11819,1.21,984978,11819,1.21,984978,984978
صبا14044,اجاصبابدون ضامن بارتبه اعتباري,1,60000,60000000000,1000000,1000000,1000000,0,0,1000000,0,0,1000000,1000000
اراد36,مرابحه عام دولت3-ش.خ 0104,1,5000,4984000000,990000,996800,996800,6800,0.69,996800,6800,0.69,996800,996800
شيشه94ن,گواهي شيشه فلوت5بيرنگBكاويان,1,1200,810432000,742896,675360,675360,-67536,-9.09,675360,-67536,-9.09,675360,675360
متا0104,آتي متانول -1401/04/17,1,100,94300000,943500,943000,943000,-500,-0.05,943000,-500,-0.05,943000,943000
كمان,س.خ.كمان كاريزما 35% تاديه,1,1000,415986000,415747,415986,415986,239,0.06,415986,239,0.06,415986,415986
اخزا8164,اسنادخزانه-م16بودجه98-010503,1,1162878,1126817153220,964570,968990,968990,4420,0.46,968990,4420,0.46,968990,968990
سآبيك4,سيمان آبيك,1,295930108,4193329630360,13500,14170,14170,670,4.96,14170,670,4.96,14170,14170
تملي801,تسهيلات مسكن ب. ملي-فروردين98,1,10,5172950,544521,517295,517295,-27226,-5,517295,-27226,-5,517295,517295
اخزا820,اسنادخزانه-م20بودجه98-020806,1,5000,3749500000,751330,749900,749900,-1430,-0.19,749900,-1430,-0.19,749900,749900
ضملي3011,اختيارخ فملي-5000-1401/03/02,1,3,6990000,2417,2330,2330,-87,-3.6,2330,-87,-3.6,2330,2330
افران2,صندوق س افرا نماد پايدار-ثابت,1,750000,750000,16381,1,1,-16380,-99.99,1,-16380,-99.99,1,1
ويستا2,صندوق س. ويستا -س,1,100000,100000,13078,1,1,-13077,-99.99,1,-13077,-99.99,1,1
ثروتم2,صندوق س. ثروت آفرين پارسيان-س,1,400000,400000,99158,1,1,-99157,-100,1,-99157,-100,1,1
ضفلا3014,اختيارخ فولاد-14000-1401/03/18,1,1,100000,389,100,100,-289,-74.29,100,-289,-74.29,100,100
نسب0104,آتي نفتاي سبك-1401/04/17,1,100,240000000,2399500,2400000,2400000,500,0.02,2400000,500,0.02,2400000,2400000
ضملت8046,اختيارخ وبملت-1975-1401/08/18,1,20,32400000,1770,1620,1620,-150,-8.47,1620,-150,-8.47,1620,1620
سبرق021,سلف موازي برق صادراتي گيلان021,1,10000,2070000000,206000,207000,207000,1000,0.49,207000,1000,0.49,207000,207000
شيشه72ن,گواهي شيشه شيت5بيرنگAساوه,1,800,510400000,638000,638000,638000,0,0,638000,0,0,638000,638000
اخزا918,اسنادخزانه-م18بودجه99-010323,1,2500,2471250000,987490,988500,988500,1010,0.1,988500,1010,0.1,988500,988500
تبريز304,مشاركت ش تبريز304-3ماهه18%,1,10000,10000000000,1000000,1000000,1000000,0,0,1000000,0,0,1000000,1000000
اراد87,مرابحه عام دولت87-ش.خ030304,1,2000,1900000000,950000,950000,950000,0,0,950000,0,0,950000,950000
سمتا022,سلف موازي استاندارد سمتا022,1,100,93087700,930445,930877,930877,432,0.05,930877,432,0.05,930877,930877
كپشير,پشم‌شيشه‌ايران‌,1,90,1008000,11840,11200,11200,-640,-5.41,11840,0,0,11200,11200
اخزا0024,اسنادخزانه-م2بودجه00-031024,1,1950000,1123201950000,578440,576001,576001,-2439,-0.42,576001,-2439,-0.42,576001,576001
اراد624,مرابحه عام دولت62-ش.خ0309,1,4300100,4041792993000,1000000,939930,939930,-60070,-6.01,939930,-60070,-6.01,939930,939930
سپر4,صندوق س سپر سرمايه بيدار- ثابت,1,9800000,142247000000,14511,14515,14515,4,0.03,14515,4,0.03,14515,14515
اخزا9022,اسنادخزانه-م2بودجه99-011019,1,85,74617250,877850,877850,877850,0,0,877850,0,0,877850,877850
اخزا9032,اسنادخزانه-م3بودجه99-011110,1,30,26014800,867960,867160,867160,-800,-0.09,867160,-800,-0.09,867160,867160
انار2,صندوق س.انارنماد ارزش-درسهام,1,50000,50000,11650,1,1,-11649,-99.99,1,-11649,-99.99,1,1
وسبحان2,سرمايه گذاري سبحان,1,9442176,36333493248,3862,3848,3848,-14,-0.36,3848,-14,-0.36,3848,3848
اخزا9092,اسنادخزانه-م9بودجه99-020316,1,56,45360000,812790,810000,810000,-2790,-0.34,810000,-2790,-0.34,810000,810000
آرام2,صندوق س شاخصي آرام مفيد,1,100000,100000,11260,1,1,-11259,-99.99,1,-11259,-99.99,1,1
اخزا9142,اسنادخزانه-م14بودجه99-021025,1,51,35816280,719610,702280,702280,-17330,-2.41,702280,-17330,-2.41,702280,702280
اخزا905,اسنادخزانه-م5بودجه99-020218,1,11000,9091500000,825830,826500,826500,670,0.08,826500,670,0.08,826500,826500
سي تيپ2ن09,گواهي سيمان تيپ 2خوزستان(ن),1,100000,719300000,5607,7193,7193,1586,28.29,6851,1244,22.19,7193,7193
اخزا9054,اسنادخزانه-م5بودجه99-020218,1,1479820,1220814504500,825830,824975,824975,-855,-0.1,824975,-855,-0.1,824975,824975
فيروزا2,صندوق ارمغان فيروزه آسيا-ثابت,1,10000000,10000000,28121,1,1,-28120,-100,1,-28120,-100,1,1
ثفارس2,عمران‌وتوسعه‌فارس‌,1,10000000,66500000000,6530,6650,6650,120,1.84,6650,120,1.84,6650,6650
سمتا021,سلف موازي استاندارد سمتا021,1,100,92875600,928324,928756,928756,432,0.05,928756,432,0.05,928756,928756
ضسپا8050,اختيارخ خساپا-1800-1401/08/25,1,50,25500000,610,510,510,-100,-16.39,510,-100,-16.39,510,510
ضملت8047,اختيارخ وبملت-2133-1401/08/18,1,1,1440000,1600,1440,1440,-160,-10,1440,-160,-10,1440,1440
ضشنا8015,اختيارخ شپنا-6350-1401/08/29,1,10,8000000,1000,800,800,-200,-20,800,-200,-20,800,800
ضترا3016,اختيارخ شتران-6000-1401/03/08,1,40,280000,100,7,7,-93,-93,7,-93,-93,7,7
ضملت8048,اختيارخ وبملت-2291-1401/08/18,1,1,1270000,1420,1270,1270,-150,-10.56,1270,-150,-10.56,1270,1270
ضخود5010,اختيارخ خودرو-3500-1401/05/12,1,1,50000,70,50,50,-20,-28.57,50,-20,-28.57,50,50
ضصاد8044,اختيارخ وبصادر-1998-1401/08/11,1,2,800000,500,400,400,-100,-20,400,-100,-20,400,400
اراد244,مرابحه عام دولت2-ش.خ ساير0212,1,4000000,3860400000000,999990,965100,965100,-34890,-3.49,965100,-34890,-3.49,965100,965100
نسب0105,آتي نفتاي سبك-1401/05/17,1,100,239900000,2398500,2399000,2399000,500,0.02,2399000,500,0.02,2399000,2399000
طكاريس304,اختيارف كاريس-15000-14010331,1,5,2500000,200,500,500,300,150,500,300,150,500,500
شيشه30ن,گواهي شيشه فلوت6بيرنگAآذر,1,330,284163000,947210,861100,861100,-86110,-9.09,861100,-86110,-9.09,861100,861100
زير0103پ01,زيره سبز0103كيميابذر(پ),1,10,13209000,1255000,1320900,1320900,65900,5.25,1320900,65900,5.25,1320900,1320900
زعف0110پ08,زعفران0110نگين روستا(پ),1,35,13650000,391005,390000,390000,-1005,-0.26,390000,-1005,-0.26,390000,390000
اراد124,مرابحه عام دولت1-ش.خ ملت0206,1,9999000,9684761427000,1000000,968573,968573,-31427,-3.14,968573,-31427,-3.14,968573,968573
ضجار7049,اختيارخ وتجارت-1880-1401/07/20,1,5,2500000,560,500,500,-60,-10.71,500,-60,-10.71,500,500
ضسپا8053,اختيارخ خساپا-2200-1401/08/25,1,1,140000,371,140,140,-231,-62.26,140,-231,-62.26,140,140
ضسپا8049,اختيارخ خساپا-1700-1401/08/25,1,100,56500000,1,565,565,564,56400,565,564,56400,565,565
كمند2,صندوق س. با درآمد ثابت كمند,1,15800000,15800000,10097,1,1,-10096,-99.99,1,-10096,-99.99,1,1
اخزا9052,اسنادخزانه-م5بودجه99-020218,1,1,824500,825830,824500,824500,-1330,-0.16,824500,-1330,-0.16,824500,824500
سنفت021,سلف موازي نفت.س صادر اروند 021,1,100,211875200,2117767,2118752,2118752,985,0.05,2118752,985,0.05,2118752,2118752
سمتا024,سلف موازي متانول بوشهر 024,1,100,91150400,911080,911504,911504,424,0.05,911504,424,0.05,911504,911504
افران4,صندوق س افرا نماد پايدار-ثابت,1,2196000,35994636000,16381,16391,16391,10,0.06,16391,10,0.06,16391,16391
سي تيپ2ن13,گواهي سيمان تيپ2بجنورد(ن),1,16000,94192000,5607,5887,5887,280,4.99,5607,0,0,5887,5887
اعتماد4,صندوق س.اعتماد آفرين پارسيان-د,1,90000000,4000140000000,44417,44446,44446,29,0.07,44446,29,0.07,44446,44446
اخزا9182,اسنادخزانه-م18بودجه99-010323,1,16,15808000,987490,988000,988000,510,0.05,988000,510,0.05,988000,988000
سي تيپ2ن12,گواهي سيمان تيپ2خزر(ن),1,92000,541604000,5887,5887,5887,0,0,5607,-280,-4.76,5887,5887
چدن4,توليدي چدن سازان,1,63000000,157563000000,2397,2501,2501,104,4.34,2501,104,4.34,2501,2501
سمتا025,سلف موازي متانول بوشهر 025,1,100,103651100,1036029,1036511,1036511,482,0.05,1036511,482,0.05,1036511,1036511
اخزا904,اسنادخزانه-م4بودجه99-011215,1,500,426945000,851700,853890,853890,2190,0.26,853890,2190,0.26,853890,853890
اهرم2,صندوق س سهامي كاريزما- اهرمي,1,100000,100000,14420,1,1,-14419,-99.99,1,-14419,-99.99,1,1
شيشه96ن,گواهي شيشه شيت6بيرنگBساوه,1,330,236874000,789580,717800,717800,-71780,-9.09,717800,-71780,-9.09,717800,717800
نسب0106,آتي نفتاي سبك-1401/06/17,1,100,239800000,2397500,2398000,2398000,500,0.02,2398000,500,0.02,2398000,2398000
ضسپا8048,اختيارخ خساپا-1600-1401/08/25,1,100,65500000,800,655,655,-145,-18.13,655,-145,-18.13,655,655
متا0106,آتي متانول -1401/06/17,1,100,94400000,945000,944000,944000,-1000,-0.11,944000,-1000,-0.11,944000,944000
ضپلا4009,اختيارخ پالايش-110000-01/04/29,1,100,500000,1900,500,500,-1400,-73.68,500,-1400,-73.68,500,500
متا0105,آتي متانول -1401/05/17,1,100,93800000,939000,938000,938000,-1000,-0.11,938000,-1000,-0.11,938000,938000
ضخود5001,اختيارخ خودرو-1800-1401/05/12,1,100,58500000,751,585,585,-166,-22.1,585,-166,-22.1,585,585
طخود5005,اختيارف خودرو-2400-1401/05/12,1,10,2000000,1,200,200,199,19900,200,199,19900,200,200
زير0103پ04,زيره سبز0103شركت مينوبذر(پ),1,11,14284160,1258000,1298560,1298560,40560,3.22,1298560,40560,3.22,1298560,1298560
ضدار4000,اختيارخ ص.دارا-68000-01/04/29,1,10,5210700,58000,52107,52107,-5893,-10.16,52107,-5893,-10.16,52107,52107
ضملت8051,اختيارخ وبملت-2885-1401/08/18,1,26,18720000,750,720,720,-30,-4,720,-30,-4,720,720
مشير112,مشاركت شهرداري شيراز-3ماهه18%,1,5,4975000,1005000,995000,995000,-10000,-1,995000,-10000,-1,995000,995000
ثروت,ص.خ.ثروت آفرين فيروزه 85%تاديه,1,1000,250000000,255000,250000,250000,-5000,-1.96,250000,-5000,-1.96,250000,250000
شيشه81ن,گواهي شيشه فلوت5بيرنگA ليا,1,800,682808800,938863,853511,853511,-85352,-9.09,853511,-85352,-9.09,853511,853511
اراد94,مرابحه عام دولت94-ش.خ030816,1,4400,4191660000,975990,952650,952650,-23340,-2.39,952650,-23340,-2.39,952650,952650
سي تيپ2ن08,گواهي سيمان تيپ 2زنجان(ن),1,66000,388542000,5607,5887,5887,280,4.99,5607,0,0,5887,5887
ضسپا3012,اختيارخ خساپا-1400-1401/03/25,1,21,14700000,750,700,700,-50,-6.67,700,-50,-6.67,700,700
ضپنا7048,اختيارخ رمپنا-11000-1401/07/12,1,10,69000000,7700,6900,6900,-800,-10.39,6900,-800,-10.39,6900,6900
سمتا011,سلف موازي استاندارد سمتا011,1,10,90155260,9011806,9015526,9015526,3720,0.04,9015526,3720,0.04,9015526,9015526
شيشه108ن,گواهي شيشه فلوت10بيرنگBدماوند,1,400,738675200,2031356,1846688,1846688,-184668,-9.09,1846688,-184668,-9.09,1846688,1846688
ضترا8066,اختيارخ شتران-4770-1401/08/08,1,1,1220000,1700,1220,1220,-480,-28.24,1220,-480,-28.24,1220,1220
وبوعلي2,سرمايه‌گذاري‌بوعلي‌,1,149500000,757965000000,5230,5070,5070,-160,-3.06,5070,-160,-3.06,5070,5070
اراد64,مرابحه عام دولتي64-ش.خ0111,1,1000,965000000,957500,965000,965000,7500,0.78,965000,7500,0.78,965000,965000
اخزا9082,اسنادخزانه-م8بودجه99-020606,1,24,18624480,777240,776020,776020,-1220,-0.16,776020,-1220,-0.16,776020,776020
شيشه102ن,گواهي شيشه فلوت5بيرنگBدماوند,1,320,251664000,865095,786450,786450,-78645,-9.09,786450,-78645,-9.09,786450,786450
سمتا023,سلف موازي استاندارد سمتا023,1,100,93443400,933999,934434,934434,435,0.05,934434,435,0.05,934434,934434
تاراز,صندوق س آواي تاراز زاگرس-سهام,1,872,10333200,12320,11850,11850,-470,-3.81,11850,-470,-3.81,11850,11850
اخزا821,اسنادخزانه-م21بودجه98-020906,1,100,73790000,740670,737900,737900,-2770,-0.37,737900,-2770,-0.37,737900,737900
سي تيپ2ن18,گواهي سيمان تيپ2مدلل(ن),1,25000,156525000,5887,6261,6261,374,6.35,5963,76,1.29,6261,6261
