نماد,نام,تعداد,حجم,ارزش,دیروز,اولین,آخرین معامله - مقدار,آخرین معامله - تغییر,آخرین معامله - درصد,قیمت پایانی - مقدار,قیمت پایانی - تغییر,قیمت پایانی - درصد,کمترین,بیشترین
ددانا,داروسازي دانا,60307,6406915,267809047000,39450,41800,41800,2350,5.96,41800,2350,5.96,41800,41800
اسياتك,انتقال داده هاي آسياتك,41129,60586602,939323529940,14810,15550,15550,740,5,15500,690,4.66,14600,15550
سآبيك,سيمان آبيك,36805,40284146,660257152940,15610,16390,16390,780,5,16390,780,5,16390,16390
شستا,سرمايه گذاري تامين اجتماعي,19926,829624587,832169307098,1015,1017,997,-18,-1.77,1003,-12,-1.18,996,1033
خودرو,ايران‌ خودرو,15893,626364203,1354191494364,2262,2251,2149,-113,-5,2162,-100,-4.42,2149,2266
شپنا,پالايش نفت اصفهان,14400,202531940,1391456903550,6770,7010,6800,30,0.44,6870,100,1.48,6750,7060
پالايش,صندوق پالايشي يكم-سهام,13183,16407226,1283694495940,77730,79160,77450,-280,-0.36,78240,510,0.66,77300,79700
خساپا,سايپا,11319,441711231,871429728039,2059,2059,1957,-102,-4.95,1973,-86,-4.18,1957,2075
دارا يكم,صندوق واسطه گري مالي يكم-سهام,10609,8068258,918739989520,115840,116580,112860,-2980,-2.57,113870,-1970,-1.7,112770,116580
كارين2,صندوق س نگين سامان-ثابت,10000,1000000000,1000000000,10035,1,1,-10034,-99.99,1,-10034,-99.99,1,1
كرمان,س. توسعه و عمران استان كرمان,9741,402041806,405123280028,1055,1065,992,-63,-5.97,1008,-47,-4.45,992,1065
فاذر,صنايع‌ آذرآب‌,8960,657370619,773207710366,1135,1191,1150,15,1.32,1176,41,3.61,1125,1191
فولاد,فولاد مباركه اصفهان,8097,67288466,804835573370,12110,12120,11980,-130,-1.07,11960,-150,-1.24,11750,12250
وتجارت,بانك تجارت,7874,219538422,454275631803,2148,2157,2030,-118,-5.49,2069,-79,-3.68,2026,2160
كمند,صندوق س. با درآمد ثابت كمند,7725,428696455,4342426557924,10113,10129,10129,16,0.16,10129,16,0.16,10129,10130
فملي,ملي‌ صنايع‌ مس‌ ايران‌,7491,103172073,759117201740,7400,7400,7400,0,0,7360,-40,-0.54,7190,7410
شتران,پالايش نفت تهران,7444,106572893,580074831350,5490,5620,5370,-120,-2.19,5440,-50,-0.91,5300,5660
وبملت,بانك ملت,6979,240397399,924737047750,3883,3900,3820,-63,-1.62,3847,-36,-0.93,3780,3900
شبندر,پالايش نفت بندرعباس,6784,73357171,659453721850,8930,9170,8900,-30,-0.34,8990,60,0.67,8840,9220
وخارزم,سرمايه گذاري خوارزمي,6475,94904529,490813275930,5260,5400,5080,-180,-3.42,5170,-90,-1.71,5060,5400
حكشتي,كشتيراني جمهوري اسلامي ايران,6068,32454632,732902040530,22940,23440,21950,-990,-4.32,22580,-360,-1.57,21870,23790
بجهرم,توسعه مولد نيروگاهي جهرم,5765,190679240,499824295790,2509,2634,2620,111,4.42,2621,112,4.46,2562,2634
تسه1401,امتيازتسهيلات مسكن سال1401,5759,345381,404303744775,1169664,1140000,1203000,33336,2.85,1170602,938,0.08,1138000,1228000
سكرد,سيمان كردستان,5669,52803222,575684175900,10530,11050,10400,-130,-1.23,10900,370,3.51,10200,11050
خپارس,پارس‌ خودرو,5537,273951369,307651583053,1173,1171,1115,-58,-4.94,1123,-50,-4.26,1115,1181
انرژي,بورس انرژي ايران,5305,5939987,336662147170,59260,58560,56300,-2960,-4.99,56680,-2580,-4.35,56300,59850
فزر,پويا زركان آق دره,5220,10422619,293198035800,29300,28900,28000,-1300,-4.44,28150,-1150,-3.92,27550,29200
پترول,گ.س.وت.ص.پتروشيمي خليج فارس,5208,135576238,325939016794,2336,2373,2390,54,2.31,2404,68,2.91,2342,2470
بپيوند,برق و انرژي پيوندگستر پارس,5176,17837515,248551289630,13430,14230,13590,160,1.19,13930,500,3.72,13480,14230
فرابورس,فرابورس ايران,5173,27990658,371768182830,13990,14050,13170,-820,-5.86,13280,-710,-5.08,13160,14200
وسپهر,سرمايه گذاري مالي سپهرصادرات,5165,25074505,213305413670,8840,9140,8580,-260,-2.94,8510,-330,-3.73,8310,9140
مديريت,س. و خدمات مديريت صند. ب كشوري,4994,29389124,267692053640,9520,9850,8960,-560,-5.88,9110,-410,-4.31,8950,9850
زقيام,كشت و دام قيام اصفهان,4843,119371574,343248850577,2735,2899,2899,164,6,2875,140,5.12,2766,2899
غنوش,نوش‌ مازندران‌,4833,41134372,509976153890,11900,12490,12400,500,4.2,12400,500,4.2,12070,12490
خبهمن,گروه‌بهمن‌,4716,155713703,281831347627,1855,1871,1796,-59,-3.18,1810,-45,-2.43,1771,1885
كالا,بورس كالاي ايران,4653,13766369,347512253390,26270,26300,24790,-1480,-5.63,25240,-1030,-3.92,24710,26610
ذوب,ذوب آهن اصفهان,4422,83524998,228309924626,2794,2810,2714,-80,-2.86,2733,-61,-2.18,2695,2849
فتوسا,توليد و توسعه سرب روي ايرانيان,4095,48872662,412862892500,8310,8720,8180,-130,-1.56,8450,140,1.68,8020,8720
كيان,صندوق س. با درآمد ثابت كيان,3756,31605380,1107638373132,35006,35046,35048,42,0.12,35046,40,0.11,35044,35048
آريا,پليمر آريا ساسول,3684,2162538,170651074550,79400,79400,79150,-250,-0.31,78900,-500,-0.63,78500,79550
ثقزوي,شركت عمران و سازندگي قزوين,3596,17644908,243950051110,13780,14190,13370,-410,-2.98,13830,50,0.36,13370,14190
كدما,معدني‌ دماوند,3572,2521106,214302682620,88380,87240,83970,-4410,-4.99,85000,-3380,-3.82,83970,88290
تليسه,دامداري تليسه نمونه,3569,43681442,193905599840,4555,4635,4343,-212,-4.65,4439,-116,-2.55,4282,4780
غزر,صنعتي زر ماكارون,3564,9137916,91406528900,10210,10390,9820,-390,-3.82,10000,-210,-2.06,9790,10430
تجلي,تجلي توسعه معادن و فلزات,3548,142383791,216746143128,1540,1551,1504,-36,-2.34,1522,-18,-1.17,1497,1571
سنير,سيمان‌ سفيد ني‌ريز,3481,9192228,387920327450,42260,44370,40150,-2110,-4.99,42200,-60,-0.14,40150,44370
زملارد,كشاورزي و دامپروري ملارد شير,3477,4640096,67723099620,13910,14600,14600,690,4.96,14600,690,4.96,14150,14600
خاور,ايران خودرو ديزل,3429,145819408,238953932946,1678,1701,1628,-50,-2.98,1639,-39,-2.32,1628,1701
بگيلان,توسعه مسير برق گيلان,3336,6330485,98910082880,15220,15980,15120,-100,-0.66,15620,400,2.63,15120,15980
سيمرغ,سيمرغ,3291,14701850,379121174520,27190,27490,25560,-1630,-5.99,25790,-1400,-5.15,25560,27490
بورس,بورس اوراق بهادار تهران,3243,22276231,184727239680,8710,8750,8200,-510,-5.86,8290,-420,-4.82,8190,8780
وهامون,سرمايه گذاري هامون صبا,3155,33485523,71269952515,2080,2187,2170,90,4.33,2128,48,2.31,2055,2187
اعتماد,صندوق س.اعتماد آفرين پارسيان-د,3144,47474170,2115693981090,44505,44565,44565,60,0.13,44565,60,0.13,44564,44566
آبادا,توليد نيروي برق آبادان,3132,6525916,86964587430,13300,13650,13020,-280,-2.11,13330,30,0.23,12800,13650
طلا,صندوق س.پشتوانه طلاي لوتوس,3128,5231562,541258875031,102521,102820,103999,1478,1.44,103460,939,0.92,102330,104500
هماي,صندوق س هماي آگاه-ثابت,3081,97927968,983515231285,10025,10042,10045,20,0.2,10043,18,0.18,10042,10045
سمگا,گروه سرمايه گذاري ميراث فرهنگي,2941,17690032,158072948860,9260,9490,8840,-420,-4.54,8940,-320,-3.46,8760,9490
قچار,فراوردههاي غذايي وقند چهارمحال,2941,41091873,458308125190,10770,11050,11220,450,4.18,11150,380,3.53,11000,11290
خموتور,موتورسازان‌تراكتورسازي‌ايران‌,2909,40788745,201389184607,4744,4981,4981,237,5,4937,193,4.07,4790,4981
ثاميد,توسعه و عمران اميد,2904,39778420,63548663480,1657,1670,1581,-76,-4.59,1598,-59,-3.56,1575,1680
هاي وب,داده گسترعصرنوين-هاي وب,2885,16318876,157535244570,9930,10000,9540,-390,-3.93,9650,-280,-2.82,9440,10000
ثرود,سرمايه‌گذاري مسكن زاينده رود,2885,15789712,178382329950,11540,12010,10850,-690,-5.98,11300,-240,-2.08,10850,12140
كاما,باما,2881,23076281,141254412930,6270,6400,6080,-190,-3.03,6120,-150,-2.39,6000,6400
خگستر,گسترش‌سرمايه‌گذاري‌ايران‌خودرو,2881,111099752,401297281118,3817,3750,3588,-229,-6,3612,-205,-5.37,3588,3869
غگل,گلوكوزان‌,2847,35858138,183077728880,5320,5230,5060,-260,-4.89,5110,-210,-3.95,5060,5280
فاراك,ماشين‌ سازي‌ اراك‌,2840,131458285,217000865769,1663,1720,1610,-53,-3.19,1651,-12,-0.72,1589,1740
ونيرو,سرمايه‌گذاري‌نيرو,2827,59651230,186839749662,3092,3155,3061,-31,-1,3132,40,1.29,3021,3229
لپارس,پارس‌ الكتريك‌,2785,1591336,168269858330,110520,110700,107300,-3220,-2.91,105740,-4780,-4.33,105000,111390
نوري,پتروشيمي نوري,2775,1341596,159074378160,118090,118680,118660,570,0.48,118570,480,0.41,118000,121000
گدنا,تهيه توزيع غذاي دنا آفرين فدك,2715,4753305,65196566110,14220,14700,13550,-670,-4.71,13720,-500,-3.52,13510,14700
حگهر,حمل و نقل گهرترابر سيرجان,2714,25010143,203553849480,8550,8400,8040,-510,-5.96,8140,-410,-4.8,8040,8500
چخزر,صنايع چوب خزر كاسپين,2677,1523383,46969348600,30000,30700,31100,1100,3.67,30850,850,2.83,29200,31450
پارس,پتروشيمي پارس,2675,65063926,181650825544,2769,2800,2768,-1,-0.04,2792,23,0.83,2751,2820
زكشت,كشاورزي مكانيزه اصفهان كشت,2665,12730983,335291583400,25400,26900,25300,-100,-0.39,26350,950,3.74,24750,26900
سدبير,س. تدبيرگران فارس وخوزستان,2658,4744849,140016021600,30400,31500,28600,-1800,-5.92,29500,-900,-2.96,28600,31500
فجهانح,ح. مجتمع جهان فولاد سيرجان,2641,9246429,15827116228,1780,1765,1701,-79,-4.44,1712,-68,-3.82,1679,1783
بترانس,ايران‌ ترانسفو,2636,80204147,193979664329,2544,2530,2392,-152,-5.97,2419,-125,-4.91,2392,2560
سصفها,سيمان‌اصفهان‌,2566,4109873,244351004960,58600,61420,58680,80,0.14,59450,850,1.45,55670,61420
شبريز,پالايش نفت تبريز,2556,10660532,246196905360,23120,23700,22750,-370,-1.6,23090,-30,-0.13,22650,23790
وپارس,بانك‌پارسيان‌,2496,87550860,165773245798,1978,1970,1880,-98,-4.95,1893,-85,-4.3,1880,2000
خزر,فنرسازي‌زر,2487,36288068,114902313554,3339,3300,3139,-200,-5.99,3166,-173,-5.18,3139,3330
خزاميا,زامياد,2482,24644537,230182085070,9690,9900,9210,-480,-4.95,9340,-350,-3.61,9210,9940
سخواف,سيمان مجد خواف,2429,13866256,125230164980,9040,9310,8770,-270,-2.99,9030,-10,-0.11,8770,9310
غبشهر,صنعتي‌ بهشهر,2421,51777365,221619228649,4371,4420,4227,-144,-3.29,4280,-91,-2.08,4150,4520
سيتا,سرمايه گذاري سيمان تامين,2409,5956293,66450456200,11210,11070,11050,-160,-1.43,11160,-50,-0.45,11000,11470
چكاپا,گروه صنايع كاغذ پارس,2402,46467304,157889835228,3335,3430,3300,-35,-1.05,3398,63,1.89,3257,3501
فخوز,فولاد  خوزستان,2390,24981446,143673991230,5890,5890,5730,-160,-2.72,5750,-140,-2.38,5690,5990
شاروم,پتروشيمي اروميه,2387,2746104,40955879990,15550,15450,14790,-760,-4.89,14910,-640,-4.12,14780,15750
توسن,توسعه سامانه ي نرم افزاري نگين,2373,2995669,60734032600,21200,21000,20100,-1100,-5.19,20250,-950,-4.48,19950,21300
غكورش,صنعت غذايي كورش,2370,3487290,154155446600,45570,45600,43500,-2070,-4.54,44200,-1370,-3.01,43300,45880
ثبهساز,بهساز كاشانه تهران,2347,17120950,28210878735,1659,1630,1612,-47,-2.83,1648,-11,-0.66,1591,1704
پارند,صندوق س. پارند پايدار سپهر,2344,85478012,865853507298,10114,10130,10130,16,0.16,10130,16,0.16,10129,10130
وپويا,سرمايه گذاري پويا,2339,24998395,67073539472,2548,2700,2682,134,5.26,2683,135,5.3,2605,2700
شگويا,پتروشيمي تندگويان,2337,9871078,119540598690,12170,12200,12090,-80,-0.66,12110,-60,-0.49,11980,12450
وآذر,سرمايه‌گذاري‌توسعه‌آذربايجان‌,2328,3650078,445634306880,116470,117690,122290,5820,5,122090,5620,4.83,117690,122290
فجهان,مجتمع جهان فولاد سيرجان,2324,10193574,34682022363,3435,3390,3389,-46,-1.34,3422,-13,-0.38,3372,3435
كيمياتك,آريان كيميا تك,2308,2327725,59381674580,26480,26050,25400,-1080,-4.08,25510,-970,-3.66,25160,26250
افران,صندوق س افرا نماد پايدار-ثابت,2294,41489248,682109964175,16414,16440,16441,27,0.16,16441,27,0.16,16440,16442
بموتو,موتوژن‌,2286,40089977,152812423651,3480,3970,3732,252,7.24,3812,332,9.54,3732,3970
كفرآور,فرآورده هاي سيمان شرق,2282,15201001,270224717670,18300,17760,17760,-540,-2.95,17780,-520,-2.84,17760,18100
ولقمان,سرمايه گذاري لقمان,2269,10386459,53906536880,5070,5220,5220,150,2.96,5190,120,2.37,5000,5220
امين يكم,صندوق درآمد ثابت امين يكم فردا,2268,57582107,577538417223,10022,10031,10030,8,0.08,10030,8,0.08,10028,10033
خنصير,مهندسي‌نصيرماشين‌,2265,9554157,147369574710,15870,16200,15080,-790,-4.98,15420,-450,-2.84,15080,16200
غمارگ,مارگارين‌,2255,42086268,134658196653,3371,3410,3169,-202,-5.99,3200,-171,-5.07,3169,3415
فسبزوار,پارس فولاد سبزوار,2250,2383760,65394015300,27560,27600,27300,-260,-0.94,27430,-130,-0.47,27250,27650
ولساپا,ليزينگ رايان‌ سايپا,2207,73872517,113835398175,1613,1610,1520,-93,-5.77,1541,-72,-4.46,1517,1630
ختوقا,قطعات‌ اتومبيل‌ ايران‌,2191,47759563,161265876488,3399,3490,3290,-109,-3.21,3377,-22,-0.65,3228,3589
وسبحان,سرمايه گذاري سبحان,2168,73918844,316915477818,4121,4368,4145,24,0.58,4287,166,4.03,4128,4368
سپيدار,سپيدار سيستم آسيا,2162,1399319,31124295900,22100,21900,21950,-150,-0.68,22250,150,0.68,21450,22600
پتاير,ايران‌ تاير,2154,64626189,99006775604,1618,1648,1522,-96,-5.93,1532,-86,-5.32,1521,1648
دماوند,توليد نيروي برق دماوند,2102,13240299,299327160950,21600,22650,22250,650,3.01,22600,1000,4.63,21950,22650
كارا,صندوق س. كارا -د,2031,104998087,1198910117160,11401,11419,11419,18,0.16,11418,17,0.15,11418,11420
تفارس,تامين سرمايه خليج فارس,2028,16967913,57589096722,3296,3394,3394,98,2.97,3394,98,2.97,3394,3394
وغدير,سرمايه‌گذاري‌غدير(هلدينگ‌,2023,14351084,211984098590,14800,14990,14690,-110,-0.74,14770,-30,-0.2,14500,15220
ثالوند,سرمايه گذاري مسكن الوند,2011,18546480,160240309130,8310,8590,8800,490,5.9,8640,330,3.97,8050,8800
ثشاهد,سرمايه‌ گذاري‌ شاهد,1965,12374401,112013595980,9520,9550,8950,-570,-5.99,9050,-470,-4.94,8950,9690
خصدرا,صنعتي‌ دريايي‌ ايران‌,1951,60657900,122101074231,1979,2038,1956,-23,-1.16,2013,34,1.72,1952,2038
واتي,سرمايه‌ گذاري‌ آتيه‌ دماوند,1939,41800462,483896181200,11060,11060,11290,230,2.08,11580,520,4.7,10820,11720
بوعلي,پتروشيمي بوعلي سينا,1925,635506,55875572440,88060,88600,87680,-380,-0.43,87980,-80,-0.09,87260,89500
ثغرب,شركت سرمايه گذاري مسكن شمالغرب,1921,30831345,172274046310,5322,5640,5640,318,5.98,5590,268,5.04,5010,5640
افرا,افرانت,1905,4255711,137074319250,33600,33900,31950,-1650,-4.91,32200,-1400,-4.17,31950,34200
وساپا,سرمايه‌گذاري‌ سايپا,1903,56352985,255603130440,4780,4720,4494,-286,-5.98,4536,-244,-5.1,4494,4829
خچرخش,چرخشگر,1892,13108881,194007259760,15490,16100,14570,-920,-5.94,14800,-690,-4.45,14570,16100
صباح,ح . گروه مالي صبا تامين,1883,18358765,42589675964,2353,2341,2310,-43,-1.83,2320,-33,-1.4,2300,2371
سفارس,سيمان فارس و خوزستان,1869,9853025,196696497300,20990,20990,19770,-1220,-5.81,19960,-1030,-4.91,19740,20990
سبزوا,سيمان لار سبزوار,1826,33112251,136200212449,4353,4359,4092,-261,-6,4113,-240,-5.51,4092,4359
غگيلا,شيرپاستوريزه پگاه گيلان,1780,2992742,47129736160,15600,15890,15400,-200,-1.28,15750,150,0.96,15100,16180
ومدير,گ.مديريت ارزش سرمايه ص ب كشوري,1758,11387094,50831216740,4554,4625,4422,-132,-2.9,4464,-90,-1.98,4390,4625
وهور,مديريت انرژي اميد  تابان هور,1752,52023651,79865462439,1520,1567,1490,-30,-1.97,1535,15,0.99,1481,1592
صبا,گروه مالي صبا تامين,1737,14398787,69830690165,4900,4851,4810,-90,-1.84,4870,-30,-0.61,4801,4932
شلرد,كود شيميايي اوره لردگان,1692,11752338,145503302470,12600,12650,12260,-340,-2.7,12380,-220,-1.75,12230,12790
فارس,صنايع پتروشيمي خليج فارس,1692,19729385,165738249320,8450,8350,8460,10,0.12,8400,-50,-0.59,8250,8500
ونوين,بانك‌اقتصادنوين‌,1692,42549325,157676224351,3828,3850,3701,-127,-3.32,3706,-122,-3.19,3662,3850
ولپارس,ليزينگ پارسيان,1690,3280266,11228350518,3260,3423,3423,163,5,3376,116,3.56,3423,3423
فلوله,لوله‌وماشين‌سازي‌ايران‌,1686,54592075,103473222243,1974,2000,1876,-98,-4.96,1895,-79,-4,1876,2030
شپاكسا,پاكسان‌,1686,47413822,124563475326,2786,2700,2619,-167,-5.99,2627,-159,-5.71,2619,2710
آرام,صندوق س شاخصي آرام مفيد,1666,10142971,111574213940,11070,11110,10950,-120,-1.08,11000,-70,-0.63,10920,11120
شسپا,نفت سپاهان,1664,34810071,119024767458,3504,3540,3385,-119,-3.4,3419,-85,-2.43,3329,3540
بمپنا,توليد برق عسلويه  مپنا,1634,70423620,556703163810,7540,7910,7910,370,4.91,7910,370,4.91,7750,7910
خديزل,بهمن  ديزل,1607,26697590,308902509840,11040,11350,11590,550,4.98,11570,530,4.8,11140,11590
غصينو,صنعتي مينو,1604,5285751,81338230460,15810,16400,15080,-730,-4.62,15390,-420,-2.66,15020,16400
لابسا,آبسال‌,1604,17860885,143194290460,7720,8100,7890,170,2.2,8020,300,3.89,7720,8100
فولاي,صنايع فولاد آلياژي يزد,1586,41053778,415739098480,9560,9740,10130,570,5.96,10130,570,5.96,9740,10130
البرز,بيمه البرز,1579,121824812,304613883319,2494,2495,2490,-4,-0.16,2500,6,0.24,2456,2533
قرن,پديده شيمي قرن,1572,3342081,78027611590,23940,24050,23310,-630,-2.63,23350,-590,-2.46,22820,24680
وتوصا,گروه س توسعه صنعتي ايران,1563,8489255,80969462860,9770,9790,9400,-370,-3.79,9540,-230,-2.35,9330,9950
غدام,خوراك‌  دام‌ پارس‌,1557,1548111,84418610370,56870,57050,54030,-2840,-4.99,54530,-2340,-4.11,54030,57050
رمپنا,گروه مپنا (سهامي عام),1548,12185603,218104636260,18540,18650,17500,-1040,-5.61,17900,-640,-3.45,17430,18860
شپلي,پلي اكريل ايران,1547,21887573,162264125680,7560,7700,7480,-80,-1.06,7410,-150,-1.98,7340,7730
وملي,گروه‌ صنعتي‌ ملي‌ (هلدينگ‌,1525,1009944,140054341010,144710,146980,139000,-5710,-3.95,138680,-6030,-4.17,137480,146980
امين,تامين سرمايه امين,1516,874425,9418076160,10770,10770,10770,0,0,10770,0,0,10770,10800
كلر,كلر پارس,1502,817239,71831636450,90250,91900,86650,-3600,-3.99,87900,-2350,-2.6,86500,91900
بكهنوج,توليد برق ماهتاب كهنوج,1498,48954500,63562679915,1281,1320,1258,-23,-1.8,1298,17,1.33,1250,1333
فباهنر,مس‌ شهيدباهنر,1488,2701142,87502011890,32230,32230,32000,-230,-0.71,32390,160,0.5,31990,32950
گشان,توسعه بين المللي پديده شانديز,1481,3195212,64893477450,20250,20200,20050,-200,-0.99,20300,50,0.25,19850,20800
لطيف,محصولات كاغذي لطيف,1479,463921,20783911950,45300,44800,45000,-300,-0.66,44800,-500,-1.1,44250,45300
زماهان,مجتمع توليد گوشت مرغ ماهان,1461,9839316,86075821760,9200,9550,8770,-430,-4.67,8750,-450,-4.89,8650,9550
شسينا,صنايع‌شيميايي‌سينا,1445,29090405,56072280653,2010,2050,1910,-100,-4.98,1928,-82,-4.08,1910,2050
اخابر,مخابرات ايران,1425,14666129,117774106790,8190,8240,7830,-360,-4.4,8030,-160,-1.95,7810,8300
لپيام,گسترش صنايع پيام,1420,3208279,80379756550,24950,25650,24250,-700,-2.81,25050,100,0.4,24250,25650
پيزد,مجتمع صنايع لاستيك يزد,1419,2880831,36038137050,13020,13060,12370,-650,-4.99,12510,-510,-3.92,12370,13250
غشهداب,كشت و صنعت شهداب ناب خراسان,1410,21999445,58106827031,2776,2830,2610,-166,-5.98,2641,-135,-4.86,2610,2830
درهآور,دارويي ره آورد تامين,1388,3005828,101887307350,35950,34650,34300,-1650,-4.59,33900,-2050,-5.7,33800,35850
غسالم,سالمين‌,1380,16899730,57276485503,3570,3599,3356,-214,-5.99,3389,-181,-5.07,3356,3599
مداران,داده‌پردازي‌ايران‌,1373,6029934,129861801790,20760,21770,21780,1020,4.91,21540,780,3.76,19730,21790
قثابت,قند ثابت‌ خراسان‌,1373,34739861,111169202112,3360,3192,3192,-168,-5,3200,-160,-4.76,3192,3280
آپ,آسان پرداخت پرشين,1363,7390139,50385965530,7000,7010,6670,-330,-4.71,6820,-180,-2.57,6650,7200
فروي,ذوب روي اصفهان,1356,2461779,39482574480,16590,16400,15750,-840,-5.06,16040,-550,-3.32,15620,16890
لكما,كارخانجات‌مخابراتي‌ايران‌,1345,41760254,37756536151,910,935,888,-22,-2.42,904,-6,-0.66,883,935
شبريزح,ح. پالايش نفت تبريز,1341,3419447,53258818310,15520,16000,15360,-160,-1.03,15580,60,0.39,15100,16150
بنو,بيمه تجارت نو,1319,9715426,56278955200,6000,6200,5700,-300,-5,5790,-210,-3.5,5700,6200
شفارس,صنايع‌ شيميايي‌ فارس‌,1300,29539504,38086439836,1356,1354,1275,-81,-5.97,1289,-67,-4.94,1275,1355
فسرب,ملي‌ سرب‌وروي‌ ايران‌,1299,32752710,55320642037,1759,1758,1686,-73,-4.15,1689,-70,-3.98,1672,1780
فگستر,گسترش صنايع روي ايرانيان,1296,3052346,23697978950,7960,8100,7630,-330,-4.15,7760,-200,-2.51,7610,8150
بكاب,صنايع‌جوشكاب‌يزد,1296,978371,60283982040,64240,65690,61030,-3210,-5,61620,-2620,-4.08,61030,65690
كرازي,كارخانجات‌توليدي‌شيشه‌رازي‌,1294,43545246,66829837088,1616,1599,1520,-96,-5.94,1535,-81,-5.01,1520,1649
رافزا,رايان هم افزا,1294,335435,17877968100,54900,54550,52900,-2000,-3.64,53300,-1600,-2.91,52500,56900
بزاگرس,نيروگاه زاگرس كوثر,1279,20370417,109076470630,5154,5410,5200,46,0.89,5350,196,3.8,5190,5410
حفاري,حفاري شمال,1273,11886664,52187281786,4451,4550,4276,-175,-3.93,4390,-61,-1.37,4233,4593
ضخود4011,اختيارخ خودرو-2000-1401/04/08,1270,56157,14496289000,309,319,229,-80,-25.89,258,-51,-16.5,228,319
بركت,گروه دارويي بركت,1270,6564233,114067483840,17980,17630,17330,-650,-3.62,17380,-600,-3.34,16910,17720
هرمز,فولاد هرمزگان جنوب,1266,4181671,66688610120,16560,16160,16280,-280,-1.69,16210,-350,-2.11,15740,16600
وپست,پست بانك ايران,1249,27392326,111466156034,4033,4120,4072,39,0.97,4069,36,0.89,3961,4150
قشرين,قند شيرين خراسان,1248,14784877,75723633110,5260,5300,5110,-150,-2.85,5120,-140,-2.66,5110,5300
ثاخت,بين‌المللي‌توسعه‌ساختمان,1243,31873384,73576999874,2334,2374,2280,-54,-2.31,2308,-26,-1.11,2251,2420
خفولا,خدمات فني فولاد يزد,1237,5935841,113599491490,18790,19290,19350,560,2.98,19140,350,1.86,18230,19350
شبصير,توليدات پتروشيمي قائد بصير,1228,908261,109794231800,116650,118000,120150,3500,3,120900,4250,3.64,118000,123600
ماديرا,صنايع ماديران,1227,14530182,46836079249,3345,3410,3190,-155,-4.63,3223,-122,-3.65,3178,3416
كچاد,معدني‌وصنعتي‌چادرملو,1226,6872123,112210623780,16520,16600,16300,-220,-1.33,16340,-180,-1.09,16190,16800
حگردش,ريل گردش ايرانيان,1217,17632819,43818745385,2548,2560,2479,-69,-2.71,2485,-63,-2.47,2472,2609
وسينا,بانك سينا,1215,33133474,76315187680,2404,2498,2275,-129,-5.37,2303,-101,-4.2,2260,2498
ختور,رادياتور ايران‌,1213,5307611,67197372340,13280,13270,12590,-690,-5.2,12660,-620,-4.67,12490,13370
ورنا,سرمايه‌گذاري‌ رنا(هلدينگ‌,1210,20060529,109327530890,5680,5680,5340,-340,-5.99,5450,-230,-4.05,5340,5750
زپارس,ملي كشت و صنعت و دامپروري پارس,1206,5963906,236786929170,38000,39880,39900,1900,5,39700,1700,4.47,38000,39900
زنجان,صنايع كشاورزي وكود زنجان,1205,12760928,51492165946,3973,4050,4025,52,1.31,4035,62,1.56,3902,4092
شيران,س. صنايع‌شيميايي‌ايران,1199,4857418,96885454890,20110,20300,19960,-150,-0.75,19950,-160,-0.8,19300,20350
اپال,فرآوري معدني اپال كاني پارس,1184,1324151,26632322740,20530,19980,19940,-590,-2.87,20440,-90,-0.44,19900,20600
ملت,بيمه ملت,1168,40344302,49987268714,1283,1287,1226,-57,-4.44,1239,-44,-3.43,1215,1310
وپترو,سرمايه‌گذاري صنايع پتروشيمي‌,1161,7378988,86774238220,11150,11360,11670,520,4.66,11760,610,5.47,11360,11810
كساوه,صنايع‌ كاشي‌ و سراميك‌ سينا,1156,3724793,196816075790,49910,51500,52900,2990,5.99,52840,2930,5.87,51500,52900
ولكار,ليزينگ كارآفرين,1155,2108915,13386768980,6440,6420,6250,-190,-2.95,6360,-80,-1.24,6170,6530
كلوند,كاشي‌ الوند,1147,6672279,177565460670,25420,26190,26690,1270,5,26610,1190,4.68,25800,26690
مرقام,ايران‌ارقام‌,1137,8173212,97851243380,11600,12180,11470,-130,-1.12,11970,370,3.19,11310,12180
حآسا,آسيا سير ارس,1134,4021038,52257948060,13490,14020,12870,-620,-4.6,13000,-490,-3.63,12690,14020
زكوثر,سرمايه گذاري كشاورزي كوثر,1131,3228424,51789236180,16910,17000,15900,-1010,-5.97,16040,-870,-5.14,15900,17000
شغدير,پتروشيمي غدير,1129,926140,89057708090,95660,97350,95990,330,0.34,96160,500,0.52,95000,97800
فپنتا,سپنتا,1125,111089,71783429610,661670,648000,663990,2320,0.35,646180,-15490,-2.34,628590,671880
ختراك,ريخته‌گري‌ تراكتورسازي‌ ايران‌,1118,20161383,140824669270,6690,6970,6800,110,1.64,6980,290,4.33,6610,7020
آباد,توريستي ورفاهي آبادگران ايران,1117,1948301,68879727670,33970,35490,35370,1400,4.12,35350,1380,4.06,34400,35660
سپاها,سيمان‌سپاهان‌,1112,7785191,76272993380,10100,10370,9600,-500,-4.95,9800,-300,-2.97,9530,10370
حسير,ريل سير كوثر,1111,3782796,74096028970,18800,19250,19920,1120,5.96,19590,790,4.2,18550,19920
شصدف,صنعتي دوده فام,1108,1299030,43525115350,34750,35000,33250,-1500,-4.32,33500,-1250,-3.6,33100,35000
ورازي,بيمه رازي,1104,39443141,79663100961,2061,2090,2000,-61,-2.96,2020,-41,-1.99,2000,2118
كسرا,سراميك‌هاي‌صنعتي‌اردكان‌,1093,12827570,88989902760,7270,7340,6840,-430,-5.91,6940,-330,-4.54,6840,7460
شجم,صنايع پتروشيمي تخت جمشيد,1093,6904968,78364572760,11710,11890,11230,-480,-4.1,11350,-360,-3.07,11130,11890
كپارس,كاشي‌ پارس‌,1090,4678045,45480701180,10030,10200,9530,-500,-4.99,9720,-310,-3.09,9530,10380
بهير,س. توسعه تجارت هيرمند,1084,1346505,11270246850,8130,8370,8370,240,2.95,8370,240,2.95,8370,8370
سرو,صندوق س سروسودمند مدبران-سهام,1082,2788694,223118786200,80800,80800,79120,-1680,-2.08,80010,-790,-0.98,79000,81350
غويتا,ويتانا,1082,9822486,54311732230,5680,5720,5400,-280,-4.93,5530,-150,-2.64,5400,5880
ثنوسا,نوسازي‌وساختمان‌تهران‌,1072,12590624,59637619164,4910,4980,4665,-245,-4.99,4737,-173,-3.52,4665,5099
فگسترح,ح . گسترش صنايع روي ايرانيان,1070,1409896,6735304566,4903,4800,4800,-103,-2.1,4777,-126,-2.57,4658,5000
آگاس,صندوق س.هستي بخش آگاه-س,1056,1587868,136639725447,87260,87300,85815,-1445,-1.66,86052,-1208,-1.38,85700,87553
كيسون,شركت كيسون,1053,34795596,58709935440,1736,1710,1692,-44,-2.53,1687,-49,-2.82,1684,1742
فاسمين,كالسيمين‌,1050,4353980,91086371200,20810,21480,20610,-200,-0.96,20920,110,0.53,20410,21480
اعتلا,شركت سرمايه گذاري اعتلاء البرز,1045,12314480,52359591575,4429,4430,4164,-265,-5.98,4252,-177,-4,4164,4517
چكارن,كارتن‌ ايران‌,1044,26206843,72093635626,2864,2840,2723,-141,-4.92,2751,-113,-3.95,2721,2900
فوكا,فولاد كاويان,1039,15004516,240326183370,15660,16120,15690,30,0.19,16020,360,2.3,15670,16120
شكربن,كربن‌ ايران‌,1037,14911344,58954703165,3902,3920,3910,8,0.21,3954,52,1.33,3855,4050
شپديس,پتروشيمي پرديس,1035,746493,133807424740,177550,179300,178330,780,0.44,179250,1700,0.96,178330,180710
ماديراح,ح صنايع ماديران,1029,17802330,29089328139,1692,1673,1620,-72,-4.26,1634,-58,-3.43,1612,1730
وشمال,س. چشم انداز توسعه شمال,1019,2879418,67495890900,23850,23550,23500,-350,-1.47,23450,-400,-1.68,23400,23850
غمينو,شركت صنايع غذايي مينو شرق,1017,8440835,49109800990,6100,6100,5740,-360,-5.9,5820,-280,-4.59,5740,6190
قلرست,قند لرستان‌,1013,2379961,57818847540,24330,25250,23850,-480,-1.97,24290,-40,-0.16,23450,25280
سشرق,سيمان‌ شرق‌,1006,7209048,61745510810,8900,8900,8370,-530,-5.96,8570,-330,-3.71,8370,9100
كبافق,معادن‌ بافق‌,1002,2085957,73655416000,37000,36000,35150,-1850,-5,35310,-1690,-4.57,35150,37400
كفپارس,فرآورده‌هاي‌ نسوز پارس‌,994,18559473,81706647192,4602,4601,4372,-230,-5,4402,-200,-4.35,4372,4680
فزرين,زرين معدن آسيا,987,6749349,48057769040,7270,7370,7140,-130,-1.79,7120,-150,-2.06,7030,7380
خكاوه,سايپا ديزل,986,11668713,106341542780,9120,9370,9050,-70,-0.77,9110,-10,-0.11,8950,9370
ياقوت,صندوق س ياقوت آگاه-ثابت,983,35234252,524527726224,14862,14881,14887,25,0.17,14887,25,0.17,14879,14887
كماسه,تامين‌ ماسه‌ ريخته‌گري‌,982,13646727,52690009209,4020,4090,3819,-201,-5,3861,-159,-3.96,3819,4090
ثبات,صندوق س. ثبات ويستا -د,982,43571631,506603428294,11607,11626,11626,19,0.16,11627,20,0.17,11626,11627
افق,فروشگاههاي زنجيره اي افق كوروش,980,1219850,56597190810,46930,48950,45140,-1790,-3.81,46400,-530,-1.13,45010,48950
زدشت,كشت و صنعت دشت خرم دره,978,2497482,67872530250,28650,28400,26950,-1700,-5.93,27200,-1450,-5.06,26950,29200
وآوا,سرمايه گذاري آوا نوين,976,13121966,46423198780,3713,3832,3492,-221,-5.95,3538,-175,-4.71,3491,3832
پارسيان,بيمه پارسيان,973,11315219,40976454352,3596,3680,3567,-29,-0.81,3621,25,0.7,3510,3779
زبينا,كشاورزي و دامپروري بينالود,967,14058673,44805385583,3318,3380,3119,-199,-6,3187,-131,-3.95,3119,3400
تپكو,توليدتجهيزات‌سنگين‌هپكو,965,20206467,33860421444,1723,1737,1672,-51,-2.96,1676,-47,-2.73,1672,1737
تسه1400,امتيازتسهيلات مسكن سال1400,964,11119,13185204385,1171745,1180500,1200002,28257,2.41,1185826,14081,1.2,1151000,1230332
آكورد,صندوق س. آرمان آتي كوثر-د,956,6432202,250557514650,38900,38953,38954,54,0.14,38954,54,0.14,38953,38956
خمهر,مهركام‌پارس‌,953,44919001,90530620983,2112,2112,2007,-105,-4.97,2015,-97,-4.59,2007,2171
تاپيكو,س. نفت و گاز و پتروشيمي تأمين,951,4502872,74038266670,16610,17000,16400,-210,-1.26,16510,-100,-0.6,16120,17000
خرينگ,رينگ‌سازي‌مشهد,949,2324642,53099565860,23930,23970,22790,-1140,-4.76,22840,-1090,-4.55,22740,24310
فرآور,فرآوري‌موادمعدني‌ايران‌,946,2242472,73507403420,34240,34090,32190,-2050,-5.99,32780,-1460,-4.26,32190,34200
شپترو,پتروشيمي آبادان,930,18559398,41743030220,2267,2335,2202,-65,-2.87,2249,-18,-0.79,2199,2335
وبانك,سرمايه گذاري گروه توسعه ملي,926,8230204,82841339180,10320,10330,9910,-410,-3.97,10130,-190,-1.84,9910,10450
مفاخر,توسعه فناوري اطلاعات خوارزمي,923,1568838,82000912800,53600,53300,52250,-1350,-2.52,52250,-1350,-2.52,50400,55300
وبرق,س.کارکنان صنعت برق زنجان وقزوي,916,803397,63333854600,81200,80550,78800,-2400,-2.96,78850,-2350,-2.89,78800,80550
وتوكا,سرمايه‌گذاري‌توكافولاد(هلدينگ,908,8898595,94988894150,10830,11220,10860,30,0.28,10670,-160,-1.48,10360,11220
جوين,كشت و صنعت جوين,891,11069016,71272322300,6600,6680,6410,-190,-2.88,6440,-160,-2.42,6410,6680
خكرمان,سرمايه گذاري آرمان گستر پاريز,891,26805992,96580256485,3520,3625,3515,-5,-0.14,3603,83,2.36,3429,3625
خودكفا,اقتصادي و خودكفايي آزادگان,886,10618912,78692550670,7600,7780,7380,-220,-2.89,7410,-190,-2.5,7380,7780
دسانكو,داروسازي سبحان انكولوژي,884,3072229,33499363180,11370,11610,10810,-560,-4.93,10900,-470,-4.13,10810,11610
غپاك,لبنيات‌ پاك‌,880,3971776,46835392670,12280,12500,11750,-530,-4.32,11790,-490,-3.99,11670,12660
غاذر,كشت‌وصنعت‌پياذر,879,1202327,76446307740,62160,65200,63230,1070,1.72,63580,1420,2.28,62400,65200
تملت,تامين سرمايه بانك ملت,876,9275029,34429134191,3776,3844,3700,-76,-2.01,3712,-64,-1.69,3560,3844
كاوه,فولاد كاوه جنوب كيش,874,5219036,66167343090,12850,12850,12700,-150,-1.17,12700,-150,-1.17,12510,12850
فيروزا,صندوق ارمغان فيروزه آسيا-ثابت,872,9496158,267939115752,28180,28216,28215,35,0.12,28216,36,0.13,28215,28216
وجامي,سرمايه گذاري جامي,870,8822416,39028960355,4363,4493,4400,37,0.85,4424,61,1.4,4300,4493
سامان,بانك سامان,869,18716242,69545937498,3672,3781,3623,-49,-1.33,3716,44,1.2,3600,3782
تاپكيش,تجارت الكترونيك پارسيان كيش,864,3361785,44235866910,13890,14390,13060,-830,-5.98,13160,-730,-5.26,13060,14390
بالاس,مهندسي ساختمان تاسيسات راه آهن,864,1055162,32145842050,31000,31750,30000,-1000,-3.23,30450,-550,-1.77,29550,32150
شاراك,پتروشيمي شازند,862,1023443,47990985650,46700,46850,47000,300,0.64,46790,90,0.19,46360,47400
كگل,معدني و صنعتي گل گهر,862,2760066,37035740840,13600,13660,13350,-250,-1.84,13540,-60,-0.44,13240,13660
وشهر,بانك شهر,851,21939567,98892582672,4555,4555,4590,35,0.77,4507,-48,-1.05,4419,4630
تبرك,گروه كارخانجات صنعتي تبرك,850,4687712,42971474370,9610,9580,9130,-480,-4.99,9170,-440,-4.58,9130,9600
فنورد,نوردوقطعات‌ فولادي‌,843,561211,128763301960,241100,229050,229050,-12050,-5,229440,-11660,-4.84,229050,235900
غدشت,دشت‌ مرغاب‌,843,3467749,63064937570,18130,18130,18300,170,0.94,18190,60,0.33,17230,19000
سهرمز,سيمان‌هرمزگان‌,838,2931970,67266557740,23390,24390,23090,-300,-1.28,22940,-450,-1.92,22230,24390
ميهن,بيمه ميهن,835,11254493,42862064261,3743,3900,3856,113,3.02,3808,65,1.74,3600,3929
وصنعت,سرمايه گذاري توسعه صنعت وتجارت,823,15376269,34694055543,2306,2296,2248,-58,-2.52,2256,-50,-2.17,2222,2349
وآفر,سرمايه گذاري ارزش آفرينان,823,6018673,179807331200,30750,29850,29850,-900,-2.93,29850,-900,-2.93,29850,30750
ولراز,ليزينگ رازي,819,1300240,36383878250,28350,27700,27500,-850,-3,28000,-350,-1.23,27500,28900
اتكاي,بيمه اتكايي ايرانيان,816,20879362,289714948520,13830,14000,14240,410,2.96,13880,50,0.36,13800,14450
زنگان,صنعت روي زنگان,814,850292,44067570400,54500,55250,51250,-3250,-5.96,51850,-2650,-4.86,51250,55250
چدن,توليدي چدن سازان,811,16189490,38197658863,2421,2420,2300,-121,-5,2359,-62,-2.56,2296,2477
شوينده,مديريت صنعت شوينده ت.ص.بهشهر,810,2309672,48765076720,22120,22400,20800,-1320,-5.97,21110,-1010,-4.57,20800,22400
سفار,سيمان‌فارس‌,806,1176737,105127214810,93460,92800,89580,-3880,-4.15,89340,-4120,-4.41,88790,92800
ركيش,كارت اعتباري ايران كيش,803,7538273,37143638350,5150,5050,4900,-250,-4.85,4930,-220,-4.27,4900,5250
ضسپا3016,اختيارخ خساپا-2500-1401/03/25,803,43014,298071000,14,13,6,-8,-57.14,7,-7,-50,5,13
ارفع,شركت آهن و فولاد ارفع,800,4132583,55956420860,14030,14030,13670,-360,-2.57,13610,-420,-2.99,13380,14030
تسه9903,امتياز تسهيلات مسكن خرداد99,798,9769,11457103584,1145690,1130011,1194879,49189,4.29,1172802,27112,2.37,1130011,1200000
كنور,توسعه معدني و صنعتي صبانور,794,2132395,41200279460,19890,19730,19150,-740,-3.72,19650,-240,-1.21,19010,20150
زفكا,كشت و دامداري فكا,789,4838431,48889911280,10660,10740,10030,-630,-5.91,10100,-560,-5.25,10030,10740
پاكشو,گروه صنعتي پاكشو,787,5001096,32854378610,6730,6700,6490,-240,-3.57,6680,-50,-0.74,6410,6730
سحرخيز,صندوق س. گروه زعفران سحرخيز,782,2011699,41329099052,20018,20400,20920,902,4.51,20544,526,2.63,19958,20930
وبيمه,سرمايه‌ گذاري‌ صنعت‌ بيمه‌,781,15809217,26131548275,1717,1755,1614,-103,-6,1653,-64,-3.73,1614,1775
تايرا,تراكتورسازي‌ايران‌,778,3123005,56469887100,17260,17990,17950,690,4,18080,820,4.75,17280,18290
كحافظ,كاشي‌ وسراميك‌ حافظ‌,771,11758873,58085823000,5057,5110,4900,-157,-3.1,4940,-117,-2.31,4810,5110
كترام,توليدي‌ كاشي‌ تكسرام‌,764,1913417,51281354300,27860,27860,26470,-1390,-4.99,26800,-1060,-3.8,26470,28000
تسه9904,امتياز تسهيلات مسكن تير99,762,8163,10391175628,1257617,1257000,1299959,42342,3.37,1272960,15343,1.22,1250000,1309999
كتوكا,توليدي و خدمات صنايع نسوز توكا,762,2808932,24968902280,8850,9160,8890,40,0.45,8890,40,0.45,8640,9170
ولغدر,ليزينگ‌خودروغدير,760,2982187,34515986700,11450,11720,11250,-200,-1.75,11570,120,1.05,10890,12100
وصنا,گروه‌صنايع‌بهشهرايران‌,751,9179518,30291167636,3469,3490,3282,-187,-5.39,3300,-169,-4.87,3261,3490
ومعادن,توسعه‌معادن‌وفلزات‌,749,5588214,32486678240,5840,5890,5800,-40,-0.68,5830,-10,-0.17,5700,5900
اهرم,صندوق س سهامي كاريزما- اهرمي,749,7536570,102365576190,13530,13890,13350,-180,-1.33,13580,50,0.37,13300,13890
كوير,توليدي فولاد سپيد فراب كوير,744,8740330,36188017232,4214,4250,4091,-123,-2.92,4149,-65,-1.54,4090,4295
وسپه,سرمايه‌گذاري‌ سپه‌,743,5293394,46987510990,8930,8910,8780,-150,-1.68,8880,-50,-0.56,8730,9080
رانفور,خدمات‌انفورماتيك‌,742,11495692,47992964843,4309,4271,4239,-70,-1.62,4202,-107,-2.48,4051,4339
كيميا,معدني كيمياي زنجان گستران,731,3982538,26796554790,6820,6900,6620,-200,-2.93,6730,-90,-1.32,6600,6950
پرديس,سرمايه گذاري پرديس,728,10702085,35170272736,3236,3270,3310,74,2.29,3286,50,1.55,3251,3332
خفنر,فنرسازي‌خاور,725,6347125,42953782070,6610,6870,6690,80,1.21,6770,160,2.42,6550,6940
ومهان,گروه توسعه مالي مهر آيندگان,717,11655525,64936462370,5670,5600,5460,-210,-3.7,5570,-100,-1.76,5400,5780
كامياب,صندوق س. كامياب آشنا-د,717,13512591,164130114393,12132,12147,12146,14,0.12,12146,14,0.12,12146,12147
خلنت,لنت‌ ترمزايران‌,715,1159542,39984227510,35880,36600,34090,-1790,-4.99,34480,-1400,-3.9,34090,36600
آ س پ,آ.س.پ,715,5655662,30740928320,5700,5790,5540,-160,-2.81,5440,-260,-4.56,5360,5790
گپارس,امور رفاهي كارگزاران پارس,710,255095,30394514400,118950,122500,118550,-400,-0.34,119150,200,0.17,115400,122500
حفارس,حمل و نقل بين المللي خليج فارس,709,9337822,86239469480,9260,9210,9470,210,2.27,9240,-20,-0.22,9100,9500
غگلستا,شير پاستوريزه پگاه گلستان,705,3655169,45850091320,12470,12460,12700,230,1.84,12540,70,0.56,12000,12860
ثفارس,عمران‌وتوسعه‌فارس‌,705,7123126,47648716370,6980,7050,6640,-340,-4.87,6690,-290,-4.15,6640,7050
ثنام,س ساختماني ب نام آوران مهندسي,702,4284803,25745745780,5890,6040,6060,170,2.89,6010,120,2.04,5760,6060
خپويش,سازه‌ پويش‌,702,5511476,82132725250,14200,14910,14910,710,5,14900,700,4.93,14360,14910
سكه0312پ01,تمام سكه طرح جديد0312 رفاه,701,282600,418767829000,1452687,1487001,1484470,31783,2.19,1481839,29152,2.01,1473510,1487001
كرماشا,صنايع پتروشيمي كرمانشاه,697,1956009,129239974710,66060,66500,65860,-200,-0.3,66070,10,0.02,65360,67100
حپترو,حمل و نقل پتروشيمي( سهامي عام,693,1676302,43762725550,25320,26500,25860,540,2.13,26110,790,3.12,24310,26580
بپاس,بيمه پاسارگاد,690,6260248,311457702000,49750,49750,49750,0,0,49750,0,0,49500,49850
غديس,پاكديس,682,2605104,31378579310,12470,12310,11810,-660,-5.29,12050,-420,-3.37,11730,12650
فخاس,فولاد خراسان,679,1960272,40753832770,21820,21690,20730,-1090,-5,21380,-440,-2.02,20730,21690
خكار,ايركا پارت صنعت,679,9053280,24413339013,2768,2716,2628,-140,-5.06,2697,-71,-2.57,2620,2800
ثتران,سرمايه گذاري مسكن تهران,678,7394743,25987143874,3546,3580,3440,-106,-2.99,3514,-32,-0.9,3400,3670
غچين,كشت‌ و صنعت‌ چين‌ چين,677,6545229,87402312970,12900,12670,13540,640,4.96,13350,450,3.49,12630,13540
والبر,سرمايه‌ گذاري‌ البرز(هلدينگ‌,674,5846441,43502775240,7470,7600,7370,-100,-1.34,7440,-30,-0.4,7220,7690
دروز,داروسازي‌ روزدارو,672,899643,22570126670,25850,26400,24560,-1290,-4.99,25090,-760,-2.94,24560,26400
تسه0011,امتيازتسهيلات مسكن بهمن 1400,669,7542,8931848189,1175991,1153500,1225000,49009,4.17,1184281,8290,0.7,1117192,1234790
ساذري,آذريت‌,666,6639909,40503672380,5950,6120,6090,140,2.35,6100,150,2.52,5970,6120
حتايد,تايدواترخاورميانه,665,6788240,37865471430,5810,5810,5560,-250,-4.3,5580,-230,-3.96,5490,5810
وايران,ليزينگ ايرانيان,659,8689512,24262325901,2762,2885,2733,-29,-1.05,2792,30,1.09,2701,2885
غفارس,شير پاستوريزه پگاه فارس,657,3931631,25018270120,6250,6320,6300,50,0.8,6360,110,1.76,6180,6560
كمرجان,بازرگاني و توليدي مرجان كار,657,3959202,24108535330,5990,6120,5960,-30,-0.5,6090,100,1.67,5850,6300
شفارا,پتروشيمي فارابي,657,3766809,21635761320,5590,5590,5740,150,2.68,5740,150,2.68,5590,5750
حريل,ريل پردازسير,652,6948740,19721372135,2847,2889,2820,-27,-0.95,2838,-9,-0.32,2761,2960
عيار,صندوق طلاي عيار مفيد,651,1219808,45326570018,36484,37430,37250,766,2.1,37159,675,1.85,36950,37430
خاذين,سايپاآذين‌,651,13776070,26966655031,2044,2011,1942,-102,-4.99,1957,-87,-4.26,1942,2040
ديران,ايران‌دارو,650,2381144,46415808930,20420,19700,19400,-1020,-5,19490,-930,-4.55,19400,20190
كهمدا,شيشه‌ همدان‌,644,5307147,66114185000,12790,12790,12430,-360,-2.81,12460,-330,-2.58,12290,13000
هجرت,پخش هجرت,643,1106366,34920447750,31650,31350,31700,50,0.16,31550,-100,-0.32,30750,32150
زشگزا,شير و گوشت زاگرس شهركرد,643,8974175,60407637900,6840,6980,6770,-70,-1.02,6730,-110,-1.61,6510,6980
نوين,بيمه نوين,641,9157290,18156505523,2045,2048,1924,-121,-5.92,1983,-62,-3.03,1923,2097
ساينا,صنايع بهداشتي ساينا,641,332658,27248045550,86300,82500,81150,-5150,-5.97,81900,-4400,-5.1,81150,87050
گكوثر,هتل پارسيان كوثر اصفهان,639,19537366,30680236794,1658,1620,1569,-89,-5.37,1570,-88,-5.31,1559,1680
وبوعلي,سرمايه‌گذاري‌بوعلي‌,635,7760885,40777984110,5230,5200,5190,-40,-0.76,5250,20,0.38,5180,5390
وبهمن,سرمايه‌گذاري‌بهمن‌,635,1632058,28251497550,16700,17420,17180,480,2.87,17310,610,3.65,16900,17700
ساوه,سيمان ساوه,635,496011,24259332700,50800,49950,48300,-2500,-4.92,48900,-1900,-3.74,48300,51500
شدوص,دوده‌ صنعتي‌ پارس‌,630,3323334,43614628050,12940,13400,13140,200,1.55,13120,180,1.39,12770,13400
شرانل,نفت ايرانول,630,936436,48863903350,54050,54850,51700,-2350,-4.35,52200,-1850,-3.42,51400,54850
فمراد,آلومراد,629,3613638,109717796690,27770,29400,30870,3100,11.16,30360,2590,9.33,29390,30870
پسهند,صنايع‌ لاستيكي‌  سهند,626,2224220,85233857440,38280,39890,37800,-480,-1.25,38320,40,0.1,37700,39890
بكام,كارخانجات توليدي شهيد قندي,626,10405327,19496123464,1909,1915,1851,-58,-3.04,1874,-35,-1.83,1836,1950
فروس,فروسيليس‌ ايران‌,625,6100736,44663077650,7240,7210,7230,-10,-0.14,7320,80,1.1,7180,7560
شفن,پتروشيمي فناوران,621,1837896,22300460500,12240,12150,12150,-90,-0.74,12220,-20,-0.16,12000,12250
غشصفا,شيرپاستوريزه‌پگاه‌اصفهان‌,617,1440427,27778798720,20230,20750,19020,-1210,-5.98,19290,-940,-4.65,19020,20990
غپآذر,شير پگاه آذربايجان شرقي,616,1035116,37059412300,37850,36050,35600,-2250,-5.94,35800,-2050,-5.42,35600,38250
غگرجي,بيسكويت‌  گرجي‌,614,11291932,20692626375,1901,1927,1806,-95,-5,1833,-68,-3.58,1806,1949
غمهرا,توليدي‌مهرام‌,613,3377588,42853099580,12220,12780,12830,610,4.99,12690,470,3.85,11950,12830
فسپا,گروه‌صنعتي‌سپاهان‌,611,2269616,35865894590,16020,16010,15630,-390,-2.43,15800,-220,-1.37,15520,16270
خريخت,صنايع‌ريخته‌گري‌ايران‌,610,12692398,41778866403,3421,3440,3250,-171,-5,3292,-129,-3.77,3250,3498
پدرخش,درخشان‌ تهران‌,601,3666789,27282149160,7640,8000,7260,-380,-4.97,7440,-200,-2.62,7260,8000
ونيكي,سرمايه‌گذاري‌ ملي‌ايران‌,600,6075182,59565373040,9910,9990,9620,-290,-2.93,9820,-90,-0.91,9620,10050
اطلس,صندوق س.توسعه اطلس مفيد-س,597,148784,40918339332,277424,279997,273754,-3670,-1.32,275018,-2406,-0.87,273405,280997
ضسپا3015,اختيارخ خساپا-2000-1401/03/25,591,29565,2404767000,140,140,55,-85,-60.71,81,-59,-42.14,53,149
نطرين,عطرين نخ قم,589,2491166,14535017590,5800,6090,5680,-120,-2.07,5830,30,0.52,5670,6090
گكيش,توريستي ورفاهي آبادگران كيش,587,1061526,36024880350,34150,34600,33800,-350,-1.02,33950,-200,-0.59,33150,35150
ستران,سيمان‌ تهران‌,587,1501969,39323200420,26980,27690,26980,0,0,26180,-800,-2.97,25600,27690
پلاسك,پلاسكوكار,584,8978125,27054828398,3135,3260,2979,-156,-4.98,3013,-122,-3.89,2979,3260
سدور,سيمان‌ دورود,578,2939205,21607704440,7580,7750,7290,-290,-3.83,7350,-230,-3.03,7210,7770
شكلر,نيروكلر,577,1045231,49801488010,50100,49590,47100,-3000,-5.99,47650,-2450,-4.89,47100,50000
دجابر,داروسازي‌ جابرابن‌حيان‌,576,2996279,34595814530,12180,11860,11460,-720,-5.91,11550,-630,-5.17,11450,12500
درسا,صندوق سرمايه گذاري درسا - سهام,574,14661435,146614350000,10000,10000,10000,0,0,10000,0,0,10000,10000
تاصيكو,سرمايه گذاري صدرتامين,573,4323078,46001936280,10780,10610,10510,-270,-2.5,10730,-50,-0.46,10500,10850
فغدير,آهن و فولاد غدير ايرانيان,568,4870000,95841600000,18572,19680,19680,1108,5.97,19680,1108,5.97,19680,19680
ددام,داروسازي زاگرس فارمد پارس,568,3299572,43228661440,12530,12900,13360,830,6.62,13100,570,4.55,12610,13450
پارسان,گسترش نفت و گاز پارسيان,565,2859623,86444959270,30220,30360,29970,-250,-0.83,30230,10,0.03,29680,31000
ولشرق,ليزينگ ايران و شرق,561,7695455,18783986919,2473,2490,2390,-83,-3.36,2441,-32,-1.29,2328,2596
وبشهر,توسعه‌ صنايع‌ بهشهر(هلدينگ,560,3884772,32515450940,8690,8690,8350,-340,-3.91,8480,-210,-2.42,8170,8700
بهپاك,صنعتي بهپاك,554,5421975,42200712460,8040,8050,7840,-200,-2.49,7780,-260,-3.23,7600,8050
ثنور,سرمايه گذاري كوه نور,551,4628472,36533949690,8080,8150,7840,-240,-2.97,7890,-190,-2.35,7840,8220
فسازان,غلتك سازان سپاهان,550,3590015,18615662920,5410,5310,5150,-260,-4.81,5190,-220,-4.07,5140,5520
وخاور,بانك خاورميانه,550,15273248,86814968120,5930,5990,5640,-290,-4.89,5680,-250,-4.22,5640,5990
وآرين,شركت توسعه اقتصادي آرين,549,22618156,29227136785,1256,1293,1293,37,2.95,1292,36,2.87,1266,1293
خاهن,آهنگري‌ تراكتورسازي‌ ايران‌,548,3466364,20231650070,5830,5980,5720,-110,-1.89,5830,0,0,5720,6060
دزهراوي,داروسازي‌زهراوي‌,548,6735182,33709108780,5120,5120,4920,-200,-3.91,5000,-120,-2.34,4900,5180
شزنگ,تجهيزنيروي‌زنگان‌,547,219027,18591347150,86450,88000,83900,-2550,-2.95,84900,-1550,-1.79,83900,88700
چافست,افست‌,545,4051167,20472953718,5000,5230,4888,-112,-2.24,5054,54,1.08,4800,5250
كپشير,پشم‌شيشه‌ايران‌,544,2670329,31845821590,11750,12330,11700,-50,-0.43,11930,180,1.53,11510,12330
آسيا,بيمه آسيا,544,10148477,18515495022,1858,1885,1785,-73,-3.93,1824,-34,-1.83,1785,1885
سرچشمه,سرمايه گذاري مس سرچشمه,543,7444421,33855656701,4546,4530,4550,4,0.09,4548,2,0.04,4455,4681
فايرا,آلومينيوم‌ايران‌,541,5072157,101209862720,19840,20190,20000,160,0.81,19950,110,0.55,19500,20190
ثپرديس,سرمايه گذاري مسكن پرديس,540,8632947,39893246398,4861,4861,4570,-291,-5.99,4621,-240,-4.94,4570,4920
دشيمي,شيمي‌ داروئي‌ داروپخش‌,538,3891271,108174695330,26850,26600,28190,1340,4.99,27800,950,3.54,26220,28190
چكاوه,صنايع‌كاغذسازي‌كاوه‌,538,4348936,33094891440,7660,7720,7410,-250,-3.26,7610,-50,-0.65,7390,7970
زمگسا,كشاورزي‌ ودامپروي‌ مگسال‌,537,1353984,35027375090,27000,27530,25650,-1350,-5,25870,-1130,-4.19,25650,27900
فردا,صندوق س آواي فرداي زاگرس-ثابت,531,20596092,270732691133,13123,13144,13145,22,0.17,13145,22,0.17,13144,13145
خكمك,كمك‌فنرايندامين‌,528,1609694,33719212760,21470,22200,20550,-920,-4.29,20950,-520,-2.42,20460,22200
سمايه,بانك سرمايه,528,4724121,16993195810,3679,3717,3569,-110,-2.99,3597,-82,-2.23,3569,3769
هامرز,صندوق س اعتماد هامرز-ثابت,527,25032637,253586661109,10113,10131,10131,18,0.18,10130,17,0.17,10130,10131
ضخود4017,اختيارخ خودرو-3250-1401/04/08,521,25697,109850000,10,8,5,-5,-50,4,-6,-60,4,8
كارين,صندوق س نگين سامان-ثابت,519,24219286,243265260712,10035,10041,10047,12,0.12,10044,9,0.09,10040,10048
دلر,داروسازي‌ اكسير,517,712079,32478644510,45920,46050,45300,-620,-1.35,45610,-310,-0.68,45050,46500
سپيدما,صندوق س. سپيد دماوند-د,516,27492665,347871091868,12635,12652,12653,18,0.14,12653,18,0.14,12652,12657
وثنو,سرمايه گذاري ساختماني نوين,516,6453999,15162667143,2405,2430,2333,-72,-2.99,2349,-56,-2.33,2333,2430
شكبير,پتروشيمي اميركبير,513,1096918,97154861500,91200,90850,88500,-2700,-2.96,88550,-2650,-2.91,88500,91000
دلقما,دارويي‌ لقمان‌,504,7510999,15503025534,2109,2150,2019,-90,-4.27,2064,-45,-2.13,2016,2150
وتوسم,سرمايه‌گذاري‌توسعه‌ملي‌,501,8902428,39649223322,4512,4515,4355,-157,-3.48,4454,-58,-1.29,4352,4580
وثوق,سرمايه گذاري وثوق امين,498,8300972,74161673530,8680,8940,8940,260,3,8930,250,2.88,8750,8940
كوثر,بيمه كوثر,492,7542297,29489918853,4028,4048,3838,-190,-4.72,3910,-118,-2.93,3827,4118
ماني,صندوق س. با درآمد ثابت ماني,490,13010071,153074927060,11745,11765,11766,21,0.18,11766,21,0.18,11765,11768
مدير,ص.س.مديريت ثروت ص.بازنشستگي-س,486,2276827,25509654691,11215,11390,11030,-185,-1.65,11204,-11,-0.1,10970,11390
سكرما,سيمان‌ كرمان‌,484,2732640,36925926870,13300,14090,13460,160,1.2,13510,210,1.58,13140,14090
كمنگنز,معادن‌منگنزايران‌,482,1147856,19413091150,16540,16780,17080,540,3.26,16910,370,2.24,16400,17130
شساخت,مهندسي و ساختمان صنايع نفت,482,1760664,81430140150,44950,46250,46250,1300,2.89,46250,1300,2.89,46100,46250
رتاپ,تجارت الكترونيك  پارسيان,481,1442619,7080503230,5020,5180,4890,-130,-2.59,4970,-50,-1,4800,5180
تكمبا,كمباين‌ سازي‌ ايران‌,478,5199536,23712514283,4514,4783,4490,-24,-0.53,4561,47,1.04,4415,4783
گوهر,صندوق سكه طلاي كيان,478,539946,39180470066,71873,72100,73299,1426,1.98,72564,691,0.96,71700,73400
شبهرن,نفت‌ بهران‌,477,2743336,39143143060,14480,14070,14110,-370,-2.56,14360,-120,-0.83,14070,14700
وسكاب,س.ص.بازنشستگي كاركنان بانكها,475,6790528,20056404068,2999,2983,2911,-88,-2.93,2954,-45,-1.5,2900,3098
آريان,سرمايه گذاري پارس آريان,474,16155268,118083361430,7100,7270,7310,210,2.96,7310,210,2.96,7220,7310
سدشت,صنايع سيمان دشتستان,473,609571,19514665280,33520,33350,31850,-1670,-4.98,32010,-1510,-4.5,31850,33400
آبين,كشت و صنعت آبشيرين,471,10763002,51060550388,4888,4761,4742,-146,-2.99,4744,-144,-2.95,4742,4798
سفاسي,شركت فارسيت اهواز,471,4488392,13680972485,3136,3050,3042,-94,-3,3048,-88,-2.81,3042,3169
سلام,صندوق س سلام فارابي-سهام,470,4746499,46852124510,10000,9990,9830,-170,-1.7,9870,-130,-1.3,9800,10010
كروي,توسعه‌ معادن‌ روي‌ ايران‌,470,1888809,48794994020,26060,26650,25620,-440,-1.69,25830,-230,-0.88,25400,26670
زشريف,كشت وصنعت شريف آباد,469,5584605,23269070830,4368,4368,4106,-262,-6,4167,-201,-4.6,4106,4419
تكشا,گسترش‌صنايع‌وخدمات‌كشاورزي‌,468,450167,16135078220,36960,36050,35400,-1560,-4.22,35840,-1120,-3.03,35140,37060
خراسان,پتروشيمي خراسان,467,223455,29492085980,132080,133000,132390,310,0.23,132050,-30,-0.02,131420,133290
چفيبر,فيبر ايران‌,466,3369658,20750551260,6390,6330,6080,-310,-4.85,6160,-230,-3.6,6080,6600
رنيك,جنرال مكانيك,460,2872656,39562826990,13960,13860,13650,-310,-2.22,13770,-190,-1.36,13500,14220
قشكر,شكرشاهرود,459,8863010,20823261835,2438,2466,2317,-121,-4.96,2349,-89,-3.65,2317,2466
دامين,داروسازي‌ امين‌,459,5497901,18634614970,3442,3500,3299,-143,-4.15,3389,-53,-1.54,3278,3600
تماوند,تامين سرمايه دماوند,459,10110867,55629850520,5250,5510,5510,260,4.95,5500,250,4.76,5240,5510
شنفت,نفت‌ پارس‌,456,2066539,18179220940,8920,9050,8680,-240,-2.69,8880,-40,-0.45,8650,9050
دبالك,مواد اوليه دارويي البرز بالك,453,2249587,23555008790,10670,11110,10300,-370,-3.47,10470,-200,-1.87,10250,11110
كمينا,شيشه سازي مينا,452,5496205,61093236420,10920,11240,10960,40,0.37,11120,200,1.83,10620,11240
فنوال,نورد آلومينيوم‌,448,967664,31130227390,33120,33770,32180,-940,-2.84,32170,-950,-2.87,31830,33770
ومعلم,بيمه معلم,444,8470848,19659337511,2312,2359,2285,-27,-1.17,2321,9,0.39,2200,2360
شكام,صنايع شيميايي كيمياگران امروز,438,1971680,65958751150,33750,34050,33300,-450,-1.33,33450,-300,-0.89,32500,34750
نهال,صندوق س. طلاي سرخ نوويرا,438,2570273,54988516679,21031,21400,21469,438,2.08,21394,363,1.73,21101,21573
دكوثر,داروسازي‌ كوثر,438,6439675,21764507090,3556,3510,3343,-213,-5.99,3380,-176,-4.95,3343,3588
بخاور,بيمه زندگي خاورميانه,435,5584041,13964706720,2544,2575,2493,-51,-2,2503,-41,-1.61,2451,2575
ولملت,واسپاري ملت,434,5703862,24740943578,4121,4365,4367,246,5.97,4338,217,5.27,4200,4368
واميد,گروه مديريت سرمايه گذاري اميد,433,2832550,41483953860,14790,15180,14450,-340,-2.3,14740,-50,-0.34,14390,15180
وگستر,گسترش سرمايه گذاري ايرانيان,433,3248851,21444925400,6950,6690,6540,-410,-5.9,6600,-350,-5.04,6540,7090
كسعدي,كاشي‌ سعدي‌,431,2994017,26172397780,9010,9000,8560,-450,-4.99,8740,-270,-3,8560,9150
بتك,كارخانجات كابل سازي‌ تك‌,428,307001,48428180200,154800,157850,157850,3050,1.97,157750,2950,1.91,151750,157850
ثجوان,تامين مسكن جوانان,426,5964302,25471493298,4369,4390,4300,-69,-1.58,4271,-98,-2.24,4238,4450
آساميد,صندوق س.مشترك آسمان اميد -د,424,8691464,129638359052,14891,14916,14916,25,0.17,14916,25,0.17,14915,14916
وپاسار,بانك  پاسارگاد,424,15868655,142184216880,8960,8960,8960,0,0,8960,0,0,8960,8970
حآفرين,ريل پرداز نو آفرين,423,4225100,15834418532,3831,3850,3775,-56,-1.46,3748,-83,-2.17,3651,3875
ثزاگرس,سرمايه گذاري توسعه عمران زاگرس,423,570245,18478796450,33150,33200,32200,-950,-2.87,32400,-750,-2.26,32200,33700
بساما,بيمه سامان,423,2556808,31726214060,12010,12010,12610,600,5,12410,400,3.33,12010,12610
جهرم,پتروشيمي جهرم,422,12411898,10462432452,864,884,839,-25,-2.89,843,-21,-2.43,839,884
توريل,توكاريل,420,2146145,18836664820,9080,9000,8660,-420,-4.63,8780,-300,-3.3,8630,9170
بالبر,كابل‌ البرز,418,1727643,63903335230,35250,37010,37010,1760,4.99,36990,1740,4.94,36050,37010
دكپسول,توليد ژلاتين كپسول ايران,418,633803,25342364650,39300,40400,40100,800,2.04,40000,700,1.78,39650,40700
تيپيكو,سرمايه گذاري دارويي تامين,418,3016884,65859886650,22100,21780,21620,-480,-2.17,21920,-180,-0.81,21550,22200
شپتروح,ح . پتروشيمي آبادان,415,9456559,10088524239,1073,1100,1041,-32,-2.98,1067,-6,-0.56,1041,1105
اپرداز,آتيه داده پرداز,415,1485732,20178230310,13970,14300,13280,-690,-4.94,13580,-390,-2.79,13280,14300
پاسا,ايران‌ياساتايرورابر,412,1233902,16508374810,13300,13520,13320,20,0.15,13380,80,0.6,12860,13600
لخانه,لوازم‌ خانگي‌ پارس‌,410,1679569,32316222190,19310,19550,19660,350,1.81,19240,-70,-0.36,18740,19750
ونفت,سرمايه‌گذاري‌ صنعت‌ نفت‌,408,4028453,17607189784,4391,4400,4299,-92,-2.1,4371,-20,-0.46,4200,4479
خمحور,توليدمحورخودرو,407,8132273,20492274379,2619,2620,2489,-130,-4.96,2520,-99,-3.78,2489,2680
تابا,تابان نيرو سپاهان,407,611554,14182676800,23550,23900,22850,-700,-2.97,23200,-350,-1.49,22850,24200
تپمپي,پمپ‌ سازي‌ ايران‌,404,1674175,28929714050,18080,17550,17180,-900,-4.98,17280,-800,-4.42,17180,18440
لخزر,پارس‌ خزر,402,101344,12814713740,129300,128000,124700,-4600,-3.56,126810,-2490,-1.93,124020,133390
فلامي,لاميران‌,398,1056478,20090397760,19250,20110,19450,200,1.04,19020,-230,-1.19,18300,20110
خشرق,الكتريك‌ خودرو شرق‌,398,2164143,30503119170,14680,14370,13950,-730,-4.97,14090,-590,-4.02,13950,14970
غالبر,لبنيات‌ كالبر,395,1690793,18286152170,11180,11190,10630,-550,-4.92,10820,-360,-3.22,10630,11350
غبهار,كشت وصنعت بهاران گلبهار خراسان,393,835028,12643050100,15510,15900,15050,-460,-2.97,15140,-370,-2.39,15050,15900
دتوزيع,توزيع دارو پخش,390,1124466,40055621850,35450,35900,34950,-500,-1.41,35600,150,0.42,34500,36100
واحيا,م .صنايع و معادن احياء سپاهان,390,2888395,55907063150,19690,19500,19330,-360,-1.83,19390,-300,-1.52,19110,19890
قمرو,قند مرودشت‌,387,689769,19228074690,27390,27230,27990,600,2.19,27880,490,1.79,27230,28590
سبهان,سيمان‌ بهبهان‌,386,261400,11898485180,46980,47000,45240,-1740,-3.7,45780,-1200,-2.55,45200,47130
تسه0010,امتيازتسهيلات مسكن دي1400,385,3453,4108178825,1184093,1152500,1192000,7907,0.67,1189742,5649,0.48,1152500,1220000
تصميم,صندوق س با درآمد ثابت تصميم,385,11111685,221033687006,19877,19891,19893,16,0.08,19892,15,0.08,19891,19894
سصوفي,سيمان‌ صوفيان‌,385,924403,16916196490,18780,18990,17870,-910,-4.85,18300,-480,-2.56,17810,18990
شيراز,پتروشيمي‌شيراز,381,530812,41152892570,77860,77710,77010,-850,-1.09,77720,-140,-0.18,76050,79860
حتوكا,حمل‌ونقل‌توكا,378,1245980,20276752560,16560,16800,16000,-560,-3.38,16270,-290,-1.75,15740,17080
دتماد,توليدمواداوليه‌داروپخش‌,377,466878,19159924540,41710,41220,40770,-940,-2.25,41040,-670,-1.61,40650,42190
لسرما,سرما آفرين‌,376,909282,23252943830,26380,26100,25070,-1310,-4.97,25570,-810,-3.07,25070,27020
حپارسا,توسعه حمل و نقل ريلي پارسيان,375,960977,39090191050,39900,42000,40000,100,0.25,40700,800,2.01,39900,42000
شخارك,پتروشيمي‌ خارك‌,375,556376,26164013380,47360,47000,47230,-130,-0.27,47270,-90,-0.19,46510,47970
وليز,ليزينگ‌ايران‌,371,5620150,9957780245,1852,1799,1760,-92,-4.97,1796,-56,-3.02,1760,1879
شگل,گلتاش‌,370,2030865,11820826360,6020,6020,5740,-280,-4.65,5860,-160,-2.66,5680,6020
دفرا,فرآورده‌هاي‌ تزريقي‌ ايران‌,369,1328230,24903415380,18400,18470,19050,650,3.53,18750,350,1.9,18000,19310
قشير,قند شيروان قوچان و بجنورد,369,1922908,12908262620,7050,7250,6660,-390,-5.53,6750,-300,-4.26,6630,7250
نمرينو,ايران‌ مرينوس‌,368,170182,15121210700,85880,88590,90170,4290,5,88780,2900,3.38,83280,90170
جم,پتروشيمي جم,367,607422,28527738820,47190,47200,47120,-70,-0.15,47130,-60,-0.13,46540,47980
وكادو,تكادو,366,2242214,40244167000,18370,18160,17820,-550,-2.99,17950,-420,-2.29,17820,18530
سفارود,كارخانه فارسيت درود,366,1541941,9935793030,6500,6600,6390,-110,-1.69,6440,-60,-0.92,6370,6630
ساروم,سيمان‌اروميه‌,365,999994,28192206130,28380,28410,27870,-510,-1.8,28190,-190,-0.67,27410,29140
غبهنوش,بهنوش‌ ايران‌,365,245362,14350342130,58900,57230,57530,-1370,-2.33,58500,-400,-0.68,57230,61500
وثنوح,ح. سرمايه گذاري ساختماني نوين,364,4333855,5609508450,1330,1291,1291,-39,-2.93,1294,-36,-2.71,1291,1335
وملل,اعتباري ملل,361,3273643,24129164150,7700,7700,7320,-380,-4.94,7430,-270,-3.51,7320,7700
قجام,فرآوردههاي غذايي وقندتربت‌جام‌,359,3882798,23861641920,6260,6250,6140,-120,-1.92,6150,-110,-1.76,6140,6250
سخاش,سيمان‌خاش‌,358,186915,11938857210,65310,65000,62880,-2430,-3.72,64140,-1170,-1.79,62750,66000
تسه0009,امتيازتسهيلات مسكن آذر 1400,358,3715,4387215568,1172558,1231185,1190010,17452,1.49,1180946,8388,0.72,1144444,1231185
اوان,مبين وان كيش,357,2803652,34372143070,11640,11920,12330,690,5.93,12260,620,5.33,11670,12330
زر,صندوق س.پشتوانه سكه طلاي زر,357,201065,12889620683,62528,63000,64165,1637,2.62,64107,1579,2.53,63000,64440
سغرب,سيمان‌غرب‌,355,1273857,24054813040,19580,19160,18600,-980,-5.01,18880,-700,-3.58,18500,19970
فن آوا,گروه فن آوا,353,1437828,11768939040,8320,8180,8080,-240,-2.88,8190,-130,-1.56,8080,8400
وحكمت,بيمه حكمت صبا,353,5817948,8219002757,1445,1421,1418,-27,-1.87,1418,-27,-1.87,1402,1470
فالوم,آلومتك‌,351,1457476,21041910150,14610,14800,14180,-430,-2.94,14440,-170,-1.16,14180,15000
داوه,داروسازي آوه سينا,351,1681532,12903883900,7970,8000,7550,-420,-5.27,7710,-260,-3.26,7530,8000
غشهد,شهد ايران ‌,347,1692443,10062458170,6000,6280,5780,-220,-3.67,5960,-40,-0.67,5780,6280
كپرور,فرآوري زغال سنگ پروده طبس,346,1687318,18021629500,11000,10960,10550,-450,-4.09,10680,-320,-2.91,10500,11130
شمواد,توليد مواداوليه الياف مصنوعي,345,385443,27765913800,73050,74000,73000,-50,-0.07,72050,-1000,-1.37,71600,74200
قپيرا,فرآورده‌هاي‌غدايي‌وقندپيرانشهر,345,2092801,18600332820,8560,8630,8980,420,4.91,8890,330,3.86,8410,8980
فولاژ,فولاد آلياژي ايران,340,1529712,13786054380,9180,9380,9000,-180,-1.96,9150,-30,-0.33,8930,9380
دفارا,داروسازي‌ فارابي‌,331,1297820,16922374920,13330,13020,13140,-190,-1.43,13040,-290,-2.18,12770,13500
آرمان,بيمه آرمان,330,3557218,16001052103,4413,4545,4543,130,2.95,4498,85,1.93,4281,4545
ريشمك,توليد و صادرات ريشمك,329,990810,26357592600,28200,27600,26550,-1650,-5.85,26600,-1600,-5.67,26550,28100
سمازن,سيمان‌مازندران‌,329,1415807,16217245310,11530,11720,11300,-230,-1.99,11450,-80,-0.69,11220,11900
تسه0006,امتيازتسهيلات مسكن شهريور1400,324,6734,7941328833,1189966,1130468,1191000,1034,0.09,1179288,-10678,-0.9,1130468,1249464
مثقال,صندوق س.پشتوانه طلاي زرين آگاه,324,1187303,13739824306,11326,11410,11584,258,2.28,11572,246,2.17,11410,11630
اتكام,بيمه اتكايي امين,321,3851720,16579537784,4418,4364,4296,-122,-2.76,4304,-114,-2.58,4212,4467
سخوز,سيمان خوزستان,317,918869,21831404770,24130,24290,23620,-510,-2.11,23760,-370,-1.53,23060,24290
ولانا,شركت ليزينگ آريا دانا,315,1611321,23657102950,14740,15000,14590,-150,-1.02,14680,-60,-0.41,14310,15170
پكوير,كوير تاير,312,1748744,9561721640,5460,5630,5340,-120,-2.2,5460,0,0,5250,5700
حاريا,كشتيراني آريا,309,1836509,10382551920,5550,5600,5660,110,1.98,5650,100,1.8,5590,5660
فنفت,صنايع تجهيزات نفت,308,1984741,66687297600,32650,33600,33600,950,2.91,33600,950,2.91,33600,33600
حشكوه,دليجان طلايي شكوه پارس,307,5741884,14052215183,2511,2470,2438,-73,-2.91,2447,-64,-2.55,2436,2578
ثتوسا,س.توسعه و عمران استان اردبيل,305,1003289,14564235080,14940,14800,14500,-440,-2.95,14520,-420,-2.81,14500,15270
فاما,صنعتي‌ آما,305,1267769,11390774990,9170,9390,8750,-420,-4.58,9030,-140,-1.53,8750,9390
كاذر,فرآورده‌هاي‌نسوزآذر,305,1249440,17024921230,14230,14200,13520,-710,-4.99,13630,-600,-4.22,13520,14400
ثباغ,شهر سازي و خانه سازي باغميشه,300,1302495,10847706850,8560,8320,8220,-340,-3.97,8390,-170,-1.99,8160,8840
كسرام,پارس‌ سرام‌,299,3381235,20869796580,6360,6400,6110,-250,-3.93,6170,-190,-2.99,6100,6450
اوصتا,صندوق انديشه ورزان صباتامين -د,297,12506723,284889288327,22737,22778,22779,42,0.18,22779,42,0.18,22778,22779
خبازرس,بازرسي مهندسي و صنعتي ايران,296,848581,14072956840,16940,16700,16530,-410,-2.42,16580,-360,-2.13,16450,17070
سپر,صندوق س سپر سرمايه بيدار- ثابت,295,5820904,84752810956,14545,14559,14562,17,0.12,14560,15,0.1,14558,14562
پكرمان,گروه‌ صنعتي‌ بارز,293,1388087,23690930540,17100,17550,17100,0,0,17070,-30,-0.18,16750,17550
پرداخت,به پرداخت ملت,293,949118,22477463680,23040,23650,23500,460,2,23550,510,2.21,22030,24170
همراه,شركت ارتباطات سيار ايران,290,3174394,31883397340,10330,10000,9980,-350,-3.39,10250,-80,-0.77,9840,10260
فراز,صندوق س.سهام فراز داريك-س,289,2725259,41917337574,15375,15400,15376,1,0.01,15381,6,0.04,15376,15401
كشرق,صنعتي و معدني شمال شرق شاهرود,288,294115,28878479100,98100,98150,98100,0,0,98200,100,0.1,94500,101000
بميلا,توسعه سرمايه گذاري ميلاد پارس,287,4478052,54490870560,11820,12170,12170,350,2.96,12170,350,2.96,11950,12170
بنيرو,نيروترانس‌,283,10266942,25021129049,2484,2549,2458,-26,-1.05,2437,-47,-1.89,2380,2551
زيتون,صندوق س زيتون نماد پايا- مختلط,281,2470218,30584654520,12410,12430,12340,-70,-0.56,12380,-30,-0.24,12320,12450
گوهران,سرمايه گذاري توسعه گوهران اميد,281,1702748,9442427510,5660,5670,5480,-180,-3.18,5590,-70,-1.24,5410,5700
حسينا,توسعه خدمات دريايي وبندري سينا,278,281381,14567975950,53250,54900,51600,-1650,-3.1,51750,-1500,-2.82,51000,54900
ما,بيمه  ما,278,2143636,10089958205,4890,4990,4700,-190,-3.89,4762,-128,-2.62,4597,4990
ضخود4012,اختيارخ خودرو-2200-1401/04/08,278,13217,1581350000,172,172,100,-72,-41.86,120,-52,-30.23,98,172
غشوكو,شوكو پارس,278,2296621,19603011370,8760,8980,8500,-260,-2.97,8540,-220,-2.51,8500,8990
قزوين,كارخانجات‌ قند قزوين‌,277,2614315,13833871580,5330,5470,5240,-90,-1.69,5290,-40,-0.75,5100,5470
تنوين,تامين سرمايه نوين,276,2152143,9631872524,4503,4503,4464,-39,-0.87,4496,-7,-0.16,4380,4546
كساپا,سايپاشيشه‌,276,2827235,49528587850,16690,17520,17520,830,4.97,17520,830,4.97,17020,17520
دكيمي,كيميدارو,276,912410,18218531640,20760,20610,19810,-950,-4.58,19970,-790,-3.81,19520,21000
كاريس,صندوق س.سپند كاريزما-س,275,3168732,47937319349,15444,15450,15140,-304,-1.97,15128,-316,-2.05,15050,15599
ضستا7005,اختيارخ شستا-1200-1401/07/17,274,23618,1572260000,69,72,69,0,0,67,-2,-2.9,62,74
وتوس,توسعه‌شهري‌توس‌گستر,274,1706154,13661500050,8050,8040,8040,-10,-0.12,8010,-40,-0.5,7820,8140
سپ,پرداخت الكترونيك سامان كيش,271,1139712,25804406930,22320,22060,23110,790,3.54,22430,110,0.49,21210,23250
دسبحا,گروه دارويي سبحان,269,453770,8243882020,18960,19000,18340,-620,-3.27,18680,-280,-1.48,17860,19000
سكارون,سيمان كارون,268,210479,10712135750,52150,51200,50600,-1550,-2.97,50900,-1250,-2.4,50600,52750
ولتجار,واسپاري تجار ايرانيان,267,6679623,19095483318,2792,2875,2875,83,2.97,2859,67,2.4,2709,2875
وارس,سرمايه گذاري ارس صبا,266,1031868,18244411740,17300,17800,17800,500,2.89,17680,380,2.2,16900,17810
وتعاون,بيمه تعاون,266,4982094,7192555571,1470,1500,1397,-73,-4.97,1457,-13,-0.88,1397,1509
سبجنو,سيمان‌ بجنورد,264,699230,28834259100,42460,42780,41410,-1050,-2.47,41240,-1220,-2.87,40340,43340
برن0104پ01,برنج طارم0104تجارت مازندران(پ),262,12653,11447781989,889757,934244,905003,15246,1.71,904748,14991,1.68,845270,934244
وهنر,گروه توسعه هنر ايران,262,3100066,7373887435,2442,2444,2369,-73,-2.99,2394,-48,-1.97,2369,2444
تسه0008,امتيازتسهيلات مسكن آبان1400,261,2287,2727313108,1183909,1243100,1200000,16091,1.36,1192529,8620,0.73,1130080,1243104
سهگمت,سيمان‌هگمتان‌,260,681519,17405118060,25170,26600,25680,510,2.03,25540,370,1.47,25200,26600
سارومح,ح . سيمان‌اروميه‌,259,1137335,28926939300,24960,24920,25670,710,2.84,25430,470,1.88,24920,25950
غپونه,نوش پونه مشهد,259,1325747,21029154510,15540,15710,15640,100,0.64,15860,320,2.06,15200,16000
غگلپا,شير پاستوريزه پگاه گلپايگان,258,332191,16416169450,50700,51700,48450,-2250,-4.44,49400,-1300,-2.56,48400,52150
ساراب,سيمان‌ داراب‌,258,562885,9201598480,16640,17110,16060,-580,-3.49,16460,-180,-1.08,15940,17110
تسه9905,امتياز تسهيلات مسكن مرداد99,258,2895,3796120013,1309059,1300000,1374500,65441,5,1311268,2209,0.17,1261003,1374500
فكمند,گسترش قطعه سازي كمند,252,643406,15259402500,23750,24350,23050,-700,-2.95,23700,-50,-0.21,23050,24350
فسديد,لوله‌وتجهيزات‌ سديد - ورشكسته,251,349219,17214750350,48850,49300,49300,450,0.92,49300,450,0.92,48500,49300
ضخود4013,اختيارخ خودرو-2400-1401/04/08,250,12062,565851000,70,75,40,-30,-42.86,47,-23,-32.86,38,75
سخاشح,ح . سيمان‌خاش‌,249,245925,12619012310,52640,52110,51270,-1370,-2.6,51310,-1330,-2.53,51060,52250
شصفها,پتروشيمي‌ اصفهان‌,245,302450,31096188050,103000,104950,103600,600,0.58,102800,-200,-0.19,100950,105000
ولبهمن,شركت بهمن ليزينگ,244,2603778,9574748892,3761,3672,3602,-159,-4.23,3677,-84,-2.23,3602,3845
فجام,جام‌دارو,243,1900682,9155342235,4900,4901,4889,-11,-0.22,4848,-52,-1.06,4671,5058
ضخود4014,اختيارخ خودرو-2600-1401/04/08,242,11808,234190000,34,21,18,-16,-47.06,20,-14,-41.18,18,30
ارزش,صندوق س ارزش آفرين بيدار-سهام,240,869824,9618375940,11240,11260,10910,-330,-2.94,11060,-180,-1.6,10910,11290
ثامان,سامان‌ گستراصفهان‌,240,1299872,18525869630,14860,15000,14220,-640,-4.31,14250,-610,-4.1,14120,15000
ويسا,سرمايه گذاري ايساتيس پويا,239,2700696,18196473290,6570,6710,6730,160,2.44,6740,170,2.59,6480,6760
قصفها,قنداصفهان‌,236,75079,7279701610,99970,101000,96930,-3040,-3.04,98460,-1510,-1.51,95010,101000
داسوه,داروسازي‌ اسوه‌,234,407894,19944418850,49660,49980,47990,-1670,-3.36,48900,-760,-1.53,47300,51390
كگاز,شيشه‌ و گاز,231,732908,11612393150,16280,15910,15550,-730,-4.48,15930,-350,-2.15,15550,16740
پارتا,مجتمع‌صنعتي‌آرتاويل‌تاير,230,807999,14319100060,18090,17890,18000,-90,-0.5,17750,-340,-1.88,17550,18500
شتوكا,توكا رنگ فولاد سپاهان,227,474808,8074348350,17640,17960,17060,-580,-3.29,17290,-350,-1.98,16640,17960
لازما,كارخانه هاي صنعتي آزمايش,226,1132844,26595791500,23700,23250,23250,-450,-1.9,23500,-200,-0.84,23250,24150
ضستا7003,اختيارخ شستا-1000-1401/07/17,226,13038,2037243000,169,167,151,-18,-10.65,156,-13,-7.69,150,168
تسه9906,امتياز تسهيلات مسكن شهريور99,224,1974,2583520578,1301624,1250071,1329500,27876,2.14,1308774,7150,0.55,1250071,1355555
سخزر,سيمان‌ خزر,224,1306517,31588371480,24770,24690,23530,-1240,-5.01,24180,-590,-2.38,23430,24890
سنوين,سرمايه گذاري اقتصاد نوين,223,2194423,12875945760,6040,6140,5860,-180,-2.98,5870,-170,-2.81,5860,6140
قاسم,قاسم ايران,222,3974317,17496205569,4247,4400,4459,212,4.99,4402,155,3.65,4150,4459
ثنظام,س. ساختماني نظام مهندسي ايران,218,625114,10660857010,16920,16500,17050,130,0.77,17050,130,0.77,16420,17410
ثعمرا,عمران و توسعه شاهد,218,972841,7196562670,7610,7800,7410,-200,-2.63,7510,-100,-1.31,7300,7800
قيستو,شركت قند بيستون,217,946673,21743248150,23650,23000,22950,-700,-2.96,22950,-700,-2.96,22950,23250
واعتبار,سرمايه گذاري اعتبار ايران,217,2015699,5931883515,3063,2947,2910,-153,-5,3014,-49,-1.6,2910,3057
ثشرق,سرمايه گذاري مسكن شمال شرق,213,2089993,7718254624,3820,3824,3707,-113,-2.96,3752,-68,-1.78,3650,3850
كاردان,صندوق س تجارت شاخصي كاردان,211,99562,22122418190,225100,225170,221190,-3910,-1.74,222200,-2900,-1.29,220760,228680
بايكا,كارخانجات كابلسازي ‌ايران‌,207,264437,4130490480,15650,16100,15190,-460,-2.94,15640,-10,-0.06,15190,16100
تسه9908,امتياز تسهيلات مسكن آبان99,207,2285,2718747185,1166552,1108238,1190000,23448,2.01,1189824,23272,1.99,1108238,1224879
لوتوس,تامين سرمايه لوتوس پارسيان,206,1056182,7440568640,7070,7000,7100,30,0.42,7070,0,0,6990,7220
سيلام,سيمان‌ ايلام‌,206,3123460,23210830090,7620,7750,7240,-380,-4.99,7430,-190,-2.49,7240,7810
تسه0007,امتيازتسهيلات مسكن مهر1400,206,1606,1893467904,1182992,1160002,1200000,17008,1.44,1178996,-3996,-0.34,1150000,1242141
تكنار,مجتمع معادن مس تكنار,206,111264,6666752450,60500,61000,59950,-550,-0.91,60100,-400,-0.66,59250,61800
كطبس,ذغال‌سنگ‌ نگين‌ ط‌بس‌,204,322627,6491735300,20410,20040,20400,-10,-0.05,20280,-130,-0.64,19690,20970
كي بي سي,شركت كي بي سي,200,491918,6104717210,12790,13000,12210,-580,-4.53,12410,-380,-2.97,12210,13000
زعف0110پ11,زعفران0110نگين سحرخيز(پ),197,222701,88831955381,391223,398000,403800,12577,3.21,398884,7661,1.96,393333,404000
آوا,صندوق س.سهام آواي معيار-س,196,831032,7073984684,8620,8670,8430,-190,-2.2,8512,-108,-1.25,8328,8720
دابور,داروسازي‌ ابوريحان‌,195,960684,22902548330,24290,23900,23560,-730,-3.01,23840,-450,-1.85,23560,24600
دعبيد,لابراتوارداروسازي‌  دكترعبيدي‌,194,301821,7147448860,24210,23700,23250,-960,-3.97,24120,-90,-0.37,23120,24000
وصندوق,سرمايه‌گذاري‌صندوق‌بازنشستگي‌,192,1892309,27370551530,14630,14400,14480,-150,-1.03,14590,-40,-0.27,14250,14840
كگهر,سنگ آهن گهرزمين,191,154250,7565444800,49950,50000,48850,-1100,-2.2,49900,-50,-0.1,48450,50000
كهرام,توليدي گرانيت بهسرام,190,118917,6815652550,56300,55450,57050,750,1.33,57300,1000,1.78,55450,57400
فاهواز,نورد و لوله اهواز,188,3955916,21289313980,5460,5460,5460,0,0,5380,-80,-1.47,5360,5460
تشتاد,صنايع توليدي اشتاد ايران‌,184,1345636,8003549850,6010,6180,5830,-180,-3,5960,-50,-0.83,5830,6190
ضخود5004,اختيارخ خودرو-2200-1401/05/12,181,10081,2066295000,263,205,200,-63,-23.95,205,-58,-22.05,181,210
فنرژي,گسترش صنايع انرژي آذرآب,180,576773,4673778180,8080,8240,8040,-40,-0.5,8100,20,0.25,8000,8240
سباقر,سيمان باقران,179,1150945,15585504740,13870,13520,13520,-350,-2.52,13540,-330,-2.38,13500,14000
شفا,سرمايه گذاري شفادارو,178,477716,7454514330,15680,16160,15320,-360,-2.3,15650,-30,-0.19,15320,16300
ولصنم,ليزينگ‌صنعت‌ومعدن‌,177,1455437,3944346726,2751,2800,2685,-66,-2.4,2740,-11,-0.4,2614,2830
وپخش,داروپخش‌ (هلدينگ‌,177,535819,18317880700,34060,32690,34010,-50,-0.15,34110,50,0.15,32690,35550
فسا,پتروشيمي فسا,176,3200411,2867893887,922,899,895,-27,-2.93,914,-8,-0.87,895,918
قشهد,شهد,171,533851,7843828100,14560,14370,14740,180,1.24,14630,70,0.48,14370,14880
بسويچ,پارس‌سويچ‌,171,700216,11430468790,16170,16070,16000,-170,-1.05,16290,120,0.74,15610,16480
سرود,سيمان‌شاهرود,168,460175,9768606020,21580,22000,20920,-660,-3.06,21350,-230,-1.07,20900,22000
درازك,دارويي‌ رازك‌,168,344133,5709949800,16540,16990,16350,-190,-1.15,16560,20,0.12,16250,16990
حخزر,كشتيراني درياي خزر,168,666666,12393137940,17710,18590,18590,880,4.97,18400,690,3.9,18580,18590
غناب,روغن‌ نباتي‌ ناب,167,49347,8766563950,180700,177200,177100,-3600,-1.99,177650,-3050,-1.69,177100,183000
تسه0002,امتيازتسهيلاتمسكن ارديبهشت1400,166,1797,2148682594,1177206,1153000,1175999,-1207,-0.1,1195705,18499,1.57,1118346,1236000
كهربا,صندوق س.پشتوانه سكه طلا كهربا,165,1966487,24800434573,12363,12450,12599,236,1.91,12612,249,2.01,12450,12640
شرنگي,شيميايي رنگين,163,34436,11369350950,338700,328800,328550,-10150,-3,331350,-7350,-2.17,328550,346000
داريك,صندوق س.اعتماد داريك-د,163,5311279,67515977286,12685,12715,12709,24,0.19,12712,27,0.21,12701,12719
حرهشا,رهشاد سپاهان (سهامي عام,163,86571,7912636850,92800,90600,90050,-2750,-2.96,91400,-1400,-1.51,90050,95400
تپولا,مهندسي مرآت پولاد,161,565994,7949443950,14310,14670,13900,-410,-2.87,14070,-240,-1.68,13890,14670
سقاين,سيمان‌ قائن‌,161,117730,5389868230,46950,47970,45100,-1850,-3.94,46520,-430,-0.92,45060,47970
سجام,مجتمع سيمان غرب آسيا,161,1565042,3879338270,2528,2500,2453,-75,-2.97,2509,-19,-0.75,2453,2559
سفانو,سيمان فارس نو,158,180120,6078907650,34080,33580,33200,-880,-2.58,33940,-140,-0.41,33200,34990
تسه0005,امتيازتسهيلات مسكن مرداد 1400,157,1902,2296242504,1205551,1156000,1185000,-20551,-1.7,1207278,1727,0.14,1156000,1265828
اخزا005,اسنادخزانه-م5بودجه00-030626,156,466700,290196658000,621870,619470,622320,450,0.07,621810,-60,-0.01,619470,622720
انار,صندوق س.انارنماد ارزش-درسهام,155,509892,5672724670,11220,11250,10900,-320,-2.85,11130,-90,-0.8,10900,11440
اخزا002,اسنادخزانه-م2بودجه00-031024,152,264100,153650709000,579630,579620,581710,2080,0.36,581790,2160,0.37,579620,582200
اميد,تامين سرمايه اميد,151,657874,3796238610,5840,5700,5650,-190,-3.25,5830,-10,-0.17,5650,5970
تسه0003,امتيازتسهيلات مسكن خرداد1400,151,2067,2523199695,1172361,1230979,1191000,18639,1.59,1220706,48345,4.12,1163001,1230979
شپاس,نفت پاسارگاد,150,278549,5040804330,18420,19270,18120,-300,-1.63,18330,-90,-0.49,17900,19270
فافق,صنايع مس افق كرمان,147,8453926,42836043042,4920,5067,5067,147,2.99,5067,147,2.99,5067,5067
تسه0004,امتيازتسهيلات مسكن تير1400,147,1259,1485428065,1188542,1151100,1190006,1464,0.12,1179847,-8695,-0.73,1151100,1247969
آساس,صندوق س.آسمان آرماني سهام-س,146,46293,9680065142,210926,212000,207802,-3124,-1.48,209104,-1822,-0.86,207801,213000
زعف0110پ18,زعفران0110نگين بهرامن(پ),146,383641,156531045206,390329,398000,401000,10671,2.73,408014,17685,4.53,392002,410000
ضهرم6000,اختيارخ اهرم-10000-1401/06/30,146,8500,396080000,4677,4900,4500,-177,-3.78,4660,-17,-0.36,4500,4900
وايرا,سرمايه گذاري صنايع ايران,145,5077129,10920904479,2089,2151,2151,62,2.97,2151,62,2.97,2151,2151
اخزا006,اسنادخزانه-م6بودجه00-030723,145,270600,165648347000,611030,611160,612500,1470,0.24,612150,1120,0.18,609810,612900
دپارس,پارس‌ دارو,142,309744,9644316890,31310,30400,31300,-10,-0.03,31200,-110,-0.35,30400,31800
قهكمت,قندهكمتان‌,141,1015148,7370958430,7270,7490,7140,-130,-1.79,7270,0,0,7070,7490
معيار ,سرمايه گذاري معيار صنعت پارس,137,156622,12205733550,76750,79050,77750,1000,1.3,77950,1200,1.56,77000,79050
خفناور,مهندسي صنعتي روان فن آور,137,641185,23948259750,36300,37350,37350,1050,2.89,37350,1050,2.89,37350,37350
وكار,بانك‌ كارآفرين‌,135,9282507,30910947051,3330,3330,3330,0,0,3330,0,0,3320,3335
سغدير,توسعه سرمايه و صنعت غدير,133,1824187,24024284430,13180,13240,13180,0,0,13170,-10,-0.08,12710,13460
ساربيل,سيمان آرتا اردبيل,132,135151,4004076780,30070,30070,29120,-950,-3.16,29950,-120,-0.4,29120,31390
كباده,توليد خاك نسوزاستقلال آباده,130,1523088,30096218880,19190,19760,19760,570,2.97,19760,570,2.97,19760,19760
خاتم,صندوق س خاتم ايساتيس پويا-ثابت,129,1953006,26491981918,13551,13565,13564,13,0.1,13565,14,0.1,13564,13566
زرين,صندوق س. سهام زرين كوروش-س,128,361135,4849836497,13589,13562,13281,-308,-2.27,13429,-160,-1.18,13110,13700
يارا,صندوق س. آريا-د,126,4922947,53071049021,10749,10771,10775,26,0.24,10780,31,0.29,10770,10793
باران,بيمه زندگي باران,125,10774712,39324738220,3544,3650,3650,106,2.99,3650,106,2.99,3640,3650
فبيرا,بسته‌ بندي‌ ايران‌,125,2454307,3893875690,1618,1601,1586,-32,-1.98,1593,-25,-1.55,1586,1630
تسه9912,امتياز تسهيلات مسكن اسفند99,124,846,994590526,1168070,1160000,1180000,11930,1.02,1175639,7569,0.65,1130010,1226473
وسين,بيمه سينا,124,1683630,3997143239,2442,2369,2369,-73,-2.99,2414,-28,-1.15,2369,2444
سكه0111پ05,تمام سكه طرح جديد0111آينده,123,81800,121024916900,1452177,1483000,1484000,31823,2.19,1479522,27345,1.88,1472100,1484000
تسه9907,امتياز تسهيلات مسكن مهر99,121,612,764592881,1277591,1214001,1262100,-15491,-1.21,1249335,-28256,-2.21,1214001,1280000
تسه0001,امتيازتسهيلات مسكن فروردين1400,121,973,1143314685,1200054,1140052,1200000,-54,0,1175041,-25013,-2.08,1140052,1230000
شفنح,ح . پتروشيمي فناوران,120,404087,4137113850,10860,10860,10000,-860,-7.92,10240,-620,-5.71,10000,10860
تسه9910,امتياز تسهيلات مسكن دي99,118,778,926312328,1159343,1170000,1217310,57967,5,1190633,31290,2.7,1140000,1217310
سيستم,همكاران سيستم,118,1331955,8278721610,6230,6230,6200,-30,-0.48,6230,0,0,6160,6380
سمتاز,سيمان ممتازان كرمان,117,556348,10729832680,19840,20000,19900,60,0.3,19290,-550,-2.77,19250,20000
ضسپا3014,اختيارخ خساپا-1800-1401/03/25,116,9749,1740469000,369,200,151,-218,-59.08,179,-190,-51.49,151,200
نتوس,پشم‌ بافي‌ توس,115,339235,3388957650,10290,9990,9990,-300,-2.92,10190,-100,-0.97,9990,9990
فيروزه,صندوق شاخص30 شركت فيروزه- سهام,113,54611,10759578510,196640,197000,197420,780,0.4,197020,380,0.19,196500,198070
وتوشه,سرمايه‌ گذاري‌ پارس‌ توشه‌,112,844437,5339251800,6580,6560,6230,-350,-5.32,6480,-100,-1.52,6220,6560
ومشان,س. فني و مهندسي مشانير,109,51560,3033766400,60250,61800,58450,-1800,-2.99,59500,-750,-1.24,58450,61850
تسه9911,امتياز تسهيلات مسكن بهمن99,109,694,821280363,1184033,1153503,1186000,1967,0.17,1183401,-632,-0.05,1124832,1243234
داراب,پتروشيمي داراب,109,3157226,3071980898,945,973,973,28,2.96,953,8,0.85,973,973
وملت,سرمايه گذاري ملت,108,1504362,3423218291,2308,2345,2262,-46,-1.99,2285,-23,-1,2262,2350
تسه9909,امتياز تسهيلات مسكن آذر99,108,617,722473934,1156717,1098884,1214552,57835,5,1170946,14229,1.23,1098884,1214552
وامير,گروه صنعتي و معدني امير,107,4524,1696781750,382300,380000,378950,-3350,-0.88,381350,-950,-0.25,371800,380000
كيان2,صندوق س. با درآمد ثابت كيان,107,10700000,10700000,35006,1,1,-35005,-100,1,-35005,-100,1,1
ثاصفا,شركت‌ ساختمان‌ اصفهان‌,104,289090,3261669370,11600,11280,11260,-340,-2.93,11490,-110,-0.95,11260,11560
كاسپين,داروسازي كاسپين تامين,102,109149,2415328350,22650,22900,21750,-900,-3.97,22550,-100,-0.44,21600,22900
دشيري,شيرين دارو,100,41205,4065915750,98950,101800,98200,-750,-0.76,98850,-100,-0.1,96700,101800
ضشنا8014,اختيارخ شپنا-5850-1401/08/29,98,1614,2010725000,1263,1351,1200,-63,-4.99,1246,-17,-1.35,1150,1351
دسينا,داروسازي‌ سينا,95,476007,12059287380,25230,25710,25710,480,1.9,25310,80,0.32,24560,25710
ضستا7004,اختيارخ شستا-1100-1401/07/17,95,5323,524625000,106,106,96,-10,-9.43,99,-7,-6.6,93,106
كابگن,توليدي و صنعتي آبگينه‌,94,191279,1678238790,8740,8820,8790,50,0.57,8760,20,0.23,8660,8820
رتكو,كنترل‌خوردگي‌تكين‌كو,93,519722,4395639150,8570,8420,8470,-100,-1.17,8540,-30,-0.35,8330,8800
دحاوي,الحاوي,92,536230,3091115130,5930,5920,5760,-170,-2.87,5880,-50,-0.84,5760,5920
تداوم,صندوق تداوم اطمينان تمدن-ثابت,91,2718029,27521268144,10110,10126,10125,15,0.15,10125,15,0.15,10125,10127
الماس,صندوق س.امين تدبيرگران فردا-س,91,38920,4834011556,126102,128469,124000,-2102,-1.67,124204,-1898,-1.51,120500,129990
اخزا001,اسنادخزانه-م1بودجه00-030821,91,271000,163270214000,601830,601510,602760,930,0.15,602470,640,0.11,600560,603290
آسام,صندوق س.آرمان سپهر آشنا-م,86,3477490,50567601590,14551,14700,14530,-21,-0.14,14541,-10,-0.07,14480,14700
وثخوز,سرمايه گذاري و توسعه خوزستان,82,102676,3383466900,33800,32900,32850,-950,-2.81,33500,-300,-0.89,32800,34600
صنم,ص.س.صندوق در صندوق صنم,82,403333,4623006005,11501,11525,11450,-51,-0.44,11462,-39,-0.34,11430,11597
شپارس,بين‌ المللي‌ محصولات‌  پارس‌,82,977702,5641340540,5500,5770,5770,270,4.91,5600,100,1.82,5770,5770
مارون,پتروشيمي مارون,81,37815,7186792150,190800,190000,188100,-2700,-1.42,190750,-50,-0.03,187950,191500
ماني2,صندوق س. با درآمد ثابت ماني,80,8000000,8000000,11745,1,1,-11744,-99.99,1,-11744,-99.99,1,1
اخزا004,اسنادخزانه-م4بودجه00-030522,76,149900,95122448000,632620,632130,635090,2470,0.39,634570,1950,0.31,632130,635090
سكه0211پ02,تمام سكه طرح جديد0211ملت,75,12900,19149647000,1452339,1493940,1481003,28664,1.97,1484469,32130,2.21,1479000,1493940
سكه0112پ03,تمام سكه طرح جديد0112سامان,75,10000,14826505200,1452756,1479100,1482000,29244,2.01,1482650,29894,2.06,1479000,1489000
ضشنا8013,اختيارخ شپنا-5350-1401/08/29,74,1037,1591118000,1450,1666,1519,69,4.76,1534,84,5.79,1430,1666
رماس,صندوق س.راهبرد ممتازابن سينا-س,74,154416,1885055789,12560,12403,12100,-460,-3.66,12208,-352,-2.8,12065,12406
وبازار,صندوق س شاخصي بازارآشنا,70,428717,5764403300,13490,13590,13370,-120,-0.89,13450,-40,-0.3,13370,13980
پاداش,صندوق س. ارزش پاداش-د,65,2089748,21353090402,10202,10219,10218,16,0.16,10218,16,0.16,10218,10219
دارا,صندوق س. دارا الگوريتم-د,64,2436262,24457293264,10022,10038,10039,17,0.17,10039,17,0.17,10038,10039
پلاست,كارخانجات توليدي پلاستيران,63,764488,12101845040,16310,15830,15830,-480,-2.94,15830,-480,-2.94,15830,15830
ضسپا3017,اختيارخ خساپا-3000-1401/03/25,63,2904,2904000,2,1,1,-1,-50,1,-1,-50,1,1
شستان,پتروشيمي گلستان,63,446687,1876960441,4120,4202,4202,82,1.99,4150,30,0.73,4195,4202
داريوش,صندوق س. ثروت داريوش -س,62,148149,1680021454,11271,11500,11499,228,2.02,11340,69,0.61,11285,11500
عيار2,صندوق طلاي عيار مفيد,61,610000,610000,36484,1,1,-36483,-100,1,-36483,-100,1,1
ضخود4015,اختيارخ خودرو-2800-1401/04/08,58,3110,39520000,19,17,10,-9,-47.37,13,-6,-31.58,10,20
اخزا0052,اسنادخزانه-م5بودجه00-030626,56,2530,1570107700,621870,621010,620180,-1690,-0.27,620600,-1270,-0.2,619010,621670
سكه0110پ04,تمام سكه طرح جديد 0110 صادرات,56,11400,16872596500,1453698,1470000,1484000,30302,2.08,1480052,26354,1.81,1470000,1484999
ويستا,صندوق س. ويستا -س,55,1950311,24952214119,12826,12805,12700,-126,-0.98,12794,-32,-0.25,12654,12899
ضهرم6002,اختيارخ اهرم-12000-1401/06/30,55,3551,102089150,3118,3300,2732,-386,-12.38,2875,-243,-7.79,2732,3300
ضستا7001,اختيارخ شستا-800-1401/07/17,55,4052,1181396000,328,320,290,-38,-11.59,292,-36,-10.98,290,320
ارمغان,ص سرمايه گذاري ارمغان ايرانيان,53,1005302,10182487313,10108,10128,10130,22,0.22,10129,21,0.21,10118,10130
وامين,س. امين توان آفرين ساز,50,103700,1187089960,11400,11450,11490,90,0.79,11400,0,0,11430,11600
اخزا010,اسناد خزانه-م10بودجه00-031115,47,155700,89497091600,572966,576000,575000,2034,0.35,574805,1839,0.32,572130,576190
ساروج,بين المللي ساروج بوشهر,47,85279,1422226450,16850,16730,16580,-270,-1.6,16830,-20,-0.12,16510,16990
خريختح,ح . صنايع‌ريخته‌گري‌ايران‌,44,1506736,2936597390,2000,2000,1900,-100,-5,1949,-51,-2.55,1900,2000
نگين,ص.س. زمين و ساختمان نگين شهرري,44,114608,7161003360,63000,64240,62400,-600,-0.95,62480,-520,-0.83,62400,64240
اخزا009,اسناد خزانه-م9بودجه00-031101,41,210000,121746526000,580870,580000,580010,-860,-0.15,579750,-1120,-0.19,578040,580500
مرواريد,صندوق س. مرواريد بها بازار-س,41,279735,2797776856,10013,10000,10003,-10,-0.1,10002,-11,-0.11,10000,10111
آتيمس,صندوق س.آرمان آتيه درخشان مس-س,41,27077,5487446492,203446,204000,201100,-2346,-1.15,202661,-785,-0.39,201100,204500
اخزا0022,اسنادخزانه-م2بودجه00-031024,39,1441,836090820,579630,579400,580210,580,0.1,580220,590,0.1,579400,581000
وسرمد,بيمه  سرمد,39,1812905,5362572990,3049,2958,2958,-91,-2.98,2999,-50,-1.64,2958,2958
قنقش,قند نقش جهان,39,11253,1343003150,120900,122350,118500,-2400,-1.99,120600,-300,-0.25,118500,122350
صنوين,صندوق سرمايه‌گذاري صنوين-مختلط,38,11467,1432540850,124400,125000,125000,600,0.48,124930,530,0.43,124400,125000
شليا,شركت مواد ويژه ليا,38,48661,1503624900,30000,30900,30900,900,3,30150,150,0.5,30900,30900
ثهام,صندوق س ثروت هامرز-سهام,37,154107,1810252840,11850,12150,11900,50,0.42,11750,-100,-0.84,10670,12150
آسام2,صندوق س.آرمان سپهر آشنا-م,34,3400000,3400000,14551,1,1,-14550,-99.99,1,-14550,-99.99,1,1
فلات,گروه صنايع معادن فلات ايرانيان,33,261052,2772372240,10320,10620,10620,300,2.91,10400,80,0.78,10620,10620
افق ملت,صندوق س در سهام افق ملت,33,80555,12622018710,156660,156670,156000,-660,-0.42,156690,30,0.02,155000,156990
طخود4013,اختيارف خودرو-2400-1401/04/08,31,1432,291910000,139,200,250,111,79.86,204,65,46.76,200,250
گوهر2,صندوق سكه طلاي كيان,30,300000,300000,71873,1,1,-71872,-100,1,-71872,-100,1,1
ضهرم6001,اختيارخ اهرم-11000-1401/06/30,30,3000,113000000,3911,3800,3700,-211,-5.4,3767,-144,-3.68,3700,3800
خعمرا,توسعه و عمران شهرستان نائين,30,327689,3217905980,9540,9820,9820,280,2.94,9630,90,0.94,9820,9820
ضستا7002,اختيارخ شستا-900-1401/07/17,29,1776,395180000,232,230,212,-20,-8.62,223,-9,-3.88,212,230
طلا2,صندوق س.پشتوانه طلاي لوتوس,29,2900000,2900000,102521,1,1,-102520,-100,1,-102520,-100,1,1
پلوله,گازلوله‌,28,164618,4354146100,25700,26450,26450,750,2.92,26000,300,1.17,26450,26450
قاروم,قند اروميه,27,13308,2547151200,197300,191400,191400,-5900,-2.99,196150,-1150,-0.58,191400,191400
ضفلا3013,اختيارخ فولاد-12000-1401/03/18,26,601,198986000,432,500,399,-33,-7.64,331,-101,-23.38,200,500
اخزا0062,اسنادخزانه-م6بودجه00-030723,26,1301,792795630,611030,611010,610450,-580,-0.09,609370,-1660,-0.27,600050,611060
ضكاريس600,اختيارخ كاريس-13000-14010606,26,2600,8580000000,3800,3300,3300,-500,-13.16,3300,-500,-13.16,3300,3300
شكف,كف,26,124722,6098905800,47950,48900,48900,950,1.98,48900,950,1.98,48900,48900
ثعتما,س. ساختماني اعتماد گستر,26,116842,1754966840,15480,15020,15020,-460,-2.97,15400,-80,-0.52,15020,15020
اخزا007,اسنادخزانه-م7بودجه00-030912,25,74900,44742240000,594660,598970,596000,1340,0.23,597360,2700,0.45,595130,599000
تكنو,تكنوتار,25,257051,1912459440,7090,7440,7440,350,4.94,7130,40,0.56,7440,7440
اخزا003,اسنادخزانه-م3بودجه00-030418,25,91800,59376540000,645480,646500,647100,1620,0.25,646800,1320,0.2,646500,647510
رشد,صندوق س.رشد پايدار آبان-د,25,173946,1769231766,10188,10171,10180,-8,-0.08,10171,-17,-0.17,10170,10180
ثمين,صندوق س. ثروت افزون ثمين-س,24,151466,1805927020,12008,12001,11900,-108,-0.9,11923,-85,-0.71,11900,12002
ضسپا8052,اختيارخ خساپا-2000-1401/08/25,24,823,236930000,362,320,270,-92,-25.41,288,-74,-20.44,270,330
زعف0110پ19,زعفران0110نگين تروند قاينات(پ),23,32598,13121145300,401670,402502,402500,830,0.21,402514,844,0.21,402000,403000
ضملت3013,اختيارخ وبملت-4000-1401/03/18,23,1434,59516000,57,70,35,-22,-38.6,42,-15,-26.32,25,70
كايتا,ايتالران‌,23,20723,808197000,37900,39000,39000,1100,2.9,38000,100,0.26,39000,39000
بذر,صندوق س بذر اميد آفرين-سهام,23,27897,3166360330,114530,118030,114600,70,0.06,113500,-1030,-0.9,110520,118030
زعف0110پ20,زعفران0110نگين وحدت جام(پ),22,12469,4971365710,407403,396000,403000,-4403,-1.08,398698,-8705,-2.14,395000,403000
سايرا,ايرانيت‌,22,30464,876757550,29250,29700,28700,-550,-1.88,29150,-100,-0.34,28700,29700
ضهرم6003,اختيارخ اهرم-13000-1401/06/30,22,2185,51755000,2360,2500,2200,-160,-6.78,2369,9,0.38,2200,2500
شتولي,تولي‌پرس‌,22,143341,2578704590,17640,17990,17990,350,1.98,17990,350,1.98,17990,17990
وآفري,بيمه كارآفرين,21,97738,370239320,3782,3782,3782,0,0,3782,0,0,3782,3834
اخزا0102,اسناد خزانه-م10بودجه00-031115,21,1095,613604970,572966,544520,572000,-966,-0.17,560370,-12596,-2.2,544510,574500
اخزا0042,اسنادخزانه-م4بودجه00-030522,21,1123,711096260,632620,631630,632540,-80,-0.01,633210,590,0.09,631630,634000
ضسپا3013,اختيارخ خساپا-1600-1401/03/25,21,1734,628000000,470,390,340,-130,-27.66,362,-108,-22.98,340,400
اخزا0012,اسنادخزانه-م1بودجه00-030821,20,893,535780370,601830,588010,582640,-19190,-3.19,599980,-1850,-0.31,572010,602150
اراد50,مرابحه عام دولت5-ش.خ0302,20,338000,338000000000,1000000,1000000,1000000,0,0,1000000,0,0,1000000,1000000
كميناح,ح . شيشه سازي مينا,20,433906,4306565960,9920,10110,9920,0,0,9930,10,0.1,9920,10110
صايند,صندوق س. گنجينه آينده روشن-د,19,322330,3263880720,10106,10120,10130,24,0.24,10126,20,0.2,10120,10130
طخود4012,اختيارف خودرو-2200-1401/04/08,18,965,102600000,60,90,110,50,83.33,106,46,76.67,90,115
وپسا,س. پتروشيمي ساختمان  خليج فارس,18,255296,568033600,2293,2225,2225,-68,-2.97,2289,-4,-0.17,2225,2225
حبندر,دريايي و کشتيراني خط دريابندر,18,109489,4182479800,37100,38200,38200,1100,2.96,37550,450,1.21,38200,38200
ضخود5005,اختيارخ خودرو-2400-1401/05/12,18,497,61645000,151,131,109,-42,-27.81,124,-27,-17.88,100,150
اوصتا2,صندوق انديشه ورزان صباتامين -د,17,54800000,54800000,22737,1,1,-22736,-100,1,-22736,-100,1,1
آينده,بازرگاني آينده سازان بهشت پارس,17,17245,213838000,12780,12400,12400,-380,-2.97,12770,-10,-0.08,12400,12400
وزمين,بانك ايران زمين,16,15622,147471680,9630,9440,9440,-190,-1.97,9630,0,0,9440,9440
اخزا903,اسنادخزانه-م3بودجه99-011110,16,11300,9876148000,872610,872890,875500,2890,0.33,874000,1390,0.16,872890,876000
اوج,صندوق س.اوج دماوند-س,16,271591,3058787433,11156,11267,11250,94,0.84,11262,106,0.95,11250,11267
اخزا901,اسنادخزانه-م1بودجه99-010621,16,7500,7072011000,941430,942810,943110,1680,0.18,942930,1500,0.16,942810,943130
ثروتم,صندوق س. ثروت آفرين پارسيان-س,15,40990,3921748450,97641,98242,96000,-1641,-1.68,95676,-1965,-2.01,93366,98599
اخزا910,اسنادخزانه-م10بودجه99-020807,15,4000,3010934000,750950,752280,752900,1950,0.26,752730,1780,0.24,752280,752990
قتربت,قند تربت حيدريه,15,121846,2167640340,17280,17790,17790,510,2.95,17390,110,0.64,17790,17790
اخزا008,اسنادخزانه-م8بودجه00-030919,15,22900,13579269000,591360,591650,593310,1950,0.33,592980,1620,0.27,590690,593990
ضخود5003,اختيارخ خودرو-2000-1401/05/12,14,76,23945000,384,365,310,-74,-19.27,315,-69,-17.97,310,365
يارا2,صندوق س. آريا-د,14,12600000,12600000,10749,1,1,-10748,-99.99,1,-10748,-99.99,1,1
ضفلا3012,اختيارخ فولاد-10000-1401/03/18,14,93,194206000,2300,2060,2020,-280,-12.17,2088,-212,-9.22,1910,2279
ضخود5001,اختيارخ خودرو-1800-1401/05/12,14,649,308950000,570,500,470,-100,-17.54,476,-94,-16.49,465,500
پكويرح,ح. كوير تاير,13,85946,353720479,4016,4497,4080,64,1.59,4116,100,2.49,4080,4497
اخزا815,اسنادخزانه-م15بودجه98-010406,13,3500,3442295000,983040,982500,983750,710,0.07,983510,470,0.05,982500,984000
هاميد104,اختيارف ت ثاميد-1928-01/04/20,13,150000,33450000,250,223,223,-27,-10.8,223,-27,-10.8,223,223
ضسپا8053,اختيارخ خساپا-2200-1401/08/25,12,533,117320000,200,260,190,-10,-5,220,20,10,190,260
ضجار7050,اختيارخ وتجارت-1980-1401/07/20,12,275,99724000,504,310,341,-163,-32.34,363,-141,-27.98,310,380
ضجار7051,اختيارخ وتجارت-2180-1401/07/20,11,119,26644000,350,329,298,-52,-14.86,224,-126,-36,200,349
ضفلا7013,اختيارخ فولاد-5141-1401/07/24,11,1005,2544500000,2600,2900,2500,-100,-3.85,2532,-68,-2.62,2500,2900
ضفلا7012,اختيارخ فولاد-4588-1401/07/24,11,590,2039810000,3500,3600,3400,-100,-2.86,3457,-43,-1.23,3300,3600
اخزا817,اسنادخزانه-م17بودجه98-010512,11,18400,17730248000,962930,966000,963510,580,0.06,963600,670,0.07,963510,966000
سپيدما2,صندوق س. سپيد دماوند-د,11,90000000,90000000,12635,1,1,-12634,-99.99,1,-12634,-99.99,1,1
اخزا908,اسنادخزانه-م8بودجه99-020606,11,104100,81299492000,779540,780990,779110,-430,-0.06,780970,1430,0.18,779110,781000
ضجار7045,اختيارخ وتجارت-1480-1401/07/20,10,185,143010000,828,780,760,-68,-8.21,773,-55,-6.64,760,780
ثبات2,صندوق س. ثبات ويستا -د,10,30900000,30900000,11607,1,1,-11606,-99.99,1,-11606,-99.99,1,1
فردا2,صندوق س آواي فرداي زاگرس-ثابت,10,10000000,10000000,13123,1,1,-13122,-99.99,1,-13122,-99.99,1,1
پلاستح,ح.كارخانجات توليدي پلاستيران,10,28971,326694080,11810,11810,11110,-700,-5.93,11280,-530,-4.49,11110,11810
اخزا909,اسنادخزانه-م9بودجه99-020316,10,7100,5786638000,812770,815010,815050,2280,0.28,815020,2250,0.28,815010,815050
نهال2,صندوق س. طلاي سرخ نوويرا,10,1000000,1000000,21031,1,1,-21030,-100,1,-21030,-100,1,1
اگ010819,گام بانك صادرات 0108,10,100000,90150200000,899724,901502,901502,1778,0.2,901502,1778,0.2,901502,901502
پادا,صندوق س.پاداش سرمايه پارس-س,9,64708,7826761818,119882,121500,118100,-1782,-1.49,120955,1073,0.9,118000,122000
ثاژن,سخت آژند,9,53093,233184456,4481,4392,4392,-89,-1.99,4477,-4,-0.09,4392,4392
اراد69,مرابحه عام دولت69-ش.خ0310,9,62300,59359285000,950000,950000,970000,20000,2.11,952800,2800,0.29,949490,970000
ضستر3006,اختيارخ خگستر-3750-1401/03/22,9,120,30000000,297,250,250,-47,-15.82,250,-47,-15.82,250,250
ضخود5002,اختيارخ خودرو-1900-1401/05/12,9,245,92750000,489,450,355,-134,-27.4,379,-110,-22.49,355,450
افاد74,منفعت دولت7-ش.خاص ساير0204,8,178000,173151280000,986000,972760,972760,-13240,-1.34,972760,-13240,-1.34,972760,972760
طهرم6005,اختيارف اهرم-15000-1401/06/30,8,750,15700000,2000,2000,2200,200,10,2093,93,4.65,2000,2200
اخزا818,اسنادخزانه-م18بودجه98-010614,8,1000,950499000,946390,950010,950000,3610,0.38,950500,4110,0.43,950000,954970
ضرنا4009,اختيارخ ورنا-6000-1401/04/22,8,46,13240000,413,300,300,-113,-27.36,288,-125,-30.27,200,300
اخزا9102,اسنادخزانه-م10بودجه99-020807,8,450,334834460,750950,750530,714150,-36800,-4.9,744080,-6870,-0.91,714150,750530
گنجين,صندوق س. گنجينه يكم آويد-د,8,3546,55253968,15562,15586,15581,19,0.12,15582,20,0.13,15581,15587
اخزا918,اسنادخزانه-م18بودجه99-010323,7,2700,2675741000,990910,991000,991060,150,0.02,991020,110,0.01,991000,991060
اخزا0092,اسناد خزانه-م9بودجه00-031101,7,136,78876310,580870,580010,580000,-870,-0.15,579970,-900,-0.15,579450,580010
اخزا902,اسنادخزانه-م2بودجه99-011019,7,4400,3887067000,881980,883120,883550,1570,0.18,883420,1440,0.16,883120,883550
ضخود5000,اختيارخ خودرو-1700-1401/05/12,7,33,17909000,680,600,540,-140,-20.59,543,-137,-20.15,540,600
صنفت0312,صكوك منفعت نفت0312-6ماهه 18/5%,7,70000,70000000000,1020000,1000000,1000000,-20000,-1.96,1000000,-20000,-1.96,1000000,1000000
ضترا3015,اختيارخ شتران-5000-1401/03/08,7,300,142826000,450,400,548,98,21.78,476,26,5.78,340,549
ضستر3009,اختيارخ خگستر-5000-1401/03/22,7,393,2827000,19,10,7,-12,-63.16,7,-12,-63.16,5,11
اراد46,مرابحه عام دولت4-ش.خ 0302,6,120000,120000000000,1000000,1000000,1000000,0,0,1000000,0,0,1000000,1000000
زعف0110پ05,زعفران0110نگين زرين(پ),6,829,337017667,403347,405000,409172,5825,1.44,406535,3188,0.79,405000,409173
اخزا907,اسنادخزانه-م7بودجه99-020704,6,6600,5058874000,766040,766290,766410,370,0.05,766500,460,0.06,766120,767000
اخزا914,اسنادخزانه-م14بودجه99-021025,6,1000,724840000,725090,729900,722100,-2990,-0.41,724840,-250,-0.03,722100,729900
ضسپا8057,اختيارخ خساپا-3000-1401/08/25,6,515,35920000,86,68,70,-16,-18.6,70,-16,-18.6,65,72
ضسپا3011,اختيارخ خساپا-1200-1401/03/25,6,242,188542000,890,801,755,-135,-15.17,779,-111,-12.47,755,802
اراد99,مرابحه عام دولت99-ش.خ050723,6,127000,127000000000,1000000,1000000,1000000,0,0,1000000,0,0,1000000,1000000
ضپنا7051,اختيارخ رمپنا-14000-1401/07/12,6,67,360100000,5000,5500,5300,300,6,5375,375,7.5,5300,5500
سپرمي,پرميت‌,6,5458,147638900,26800,27050,27050,250,0.93,27050,250,0.93,27050,27050
اخزا9012,اسنادخزانه-م1بودجه99-010621,6,199,187307400,941430,941030,941620,190,0.02,941240,-190,-0.02,941020,941620
ضذوب8000,اختيارخ ذوب-1940-1401/08/04,6,48,49000000,1,1100,1000,999,99900,1021,1020,102000,1000,1100
ضپلا4008,اختيارخ پالايش-100000-01/04/29,6,152,1520000,1656,1000,1000,-656,-39.61,1000,-656,-39.61,1000,1000
طخود4011,اختيارف خودرو-2000-1401/04/08,5,500,16000000,1,30,30,29,2900,32,31,3100,30,40
ضهمن3003,اختيارخ خبهمن-1800-1401/03/11,5,127,6790000,57,31,70,13,22.81,53,-4,-7.02,31,70
ضملت3010,اختيارخ وبملت-2500-1401/03/18,5,24,32598000,1427,1365,1349,-78,-5.47,1358,-69,-4.84,1250,1365
اخزا9032,اسنادخزانه-م3بودجه99-011110,5,228,198663140,872610,872200,872010,-600,-0.07,871330,-1280,-0.15,870160,872200
اخزا816,اسنادخزانه-م16بودجه98-010503,5,4400,4263275000,966920,967500,967610,690,0.07,968930,2010,0.21,967500,977610
ضسپا8047,اختيارخ خساپا-1500-1401/08/25,5,203,132810000,725,660,640,-85,-11.72,654,-71,-9.79,640,660
اخزا820,اسنادخزانه-م20بودجه98-020806,5,800,603500000,751120,755000,754000,2880,0.38,754370,3250,0.43,753000,755000
اراد61,مرابحه عام دولت61-ش.خ0309,5,85000,85000000000,1000000,1000000,1000000,0,0,1000000,0,0,1000000,1000000
ضذوب8001,اختيارخ ذوب-2140-1401/08/04,5,45,39500000,1,900,800,799,79900,878,877,87700,800,900
سلار,شركت سيمان لارستان,5,1287,52767000,42250,41000,41000,-1250,-2.96,42250,0,0,41000,41000
اراد72,مرابحه عام دولت72-ش.خ0311,5,1400,1365995000,956070,964990,984990,28920,3.02,975710,19640,2.05,964990,984990
سيناد,صندوق س.سپهرسودمند سينا-د,5,3324,33280938,10006,10012,10013,7,0.07,10012,6,0.06,10012,10013
ضملت3011,اختيارخ وبملت-3000-1401/03/18,4,30,24113000,983,802,806,-177,-18.01,804,-179,-18.21,802,807
تاراز,صندوق س آواي تاراز زاگرس-سهام,4,27832,332997520,11990,11970,11890,-100,-0.83,11960,-30,-0.25,11890,11990
اخزا9182,اسنادخزانه-م18بودجه99-010323,4,151,149129820,990910,988510,988890,-2020,-0.2,987610,-3300,-0.33,986740,988890
اخزا0082,اسنادخزانه-م8بودجه00-030919,4,86,50846830,591360,591010,591500,140,0.02,591240,-120,-0.02,591010,591500
زعف0110پ10,زعفران0110نگين طلاي سرخ(پ),4,432,176234184,402500,407900,407999,5499,1.37,407949,5449,1.35,407900,407999
هبساز103,اختيارف ت ثبهساز-2226-01/03/18,4,27445,15177085,569,553,553,-16,-2.81,553,-16,-2.81,553,553
ضملت3012,اختيارخ وبملت-3500-1401/03/18,4,28,10883000,398,400,360,-38,-9.55,389,-9,-2.26,360,400
ضپنا7053,اختيارخ رمپنا-16000-1401/07/12,4,32,124800000,4567,3900,3900,-667,-14.6,3900,-667,-14.6,3900,3900
ضملت3009,اختيارخ وبملت-2000-1401/03/18,4,22,32308000,1850,1222,1500,-350,-18.92,1469,-381,-20.59,1222,1849
اخزا0072,اسنادخزانه-م7بودجه00-030912,4,227,134930060,594660,594500,593750,-910,-0.15,594410,-250,-0.04,593750,595030
اخزا8142,اسنادخزانه-م14بودجه98-010318,4,104,103122230,992000,991560,991550,-450,-0.05,991560,-440,-0.04,991550,991560
تملي801,تسهيلات مسكن ب. ملي-فروردين98,4,31,14358247,467281,490645,462500,-4781,-1.02,463169,-4112,-0.88,443917,490645
اطلس2,صندوق س.توسعه اطلس مفيد-س,4,40000,40000,277424,1,1,-277423,-100,1,-277423,-100,1,1
اخزا9022,اسنادخزانه-م2بودجه99-011019,4,183,161252950,881980,881060,881160,-820,-0.09,881160,-820,-0.09,881060,881530
پتروما,صندوق س.بخشي پتروشيمي دماوند-ب,4,11205,121106640,10780,10808,10811,31,0.29,10808,28,0.26,10808,10811
ضپاس7039,اختيارخ وپارس-2000-1401/07/27,4,23,5909000,400,266,238,-162,-40.5,257,-143,-35.75,238,266
كارا2,صندوق س. كارا -د,4,40000000,40000000,11401,1,1,-11400,-99.99,1,-11400,-99.99,1,1
ضخود4009,اختيارخ خودرو-1800-1401/04/08,4,138,57401000,510,450,413,-97,-19.02,416,-94,-18.43,413,450
ضسان8004,اختيارخ پارسان-28000-01/08/08,3,36,280800000,8100,7800,7800,-300,-3.7,7800,-300,-3.7,7800,7800
ضسپا8050,اختيارخ خساپا-1800-1401/08/25,3,105,39500000,489,400,350,-139,-28.43,376,-113,-23.11,350,400
ضسان8005,اختيارخ پارسان-30000-01/08/08,3,39,245700000,6393,6300,6300,-93,-1.45,6300,-93,-1.45,6300,6300
ضملت3008,اختيارخ وبملت-1800-1401/03/18,3,5,6110000,2041,1222,1222,-819,-40.13,1222,-819,-40.13,1222,1222
افاد73,منفعت دولت7-ش.خاص نوين0204,3,60000,60000000000,1000000,1000000,1000000,0,0,1000000,0,0,1000000,1000000
اخزا905,اسنادخزانه-م5بودجه99-020218,3,5400,4471732000,844410,827780,844980,570,0.07,828100,-16310,-1.93,827780,844980
كرونا2,تامين مالي جمعي صرفا اهداي سود,3,1245,12450000,10000,10000,10000,0,0,10000,0,0,10000,10000
اخزا814,اسنادخزانه-م14بودجه98-010318,3,1100,1092696000,992000,992270,993610,1610,0.16,993360,1360,0.14,992270,993610
تسه14002,امتيازتسهيلات مسكن سال1400,3,201,2010,1171745,10,10,-1171735,-100,10,-1171735,-100,10,10
ضسپا3010,اختيارخ خساپا-1000-1401/03/25,3,22,20742000,1221,980,971,-250,-20.48,943,-278,-22.77,900,980
اراد43,مرابحه عام دولت4-ش.خ 0205,3,54000,51894000000,960960,961000,961000,40,0,961000,40,0,961000,961000
فغدير2,آهن و فولاد غدير ايرانيان,3,30744612,605053964160,18572,19680,19680,1108,5.97,19680,1108,5.97,19680,19680
ضترا3010,اختيارخ شتران-2500-1401/03/08,3,10,27296000,3500,2729,2729,-771,-22.03,2730,-770,-22,2729,2731
مثقال2,صندوق س.پشتوانه طلاي زرين آگاه,3,300000,300000,11326,1,1,-11325,-99.99,1,-11325,-99.99,1,1
ضكاريس901,اختيارخ كاريس-12000-14010930,3,18,96300000,3400,7300,3400,0,0,5350,1950,57.35,3400,7300
ضسان8000,اختيارخ پارسان-20000-01/08/08,3,19,275800000,14000,14600,13000,-1000,-7.14,14516,516,3.69,13000,14600
ضسان8002,اختيارخ پارسان-24000-01/08/08,2,14,154700000,11394,11200,10500,-894,-7.85,11050,-344,-3.02,10500,11200
زعف0110پ09,زعفران0110نگين نوين(پ),2,355,142887700,402500,402502,402500,0,0,402501,1,0,402500,402502
ضشنا8017,اختيارخ شپنا-7350-1401/08/29,2,60,34400000,398,620,550,152,38.19,573,175,43.97,550,620
ضستا7000,اختيارخ شستا-700-1401/07/17,2,200,80000000,400,400,400,0,0,400,0,0,400,400
اخزا911,اسنادخزانه-م11بودجه99-020906,2,43100,31949962000,743690,741500,741020,-2670,-0.36,741300,-2390,-0.32,741020,741500
زير0103پ04,زيره سبز0103شركت مينوبذر(پ),2,17,21925280,1295000,1305200,1278888,-16112,-1.24,1289722,-5278,-0.41,1278888,1305200
ضملي7012,اختيارخ فملي-6300-1401/07/10,2,11,12100000,1,1100,1100,1099,109900,1100,1099,109900,1100,1100
ضبدر3013,اختيارخ شبندر-7000-1401/03/29,2,2,4600000,2600,2300,2300,-300,-11.54,2300,-300,-11.54,2300,2300
ضسان8003,اختيارخ پارسان-26000-01/08/08,2,34,323000000,9800,9500,9500,-300,-3.06,9500,-300,-3.06,9500,9500
اخزا9082,اسنادخزانه-م8بودجه99-020606,2,119,88202580,779540,741120,741430,-38110,-4.89,741200,-38340,-4.92,741120,741430
ضخود4010,اختيارخ خودرو-1900-1401/04/08,2,70,23480000,400,349,330,-70,-17.5,335,-65,-16.25,330,349
صرزم0411,صكوك اجاره خوارزم0411-6ماهه20%,2,15,14900000,1000000,1000000,990000,-10000,-1,993333,-6667,-0.67,990000,1000000
اراد964,مرابحه عام دولت96-ش.خ030414,2,4534151,4205499846039,945000,922689,932400,-12600,-1.33,927516,-17484,-1.85,922689,932400
اخزا8152,اسنادخزانه-م15بودجه98-010406,2,123,120714470,983040,981770,981300,-1740,-0.18,981420,-1620,-0.16,981300,981770
اخزا8182,اسنادخزانه-م18بودجه98-010614,2,142,134090600,946390,944300,944300,-2090,-0.22,944300,-2090,-0.22,944300,944300
پارس2,پتروشيمي پارس,2,114000000,317720000000,2769,2769,2795,26,0.94,2787,18,0.65,2769,2795
تفيرو,مهندسي فيروزا,2,1860,66960000,35300,36000,36000,700,1.98,36000,700,1.98,36000,36000
اخزا9052,اسنادخزانه-م5بودجه99-020218,2,19,15770000,844410,830000,830000,-14410,-1.71,830000,-14410,-1.71,830000,830000
تسه00112,امتيازتسهيلات مسكن بهمن 1400,2,144,1440,1175991,10,10,-1175981,-100,10,-1175981,-100,10,10
امين يكم4,صندوق درآمد ثابت امين يكم فردا,2,50898400,510541850400,10022,10030,10031,9,0.09,10031,9,0.09,10030,10031
كرماشا2,صنايع پتروشيمي كرمانشاه,2,1490000,98578400000,66060,66160,66160,100,0.15,66160,100,0.15,66160,66160
كهربا2,صندوق س.پشتوانه سكه طلا كهربا,2,1500000,1500000,12363,1,1,-12362,-99.99,1,-12362,-99.99,1,1
تسه00092,امتيازتسهيلات مسكن آذر 1400,2,53,530,1172558,10,10,-1172548,-100,10,-1172548,-100,10,10
ضسپا8051,اختيارخ خساپا-1900-1401/08/25,2,40,13000000,430,340,320,-110,-25.58,325,-105,-24.42,320,340
ضترا8064,اختيارخ شتران-3770-1401/08/08,2,20,41000000,1700,2050,2050,350,20.59,2050,350,20.59,2050,2050
ضستر3007,اختيارخ خگستر-4000-1401/03/22,2,28,2728000,105,100,76,-29,-27.62,97,-8,-7.62,76,100
پاداش2,صندوق س. ارزش پاداش-د,2,200000,200000,10202,1,1,-10201,-99.99,1,-10201,-99.99,1,1
ضملي7014,اختيارخ فملي-7300-1401/07/10,2,20,1260000,1,63,63,62,6200,63,62,6200,63,63
اخزا0032,اسنادخزانه-م3بودجه00-030418,2,54,34839080,645480,645100,646020,540,0.08,645170,-310,-0.05,645100,646020
تبريز304,مشاركت ش تبريز304-3ماهه18%,2,13000,13000000000,1000000,1000000,1000000,0,0,1000000,0,0,1000000,1000000
طكاريس304,اختيارف كاريس-15000-14010331,2,5,3600000,500,600,800,300,60,720,220,44,600,800
زيتون2,صندوق س زيتون نماد پايا- مختلط,2,2000000,2000000,12410,1,1,-12409,-99.99,1,-12409,-99.99,1,1
خديزل2,بهمن  ديزل,2,15000000,167100000000,11040,11140,11140,100,0.91,11140,100,0.91,11140,11140
رايان106,مشاركت رايان سايپا-3ماهه16%,2,118,118864940,1000000,1007330,1007330,7330,0.73,1007330,7330,0.73,1007330,1007330
ضذوب8002,اختيارخ ذوب-2340-1401/08/04,2,30,22250000,850,750,700,-150,-17.65,742,-108,-12.71,700,750
ضفلا7015,اختيارخ فولاد-6247-1401/07/24,2,100,149000000,2000,1490,1490,-510,-25.5,1490,-510,-25.5,1490,1490
ضترا3016,اختيارخ شتران-6000-1401/03/08,2,77,87000,60,2,1,-59,-98.33,1,-59,-98.33,1,2
ضهمن3000,اختيارخ خبهمن-1200-1401/03/11,1,1,780000,573,780,780,207,36.13,780,207,36.13,780,780
هفارس104,اختيارف ت فارس-6937-01/04/12,1,622,622,1,1,1,0,0,1,0,0,1,1
ضشنا8015,اختيارخ شپنا-6350-1401/08/29,1,1,801000,795,801,801,6,0.75,801,6,0.75,801,801
ضستا7006,اختيارخ شستا-1300-1401/07/17,1,10,300000,40,30,30,-10,-25,30,-10,-25,30,30
زعف0110پ08,زعفران0110نگين روستا(پ),1,12,4830024,402500,402502,402502,2,0,402502,2,0,402502,402502
ضذوب8004,اختيارخ ذوب-2740-1401/08/04,1,20,8000000,516,400,400,-116,-22.48,400,-116,-22.48,400,400
ضبدر3014,اختيارخ شبندر-8000-1401/03/29,1,3,4200000,730,1400,1400,670,91.78,1400,670,91.78,1400,1400
ضخود5006,اختيارخ خودرو-2600-1401/05/12,1,20,960000,101,48,48,-53,-52.48,48,-53,-52.48,48,48
ضسان8001,اختيارخ پارسان-22000-01/08/08,1,12,153840000,1,12820,12820,12819,1281900,12820,12819,1281900,12820,12820
كمند2,صندوق س. با درآمد ثابت كمند,1,123100000,123100000,10113,1,1,-10112,-99.99,1,-10112,-99.99,1,1
تسه99042,امتياز تسهيلات مسكن تير99,1,3,30,1257617,10,10,-1257607,-100,10,-1257607,-100,10,10
ضپنا7052,اختيارخ رمپنا-15000-1401/07/12,1,10,45000000,4400,4500,4500,100,2.27,4500,100,2.27,4500,4500
ضپلا4006,اختيارخ پالايش-80000-01/04/29,1,40,2000000,5000,5000,5000,0,0,5000,0,0,5000,5000
نسب0105,آتي نفتاي سبك-1401/05/17,1,100,239400000,2398000,2394000,2394000,-4000,-0.17,2394000,-4000,-0.17,2394000,2394000
وسپه2,سرمايه‌گذاري‌ سپه‌,1,2250000,20250000000,8930,9000,9000,70,0.78,9000,70,0.78,9000,9000
اتكاي2,بيمه اتكايي ايرانيان,1,4500000,62325000000,13830,13850,13850,20,0.14,13850,20,0.14,13850,13850
تصميم2,صندوق س با درآمد ثابت تصميم,1,2000000,2000000,19877,1,1,-19876,-99.99,1,-19876,-99.99,1,1
سمتا021,سلف موازي استاندارد سمتا021,1,100,93091800,929620,930918,930918,1298,0.14,930918,1298,0.14,930918,930918
سپر4,صندوق س سپر سرمايه بيدار- ثابت,1,6147936,89483208480,14545,14555,14555,10,0.07,14555,10,0.07,14555,14555
سخند4,صندوق س.سپهرخبرگان نفت-د,1,24000000,242856000000,10082,10119,10119,37,0.37,10119,37,0.37,10119,10119
ثهام2,صندوق س ثروت هامرز-سهام,1,100000,100000,11850,1,1,-11849,-99.99,1,-11849,-99.99,1,1
اخزا9072,اسنادخزانه-م7بودجه99-020704,1,50,36481000,766040,729620,729620,-36420,-4.75,729620,-36420,-4.75,729620,729620
اخزا8172,اسنادخزانه-م17بودجه98-010512,1,41,39483000,962930,963000,963000,70,0.01,963000,70,0.01,963000,963000
ياقوت2,صندوق س ياقوت آگاه-ثابت,1,33549000,33549000,14862,1,1,-14861,-99.99,1,-14861,-99.99,1,1
اعتماد2,صندوق س.اعتماد آفرين پارسيان-د,1,6000000,6000000,44505,1,1,-44504,-100,1,-44504,-100,1,1
تسه00102,امتيازتسهيلات مسكن دي1400,1,87,870,1184093,10,10,-1184083,-100,10,-1184083,-100,10,10
تسه99092,امتياز تسهيلات مسكن آذر99,1,4,40,1156717,10,10,-1156707,-100,10,-1156707,-100,10,10
تسه14012,امتيازتسهيلات مسكن سال1401,1,131,1310,1169664,10,10,-1169654,-100,10,-1169654,-100,10,10
آوا2,صندوق س.سهام آواي معيار-س,1,2100000,2100000,8620,1,1,-8619,-99.99,1,-8619,-99.99,1,1
اخزا9092,اسنادخزانه-م9بودجه99-020316,1,15,11590050,812770,772670,772670,-40100,-4.93,772670,-40100,-4.93,772670,772670
اخزا9112,اسنادخزانه-م11بودجه99-020906,1,9,6365160,743690,707240,707240,-36450,-4.9,707240,-36450,-4.9,707240,707240
تسه99112,امتياز تسهيلات مسكن بهمن99,1,4,40,1184033,10,10,-1184023,-100,10,-1184023,-100,10,10
اخزا9142,اسنادخزانه-م14بودجه99-021025,1,20,14026800,725090,701340,701340,-23750,-3.28,701340,-23750,-3.28,701340,701340
تسه00082,امتيازتسهيلات مسكن آبان1400,1,41,410,1183909,10,10,-1183899,-100,10,-1183899,-100,10,10
سخند,صندوق س.سپهرخبرگان نفت-د,1,570,5751300,10082,10090,10090,8,0.08,10090,8,0.08,10090,10090
سمتا022,سلف موازي استاندارد سمتا022,1,100,93304500,931744,933045,933045,1301,0.14,933045,1301,0.14,933045,933045
مشير1122,مشاركت شهرداري شيراز-3ماهه18%,1,115000,115000000000,995000,1000000,1000000,5000,0.5,1000000,5000,0.5,1000000,1000000
تسه00062,امتيازتسهيلات مسكن شهريور1400,1,54,540,1189966,10,10,-1189956,-100,10,-1189956,-100,10,10
اراد96,مرابحه عام دولت96-ش.خ030414,1,3000,2856000000,945000,952000,952000,7000,0.74,952000,7000,0.74,952000,952000
تسه99102,امتياز تسهيلات مسكن دي99,1,4,40,1159343,10,10,-1159333,-100,10,-1159333,-100,10,10
تاراز2,صندوق س آواي تاراز زاگرس-سهام,1,20000,20000,11990,1,1,-11989,-99.99,1,-11989,-99.99,1,1
ضترا3013,اختيارخ شتران-4000-1401/03/08,1,1,1340000,1550,1340,1340,-210,-13.55,1340,-210,-13.55,1340,1340
ضدار4004,اختيارخ ص.دارا-100000-01/04/29,1,10,2000000,27561,20000,20000,-7561,-27.43,20000,-7561,-27.43,20000,20000
نسب0104,آتي نفتاي سبك-1401/04/17,1,100,239500000,2399000,2395000,2395000,-4000,-0.17,2395000,-4000,-0.17,2395000,2395000
تسه99052,امتياز تسهيلات مسكن مرداد99,1,1,10,1309059,10,10,-1309049,-100,10,-1309049,-100,10,10
تسه99122,امتياز تسهيلات مسكن اسفند99,1,4,40,1168070,10,10,-1168060,-100,10,-1168060,-100,10,10
تهران012,مشاركت ش تهران012-3ماهه18%,1,3691,3617180000,979990,980000,980000,10,0,980000,10,0,980000,980000
طخود4014,اختيارف خودرو-2600-1401/04/08,1,10,1000000,1,100,100,99,9900,100,99,9900,100,100
اخزا9062,اسنادخزانه-م6بودجه99-020321,1,52,42172000,811380,811000,811000,-380,-0.05,811000,-380,-0.05,811000,811000
مي ه 12,ميان باري هفته 12,1,8900,6675000,660,750,750,90,13.64,750,90,13.64,750,750
اوصتا4,صندوق انديشه ورزان صباتامين -د,1,1097296,24995305584,22737,22779,22779,42,0.18,22779,42,0.18,22779,22779
افران2,صندوق س افرا نماد پايدار-ثابت,1,2200000,2200000,16414,1,1,-16413,-99.99,1,-16413,-99.99,1,1
ويستا2,صندوق س. ويستا -س,1,1900000,1900000,12826,1,1,-12825,-99.99,1,-12825,-99.99,1,1
كارين4,صندوق س نگين سامان-ثابت,1,995000000,9990795000000,10035,10041,10041,6,0.06,10041,6,0.06,10041,10041
ضملت3014,اختيارخ وبملت-4500-1401/03/18,1,20,40000,1,2,2,1,100,2,1,100,2,2
ضپلا4007,اختيارخ پالايش-90000-01/04/29,1,100,2000000,2450,2000,2000,-450,-18.37,2000,-450,-18.37,2000,2000
ضبدر3009,اختيارخ شبندر-4000-1401/03/29,1,2,9002000,5100,4501,4501,-599,-11.75,4501,-599,-11.75,4501,4501
سميعا101,سلف موازي استاندارد سميعا101,1,100,131375800,1312195,1313758,1313758,1563,0.12,1313758,1563,0.12,1313758,1313758
ضترا8067,اختيارخ شتران-5270-1401/08/08,1,30,30600000,960,1020,1020,60,6.25,1020,60,6.25,1020,1020
شستا2,سرمايه گذاري تامين اجتماعي,1,476830711,483983171665,1015,1015,1015,0,0,1015,0,0,1015,1015
تسه99082,امتياز تسهيلات مسكن آبان99,1,3,30,1166552,10,10,-1166542,-100,10,-1166542,-100,10,10
سميعا102,سلف موازي استاندارد سميعا102,1,100,142691700,1425208,1426917,1426917,1709,0.12,1426917,1709,0.12,1426917,1426917
تسه00012,امتيازتسهيلات مسكن فروردين1400,1,3,30,1200054,10,10,-1200044,-100,10,-1200044,-100,10,10
اخزا8212,اسنادخزانه-م21بودجه98-020906,1,75,56250000,754860,750000,750000,-4860,-0.64,750000,-4860,-0.64,750000,750000
اراد65,مرابحه عام دولتي65-ش.خ0210,1,500,483800000,950000,967600,967600,17600,1.85,967600,17600,1.85,967600,967600
گنجينه,صندوق س. گنجينه داريوش-د,1,49450,499593350,10105,10103,10103,-2,-0.02,10103,-2,-0.02,10103,10103
ضپيك7051,اختيارخ تاپيكو-8053-01/07/20,1,1,6000000,6530,6000,6000,-530,-8.12,6000,-530,-8.12,6000,6000
متا0104,آتي متانول -1401/04/17,1,100,94100000,942000,941000,941000,-1000,-0.11,941000,-1000,-0.11,941000,941000
افاد61,منفعت دولت6-ش.خاص140109,1,4000,3948000000,999980,987000,987000,-12980,-1.3,987000,-12980,-1.3,987000,987000
ضپيك7049,اختيارخ تاپيكو-6418-01/07/20,1,1,8000000,8767,8000,8000,-767,-8.75,8000,-767,-8.75,8000,8000
ضهمن3002,اختيارخ خبهمن-1600-1401/03/11,1,1,360000,210,360,360,150,71.43,360,150,71.43,360,360
صبا14044,اجاصبابدون ضامن بارتبه اعتباري,1,60000,60000000000,1000000,1000000,1000000,0,0,1000000,0,0,1000000,1000000
كچاد2,معدني‌وصنعتي‌چادرملو,1,13000000,214760000000,16520,16520,16520,0,0,16520,0,0,16520,16520
مشهد212,مشاركت ش مشهد212-3ماهه18%,1,100,98407800,974335,984078,984078,9743,1,984078,9743,1,984078,984078
سنفت021,سلف موازي نفت.س صادر اروند 021,1,100,212368400,2120723,2123684,2123684,2961,0.14,2123684,2961,0.14,2123684,2123684
تسه00042,امتيازتسهيلات مسكن تير1400,1,1,10,1188542,10,10,-1188532,-100,10,-1188532,-100,10,10
اراد92,مرابحه عام دولت92-ش.خ020825,1,2000,1990000000,975000,995000,995000,20000,2.05,995000,20000,2.05,995000,995000
سمتا024,سلف موازي متانول بوشهر 024,1,100,91362600,912352,913626,913626,1274,0.14,913626,1274,0.14,913626,913626
صبهمن0522,صكوك مرابحه بهمن 052-3ماهه18%,1,1400000,1330000000000,950000,950000,950000,0,0,950000,0,0,950000,950000
اخزا904,اسنادخزانه-م4بودجه99-011215,1,100,85636000,858070,856360,856360,-1710,-0.2,856360,-1710,-0.2,856360,856360
سمتا025,سلف موازي متانول بوشهر 025,1,100,103892400,1037475,1038924,1038924,1449,0.14,1038924,1449,0.14,1038924,1038924
تملي709,تسهيلات مسكن ب. ملي-آذر97,1,5,2227270,468898,445454,445454,-23444,-5,445454,-23444,-5,445454,445454
سپيدما4,صندوق س. سپيد دماوند-د,1,79000000,999587000000,12635,12653,12653,18,0.14,12653,18,0.14,12653,12653
اراد724,مرابحه عام دولت72-ش.خ0311,1,1000000,1000000000000,956070,1000000,1000000,43930,4.59,1000000,43930,4.59,1000000,1000000
شغدير2,پتروشيمي غدير,1,800000,76968000000,95660,96210,96210,550,0.57,96210,550,0.57,96210,96210
وغدير2,سرمايه‌گذاري‌غدير(هلدينگ‌,1,10000000,150000000000,14800,15000,15000,200,1.35,15000,200,1.35,15000,15000
قم304,مشاركت ش قم304-3ماهه18%,1,5,5000000,1010000,1000000,1000000,-10000,-0.99,1000000,-10000,-0.99,1000000,1000000
تسه00072,امتيازتسهيلات مسكن مهر1400,1,40,400,1182992,10,10,-1182982,-100,10,-1182982,-100,10,10
كگل2,معدني و صنعتي گل گهر,1,15000000,204000000000,13600,13600,13600,0,0,13600,0,0,13600,13600
صرزم4411,صكوك اجاره خوارزم4411-6ماهه20%,1,8,8000000,1000000,1000000,1000000,0,0,1000000,0,0,1000000,1000000
پست0108پ04,پسته فندقي32-30سبزدانه0108(پ),1,3,7585710,2515584,2528570,2528570,12986,0.52,2528570,12986,0.52,2528570,2528570
ضهمن3001,اختيارخ خبهمن-1400-1401/03/11,1,1,550000,500,550,550,50,10,550,50,10,550,550
وبوعلي2,سرمايه‌گذاري‌بوعلي‌,1,149500000,777400000000,5230,5200,5200,-30,-0.57,5200,-30,-0.57,5200,5200
سمتا023,سلف موازي استاندارد سمتا023,1,100,93660900,935303,936609,936609,1306,0.14,936609,1306,0.14,936609,936609
استارز,ص.ج.ستاره برتر20%تاديه,1,1000,127089000,141210,127089,127089,-14121,-10,127089,-14121,-10,127089,127089
ضرنا4008,اختيارخ ورنا-5500-1401/04/22,1,4,2120000,1200,530,530,-670,-55.83,530,-670,-55.83,530,530
ضپيك7052,اختيارخ تاپيكو-8871-01/07/20,1,1,5000000,5900,5000,5000,-900,-15.25,5000,-900,-15.25,5000,5000
ضفلا7014,اختيارخ فولاد-5694-1401/07/24,1,1,2200000,1999,2200,2200,201,10.06,2200,201,10.06,2200,2200
ضبدر7001,اختيارخ شبندر-5650-1401/07/27,1,10,33000000,1,3300,3300,3299,329900,3300,3299,329900,3300,3300
ضپيك7054,اختيارخ تاپيكو-10506-01/07/20,1,1,3500000,5600,3500,3500,-2100,-37.5,3500,-2100,-37.5,3500,3500
متا0105,آتي متانول -1401/05/17,1,100,93700000,937500,937000,937000,-500,-0.05,937000,-500,-0.05,937000,937000
نسب0106,آتي نفتاي سبك-1401/06/17,1,100,239300000,2397500,2393000,2393000,-4500,-0.19,2393000,-4500,-0.19,2393000,2393000
سحرا021,سلف موازي برق نيروي برق حرارتي,1,176400,59977234800,346181,340007,340007,-6174,-1.78,340007,-6174,-1.78,340007,340007
گواهي ظرفيت,گواهي ظرفيت نقدي,1,2000000,82002000000,39049,41001,41001,1952,5,39197,148,0.38,41001,41001
قم0312,مشاركت ش قم0312-سه ماهه18%,1,10,10000000,1010000,1000000,1000000,-10000,-0.99,1000000,-10000,-0.99,1000000,1000000
سمتا011,سلف موازي استاندارد سمتا011,1,10,90341250,9022965,9034125,9034125,11160,0.12,9034125,11160,0.12,9034125,9034125
اراد76,مرابحه عام دولت76-ش.خ030406,1,1000,926000000,939140,926000,926000,-13140,-1.4,926000,-13140,-1.4,926000,926000
ضترا8068,اختيارخ شتران-5770-1401/08/08,1,10,5000000,800,500,500,-300,-37.5,500,-300,-37.5,500,500
متا0106,آتي متانول -1401/06/17,1,100,94200000,943500,942000,942000,-1500,-0.16,942000,-1500,-0.16,942000,942000
