نماد,نام,تعداد,حجم,ارزش,دیروز,اولین,آخرین معامله - مقدار,آخرین معامله - تغییر,آخرین معامله - درصد,قیمت پایانی - مقدار,قیمت پایانی - تغییر,قیمت پایانی - درصد,کمترین,بیشترین
فروژ,صنايع فروآلياژ ايران,27018,16893352,836220924000,47150,49500,49500,2350,4.98,49500,2350,4.98,49500,49500
پالايش,صندوق پالايشي يكم-سهام,21026,32000183,3813686992170,117510,118600,119800,2290,1.95,119180,1670,1.42,117110,121100
شتران,پالايش نفت تهران,20947,621148641,2714302243348,4208,4320,4370,162,3.85,4370,162,3.85,4255,4418
دي,بانك دي,19789,895918548,771043654179,879,862,872,-7,-0.8,861,-18,-2.05,838,900
خودرو,ايران‌ خودرو,19269,729791824,2358282613505,3284,3300,3300,16,0.49,3231,-53,-1.61,3140,3348
خگستر,گسترش‌سرمايه‌گذاري‌ايران‌خودرو,19060,477606167,2089287956719,4499,4490,4470,-29,-0.64,4374,-125,-2.78,4219,4578
خساپا,سايپا,16333,656386497,1584908754285,2417,2412,2489,72,2.98,2415,-2,-0.08,2324,2505
شستا,سرمايه گذاري تامين اجتماعي,15797,810673996,845878376476,1052,1041,1056,4,0.38,1043,-9,-0.86,1018,1068
كرمان,س. توسعه و عمران استان كرمان,15657,761186639,864631204783,1151,1141,1180,29,2.52,1136,-15,-1.3,1075,1196
طلا,صندوق س.پشتوانه طلاي لوتوس,13364,12602313,2126283167170,158380,168101,169151,10771,6.8,168722,10342,6.53,165000,172400
شبندر,پالايش نفت بندرعباس,11208,128554369,1207665014180,9380,9430,9430,50,0.53,9390,10,0.11,9250,9650
شپنا,پالايش نفت اصفهان,11088,165446090,1282533040560,7680,7730,7790,110,1.43,7750,70,0.91,7600,7980
دارا يكم,صندوق واسطه گري مالي يكم-سهام,11070,15840974,1904169919150,120530,120300,120790,260,0.22,120210,-320,-0.27,118020,121490
خاور,ايران خودرو ديزل,10488,373483284,1386878292202,3802,3752,3770,-32,-0.84,3713,-89,-2.34,3688,3850
حكشتي,كشتيراني جمهوري اسلامي ايران,9983,69573354,1921672006160,29010,28300,27750,-1260,-4.34,27620,-1390,-4.79,27560,28500
تليسه,دامداري تليسه نمونه,9937,196470194,779885533626,4184,4006,4094,-90,-2.15,3969,-215,-5.14,3892,4148
غزر,صنعتي زر ماكارون,9727,180827153,783178672388,4151,4185,4350,199,4.79,4331,180,4.34,4150,4358
وتجارت,بانك تجارت,9712,386506187,701917659787,1865,1870,1833,-32,-1.72,1816,-49,-2.63,1760,1888
تسه1401,امتيازتسهيلات مسكن سال1401,8651,328633,396746935808,1182441,1202000,1215002,32561,2.75,1207264,24823,2.1,1195000,1240000
وبملت,بانك ملت,8335,321801884,1156670696406,3615,3590,3612,-3,-0.08,3594,-21,-0.58,3514,3683
نهال,صندوق س. طلاي سرخ نوويرا,7866,71675134,1067179880609,14366,14620,15281,915,6.37,14889,523,3.64,14366,15679
وساخت,سرمايه‌ گذاري‌ ساختمان‌ايران‌,7865,435162960,699917398677,1626,1670,1680,54,3.32,1608,-18,-1.11,1513,1730
فولاد,فولاد مباركه اصفهان,7806,131724234,814437533830,6140,6130,6240,100,1.63,6180,40,0.65,6110,6290
اهرم,صندوق س سهامي كاريزما- اهرمي,7663,123994592,1802964766880,14310,14600,14650,340,2.38,14540,230,1.61,14160,14830
كالا,بورس كالاي ايران,7460,37553427,754448246390,20260,20220,20290,30,0.15,20090,-170,-0.84,19400,20720
وسپهر,سرمايه گذاري مالي سپهرصادرات,7401,31858128,294353596250,9260,9680,9310,50,0.54,9240,-20,-0.22,8780,9710
افران,صندوق س افرا نماد پايدار-ثابت,6609,170256476,3225072134140,18931,18942,18943,12,0.06,18942,11,0.06,18942,18943
هماي,صندوق س هماي آگاه-ثابت,6517,149051396,1492443935681,10007,10013,10014,7,0.07,10013,6,0.06,10012,10014
عيار,صندوق طلاي عيار مفيد,6082,8294872,581229402121,64085,70000,70493,6408,10,70071,5986,9.34,69450,70493
خنصير,مهندسي‌نصيرماشين‌,6065,39630730,689748336740,16550,17400,17490,940,5.68,17400,850,5.14,16800,17700
نوري,پتروشيمي نوري,6033,6346961,653772732490,105820,100540,104500,-1320,-1.25,103010,-2810,-2.66,100540,105750
فملي,ملي‌ صنايع‌ مس‌ ايران‌,5980,87288044,671883367440,7640,7600,7760,120,1.57,7700,60,0.79,7590,7800
فرابورس,فرابورس ايران,5865,42965321,480949884550,11240,11120,11400,160,1.42,11190,-50,-0.44,10670,11500
وپاسار,بانك  پاسارگاد,5833,80195191,439651915440,5670,5640,5550,-120,-2.12,5480,-190,-3.35,5310,5770
ميدكو,توسعه معادن وص.معدني خاورميانه,5727,31323648,376712406420,12570,12320,12020,-550,-4.38,12030,-540,-4.3,11950,12550
انرژي,بورس انرژي ايران,5690,9645611,407330758600,43460,42000,42300,-1160,-2.67,42230,-1230,-2.83,40600,44200
فزر,پويا زركان آق دره,5619,22604121,811390000650,33950,36000,36300,2350,6.92,35900,1950,5.74,34850,36300
خبهمن,گروه‌بهمن‌,5424,229284793,525011742183,2352,2360,2325,-27,-1.15,2290,-62,-2.64,2229,2420
كوير,توليدي فولاد سپيد فراب كوير,5414,110323497,379756694101,3483,3400,3470,-13,-0.37,3442,-41,-1.18,3310,3597
كمند,صندوق س. با درآمد ثابت كمند,5263,194910685,1969846293299,10099,10107,10106,7,0.07,10106,7,0.07,10106,10107
قچار,فراوردههاي غذايي وقند چهارمحال,5226,28109529,322459275430,11970,11760,11480,-490,-4.09,11470,-500,-4.18,11140,12090
وساپا,سرمايه‌گذاري‌ سايپا,5010,100109487,598865376880,6100,6100,6160,60,0.98,5980,-120,-1.97,5720,6240
وكبهمن,مديريت سرمايه گذاري كوثربهمن,4990,61590698,210244240173,3341,3230,3520,179,5.36,3414,73,2.18,3185,3550
شيراز,پتروشيمي‌شيراز,4890,7552723,632923852180,80730,84990,85680,4950,6.13,83800,3070,3.8,81950,85700
وبصادر,بانك صادرات ايران,4869,281841691,541480099554,1939,1935,1961,22,1.13,1921,-18,-0.93,1870,1976
غنوش,نوش‌ مازندران‌,4810,29491320,285104172770,9950,9930,9800,-150,-1.51,9670,-280,-2.81,9460,10110
فسرب,ملي‌ سرب‌وروي‌ ايران‌,4656,220468645,466064612953,1987,2037,2126,139,7,2114,127,6.39,1967,2126
گوهر,صندوق سكه طلاي كيان,4421,9881413,1111649436540,107442,112000,114001,6559,6.1,112499,5057,4.71,108512,116223
فتوسا,توليد و توسعه سرب روي ايرانيان,4420,43238740,343268520920,7470,7990,7990,520,6.96,7940,470,6.29,7600,7990
فلوله,لوله‌وماشين‌سازي‌ايران‌,4221,129991369,296005466690,2261,2348,2290,29,1.28,2277,16,0.71,2151,2359
ورنا,سرمايه‌گذاري‌ رنا(هلدينگ‌,4220,64261971,445115252590,6880,6750,7190,310,4.51,6930,50,0.73,6550,7230
ولساپا,ليزينگ رايان‌ سايپا,4131,163959219,286616305814,1702,1722,1756,54,3.17,1748,46,2.7,1685,1812
هاي وب,داده گسترعصرنوين-هاي وب,4102,111937457,300405523245,2687,2690,2724,37,1.38,2684,-3,-0.11,2602,2741
ثاميد,توسعه و عمران اميد,4067,45126727,83161667816,1867,1837,1900,33,1.77,1843,-24,-1.29,1786,1900
اعتماد,صندوق س.اعتماد آفرين پارسيان-د,4056,85963760,4396820442038,51109,51147,51148,39,0.08,51147,38,0.07,51147,51149
ثفارس,عمران‌وتوسعه‌فارس‌,4045,60307828,534117823170,8480,8490,8900,420,4.95,8860,380,4.48,8400,8900
ارزش مسكن,ص.س.املاك ومستغلات ارزش مسكن,4035,2173586,25026936162,11445,11530,11538,93,0.81,11514,69,0.6,11425,11646
شپديس,پتروشيمي پرديس,4022,3386986,537134753160,158160,158350,159500,1340,0.85,158590,430,0.27,157130,161040
ديران,ايران‌دارو,3952,18856505,281260864710,15540,15330,15050,-490,-3.15,14920,-620,-3.99,14770,15700
ماديرا,صنايع ماديران,3824,113984871,464976017845,3907,3965,4099,192,4.91,4079,172,4.4,3930,4102
وخارزم,سرمايه گذاري خوارزمي,3819,72102028,324467335303,4562,4505,4537,-25,-0.55,4500,-62,-1.36,4361,4660
اسياتك,انتقال داده هاي آسياتك,3793,9844938,166409762720,17180,17230,16940,-240,-1.4,16900,-280,-1.63,16630,17450
كگل,معدني و صنعتي گل گهر,3790,34628545,301989918660,8780,8700,8800,20,0.23,8720,-60,-0.68,8540,8950
دانا,بيمه دانا,3737,100576925,309469691690,3158,3150,3050,-108,-3.42,3077,-81,-2.56,3016,3197
كارا,صندوق س. كارا -د,3730,391528904,5158559703748,13166,13175,13175,9,0.07,13175,9,0.07,13175,13179
ولبهمن,شركت بهمن ليزينگ,3650,65176427,191692651267,3016,3010,2977,-39,-1.29,2941,-75,-2.49,2850,3080
ثبهساز,بهساز كاشانه تهران,3547,52034759,100851275938,2050,2026,1974,-76,-3.71,1938,-112,-5.46,1907,2072
بوعلي,پتروشيمي بوعلي سينا,3542,6506472,224620461970,34000,34490,35360,1360,4,34520,520,1.53,33700,35630
شلرد,كود شيميايي اوره لردگان,3508,31013074,274751851140,9040,8860,8960,-80,-0.88,8860,-180,-1.99,8770,9190
زبينا,كشاورزي و دامپروري بينالود,3495,97791279,387072314615,3723,3790,3983,260,6.98,3958,235,6.31,3751,3983
توان,صندوق س. اهرمي توان مفيد-س,3436,35822094,440693847472,12173,12279,12500,327,2.69,12302,129,1.06,12081,12527
فخوز,فولاد  خوزستان,3374,83208774,256566055338,3134,3022,3122,-12,-0.38,3083,-51,-1.63,3022,3160
كيان,صندوق س. با درآمد ثابت كيان,3316,40663731,1624857317688,39933,39958,39956,23,0.06,39958,25,0.06,39956,39960
خمحركه,نيرو محركه‌,3282,45316501,283434098180,6200,6280,6360,160,2.58,6250,50,0.81,6010,6450
سنير,سيمان‌ سفيد ني‌ريز,3262,7052624,269616194980,37080,38930,38910,1830,4.94,38230,1150,3.1,35980,38930
سپيد,سپيد ماكيان,3253,9481510,192099081800,20410,20510,20500,90,0.44,20260,-150,-0.73,19700,20850
بگيلان,توسعه مسير برق گيلان,3243,8258515,123137102390,14480,14400,15200,720,4.97,14910,430,2.97,14100,15200
گدنا,تهيه توزيع غذاي دنا آفرين فدك,3221,31967382,384567605460,11250,12030,12030,780,6.93,12030,780,6.93,12030,12030
آگاس,صندوق س.هستي بخش آگاه-س,3215,4939577,494299834128,99144,99298,101632,2488,2.51,100069,925,0.93,98620,101650
وپارس,بانك‌پارسيان‌,3178,120880095,235821286445,2022,1965,1980,-42,-2.08,1951,-71,-3.51,1921,2046
ضسپا1211,اختيارخ خساپا-3250-1401/12/10,3155,1010289,78703166000,99,96,85,-14,-14.14,78,-21,-21.21,59,99
دكوثر,داروسازي‌ كوثر,3120,56820304,395695748920,6670,6890,6890,220,3.3,6960,290,4.35,6710,7130
پترول,گ.س.وت.ص.پتروشيمي خليج فارس,3118,79945150,193578618995,2461,2403,2412,-49,-1.99,2421,-40,-1.63,2367,2492
خكاوه,سايپا ديزل,3110,28083538,566439823330,20310,19810,20160,-150,-0.74,20170,-140,-0.69,19710,20910
سآبيك,سيمان آبيك,3099,4272425,61671980410,14110,14160,14690,580,4.11,14430,320,2.27,14080,14750
ختوقا,قطعات‌ اتومبيل‌ ايران‌,3084,49584501,235431272360,4870,4880,4790,-80,-1.64,4750,-120,-2.46,4580,4960
خپويش,سازه‌ پويش‌,3073,23048639,489737338230,20280,21290,21290,1010,4.98,21250,970,4.78,20520,21290
بركت,گروه دارويي بركت,3064,13501117,175857117850,13360,12900,13110,-250,-1.87,13030,-330,-2.47,12700,13400
آبادا,توليد نيروي برق آبادان,3060,5410157,65342740510,11910,11800,12230,320,2.69,12080,170,1.43,11640,12320
غگل,گلوكوزان‌,3050,28502211,182397487350,6260,6250,6460,200,3.19,6400,140,2.24,6170,6570
فاسمين,كالسيمين‌,3013,14177370,366205834480,24930,25150,26670,1740,6.98,25830,900,3.61,24580,26670
سمگا,گروه سرمايه گذاري ميراث فرهنگي,3005,39963572,277102329290,6950,6840,6940,-10,-0.14,6930,-20,-0.29,6680,7260
ياقوت,صندوق س ياقوت آگاه-ثابت,2990,34764058,585815061692,16829,16838,16838,9,0.05,16851,22,0.13,16837,16853
كدما,معدني‌ دماوند,2941,3194312,191223650870,62100,61750,59750,-2350,-3.78,59860,-2240,-3.61,59000,62990
سصفها,سيمان‌اصفهان‌,2922,3362787,242465573260,69610,69580,73090,3480,5,72100,2490,3.58,68100,73090
سحرخيز,صندوق س. گروه زعفران سحرخيز,2918,10954923,233134886244,19892,20165,21600,1708,8.59,21281,1389,6.98,20165,21880
اردستان,سيمان اردستان,2879,1622485,17214565850,10110,10610,10610,500,4.95,10610,500,4.95,10610,10610
خصدرا,صنعتي‌ دريايي‌ ايران‌,2860,106926273,240232487169,2312,2251,2243,-69,-2.98,2247,-65,-2.81,2243,2290
مديريت,س. و خدمات مديريت صند. ب كشوري,2852,22070362,89634506997,4135,4165,4072,-63,-1.52,4061,-74,-1.79,3980,4168
غدشت,دشت‌ مرغاب‌,2844,5163593,202546067450,38330,39470,38590,260,0.68,39230,900,2.35,38500,39840
شگويا,پتروشيمي تندگويان,2819,20904835,251890489310,12060,11840,12090,30,0.25,12050,-10,-0.08,11840,12220
زشگزا,شير و گوشت زاگرس شهركرد,2811,42324930,295496419500,6690,6750,7150,460,6.88,6980,290,4.33,6600,7150
وتوس,توسعه‌شهري‌توس‌گستر,2796,36451038,395992314040,10490,10980,11220,730,6.96,10860,370,3.53,10100,11220
خمهر,مهركام‌پارس‌,2789,89175195,234494930436,2733,2650,2671,-62,-2.27,2630,-103,-3.77,2597,2790
وآذر,سرمايه‌گذاري‌توسعه‌آذربايجان‌,2766,4284451,547994002150,133750,129100,127070,-6680,-4.99,127900,-5850,-4.37,127070,131500
شبريز,پالايش نفت تبريز,2750,12182950,204227798170,16710,16270,16810,100,0.6,16760,50,0.3,16270,17100
مثقال,صندوق س.پشتوانه طلاي زرين آگاه,2691,10957333,226444051670,19132,20300,21045,1913,10,20666,1534,8.02,19800,21045
لپارس,پارس‌ الكتريك‌,2690,1915750,154178560890,80960,79000,80980,20,0.02,80480,-480,-0.59,77500,82980
ومعادن,توسعه‌معادن‌وفلزات‌,2663,32359929,167164695490,5210,5100,5230,20,0.38,5170,-40,-0.77,5100,5250
شپلي,پلي اكريل ايران,2625,31084680,341793940790,11180,10880,11030,-150,-1.34,11000,-180,-1.61,10850,11510
شاروم,پتروشيمي اروميه,2593,2922897,59113095400,20000,20000,20650,650,3.25,20200,200,1,19500,20700
امين يكم,صندوق درآمد ثابت امين يكم فردا,2548,59787411,585790428578,9855,9840,9813,-42,-0.43,9798,-57,-0.58,9735,9845
خكار,ايركا پارت صنعت,2545,50519062,159003748096,3082,3090,3260,178,5.78,3147,65,2.11,3011,3278
سپيدار,سپيدار سيستم آسيا,2517,4336450,110209845900,25950,25250,25900,-50,-0.19,25400,-550,-2.12,24800,26400
سامان,بانك سامان,2507,71626061,200751783872,2802,2870,2780,-22,-0.79,2803,1,0.04,2745,2874
بورس,بورس اوراق بهادار تهران,2423,24725465,168324926900,6830,6690,6890,60,0.88,6810,-20,-0.29,6520,7100
كمرجان,بازرگاني و توليدي مرجان كار,2423,14324085,129173659150,9130,8810,9120,-10,-0.11,9020,-110,-1.2,8550,9370
غگيلا,شيرپاستوريزه پگاه گيلان,2394,4372410,112361560800,25350,26500,25450,100,0.39,25700,350,1.38,24500,26950
افرا,افرانت,2392,13991328,344113458550,23050,24650,24650,1600,6.94,24600,1550,6.72,23600,24650
ثشاهد,سرمايه‌ گذاري‌ شاهد,2388,19397110,185586842160,9920,9820,9620,-300,-3.02,9570,-350,-3.53,9230,10210
همراه,شركت ارتباطات سيار ايران,2380,31629491,257898746740,8450,8250,8250,-200,-2.37,8150,-300,-3.55,8030,8420
آريا,پليمر آريا ساسول,2373,1480497,114325048250,77500,76300,77750,250,0.32,77200,-300,-0.39,76300,78000
فروي,ذوب روي اصفهان,2367,8261057,128691389810,15910,15590,15800,-110,-0.69,15580,-330,-2.07,15050,16170
ددانا,داروسازي دانا,2297,2637567,95935111900,36400,37450,36350,-50,-0.14,36350,-50,-0.14,35550,37450
قثابت,قند ثابت‌ خراسان‌,2286,63131813,172478205749,2846,2819,2730,-116,-4.08,2732,-114,-4.01,2704,2868
حفارس,حمل و نقل بين المللي خليج فارس,2232,22624753,346140090820,15380,15200,15400,20,0.13,15300,-80,-0.52,15150,15670
غسالم,سالمين‌,2210,27549380,126893337368,4746,4749,4671,-75,-1.58,4606,-140,-2.95,4457,4823
ولپارس,ليزينگ پارسيان,2208,8288874,34955558553,4287,4200,4359,72,1.68,4217,-70,-1.63,4005,4399
زقيام,كشت و دام قيام اصفهان,2186,42758902,115899588834,2646,2658,2760,114,4.31,2711,65,2.46,2600,2800
چكاپا,گروه صنايع كاغذ پارس,2152,39917392,119215722135,3069,3069,2998,-71,-2.31,2987,-82,-2.67,2920,3100
فگستر,گسترش صنايع روي ايرانيان,2133,12718264,99665649440,7580,7600,7800,220,2.9,7840,260,3.43,7530,8060
سيتا,سرمايه گذاري سيمان تامين,2133,3544933,39635466890,11150,10970,11260,110,0.99,11170,20,0.18,10860,11300
غاذر,كشت‌وصنعت‌پياذر,2115,5658928,266379521930,45780,45870,48060,2280,4.98,47070,1290,2.82,45870,48060
شپارس,بين‌ المللي‌ محصولات‌  پارس‌,2113,20148325,134767875220,6830,6950,6780,-50,-0.73,6690,-140,-2.05,6490,7040
كهربا,صندوق س.پشتوانه سكه طلا كهربا,2102,10021474,210485359960,19750,21500,21100,1350,6.84,21003,1253,6.34,20500,21500
اخابر,مخابرات ايران,2098,28784169,222925501630,7880,7780,7870,-10,-0.13,7740,-140,-1.78,7480,7990
بپيوند,برق و انرژي پيوندگستر پارس,2096,2348208,26682131260,11510,11340,11470,-40,-0.35,11360,-150,-1.3,10970,11700
وملل,اعتباري ملل,2095,38427906,145325559549,3639,3790,3778,139,3.82,3782,143,3.93,3700,3820
چخزر,صنايع چوب خزر كاسپين,2093,1155103,40485915950,35350,34900,35050,-300,-0.85,35050,-300,-0.85,34600,36000
زملارد,كشاورزي و دامپروري ملارد شير,2090,1934524,25507395870,13670,13200,13220,-450,-3.29,13190,-480,-3.51,12990,13700
خاذين,سايپاآذين‌,2071,50143492,129694498625,2662,2570,2645,-17,-0.64,2586,-76,-2.85,2529,2680
كماسه,تامين‌ ماسه‌ ريخته‌گري‌,2063,39543720,195646598653,4726,4790,5056,330,6.98,4948,222,4.7,4752,5056
صبا,گروه مالي صبا تامين,2049,29371429,111784501389,3874,3860,3825,-49,-1.26,3807,-67,-1.73,3759,3899
سكه مركزي,سلف تمام سكه 001 مركزي,2031,516200,1173427610400,2170811,2260000,2279351,108540,5,2273203,102392,4.72,2242000,2279351
ختور,رادياتور ايران‌,2020,20797302,126203563320,6240,6080,6160,-80,-1.28,6070,-170,-2.72,5860,6300
اپال,فرآوري معدني اپال كاني پارس,2008,3721787,63847309950,17470,17230,17180,-290,-1.66,17300,-170,-0.97,16930,17470
رافزا,رايان هم افزا,2001,1242641,79154994350,65300,64000,64700,-600,-0.92,63700,-1600,-2.45,61400,65650
كتوكا,توليدي و خدمات صنايع نسوز توكا,1986,23427355,242015893230,10730,10160,10710,-20,-0.19,10330,-400,-3.73,9980,10780
فجهان,مجتمع جهان فولاد سيرجان,1960,10328921,32843371126,3231,3200,3190,-41,-1.27,3211,-20,-0.62,3132,3234
توسن,توسعه سامانه ي نرم افزاري نگين,1945,6013304,91891145010,15710,15260,15500,-210,-1.34,15280,-430,-2.74,14900,16110
پتاير,ايران‌ تاير,1943,62379076,93656388806,1547,1501,1520,-27,-1.75,1501,-46,-2.97,1452,1569
ثنور,سرمايه گذاري كوه نور,1931,16353049,118617132810,7450,7490,7260,-190,-2.55,7250,-200,-2.68,7230,7490
ثالوند,سرمايه گذاري مسكن الوند,1929,13631447,163867157660,11760,12300,12200,440,3.74,12020,260,2.21,11410,12440
سشرق,سيمان‌ شرق‌,1923,13293134,133984378110,10110,10120,10110,0,0,10080,-30,-0.3,9800,10370
غويتا,ويتانا,1921,21351933,116698600770,5620,5680,5510,-110,-1.96,5470,-150,-2.67,5270,5730
پيزد,مجتمع صنايع لاستيك يزد,1919,5954265,89871127860,14460,15180,15180,720,4.98,15090,630,4.36,14750,15180
دتوليد,داروسازي توليد دارو,1904,9817927,104897844310,10390,10470,10850,460,4.43,10680,290,2.79,10120,11040
شبهرن,نفت‌ بهران‌,1893,7702879,153544542790,19960,20200,20060,100,0.5,19930,-30,-0.15,19650,20200
قجام,فرآوردههاي غذايي وقندتربت‌جام‌,1871,34293678,278735986320,8370,8150,8120,-250,-2.99,8130,-240,-2.87,8120,8300
غكورش,صنعت غذايي كورش,1871,9186654,90591455490,10040,9880,9860,-180,-1.79,9860,-180,-1.79,9740,10060
قشير,قند شيروان قوچان و بجنورد,1850,16674053,148563867220,8770,8990,9040,270,3.08,8910,140,1.6,8470,9370
وهامون,سرمايه گذاري هامون صبا,1835,20391341,44497169550,2239,2200,2195,-44,-1.97,2182,-57,-2.55,2130,2274
شسينا,صنايع‌شيميايي‌سينا,1815,35400235,85244263614,2460,2400,2388,-72,-2.93,2408,-52,-2.11,2310,2575
خكرمان,سرمايه گذاري آرمان گستر پاريز,1812,39524556,192330888690,4970,5020,4821,-149,-3,4866,-104,-2.09,4821,5050
چكارن,كارتن‌ ايران‌,1811,56609067,217269788502,4000,4000,3813,-187,-4.68,3838,-162,-4.05,3800,4070
كيمياتك,آريان كيميا تك,1801,10063291,128292402680,13210,13310,12810,-400,-3.03,12750,-460,-3.48,12550,13390
شفن,پتروشيمي فناوران,1791,24257303,144809432230,5980,6000,5970,-10,-0.17,5970,-10,-0.17,5830,6100
غديس,پاكديس,1781,15536223,298443040170,18470,19000,19760,1290,6.98,19210,740,4.01,18500,19760
تاپكيش,تجارت الكترونيك پارسيان كيش,1770,8079272,82649743100,9930,10480,10050,120,1.21,10230,300,3.02,9990,10600
ضخود1205,اختيارخ خودرو-2000-1401/12/03,1765,198230,229394620000,1268,1220,1190,-78,-6.15,1157,-111,-8.75,1052,1280
دفارا,داروسازي‌ فارابي‌,1764,15203023,331309618460,21400,22000,21700,300,1.4,21790,390,1.82,21050,22290
كلر,كلر پارس,1755,1135354,98677484850,88300,88300,87350,-950,-1.08,86900,-1400,-1.59,84650,89300
غپينو,پارس‌ مينو,1749,31672784,109014507809,3557,3511,3482,-75,-2.11,3442,-115,-3.23,3311,3610
زر,صندوق س.پشتوانه سكه طلاي زر,1746,1055664,113270929552,99294,109223,107474,8180,8.24,107298,8004,8.06,104000,109223
ثاخت,بين‌المللي‌توسعه‌ساختمان,1732,46273075,130938921432,2847,2930,2868,21,0.74,2830,-17,-0.6,2734,2940
گكوثر,هتل پارسيان كوثر اصفهان,1730,44780484,108718874679,2495,2426,2410,-85,-3.41,2428,-67,-2.69,2371,2533
ولصنم,ليزينگ‌صنعت‌ومعدن‌,1725,41231494,213817158006,5056,5160,5365,309,6.11,5186,130,2.57,5000,5400
ثنوسا,نوسازي‌وساختمان‌تهران‌,1722,33767508,165378156392,5080,5180,4902,-178,-3.5,4898,-182,-3.58,4826,5180
وغدير,سرمايه‌گذاري‌غدير(هلدينگ‌,1703,12298839,229102462410,18470,18290,18680,210,1.14,18630,160,0.87,18290,18870
ثرود,سرمايه‌گذاري مسكن زاينده رود,1692,9953763,107539690180,11130,11390,10580,-550,-4.94,10800,-330,-2.96,10390,11550
وبانك,سرمايه گذاري گروه توسعه ملي,1684,15952782,171947430580,10710,10710,10780,70,0.65,10780,70,0.65,10580,10980
بكام,كارخانجات توليدي شهيد قندي,1674,32262193,85960949120,2674,2745,2649,-25,-0.93,2664,-10,-0.37,2554,2800
استقلال,استقلال,1661,9592281,20361128770,2116,2117,2112,-4,-0.19,2123,7,0.33,2085,2158
وپويا,سرمايه گذاري پويا,1659,16367275,43297478122,2727,2665,2653,-74,-2.71,2645,-82,-3.01,2570,2750
فسوژ,سوژميران,1651,3992818,79393362770,20020,20000,20440,420,2.1,19880,-140,-0.7,18620,20700
حتوكا,حمل‌ونقل‌توكا,1646,28503594,228217796220,7630,7930,8010,380,4.98,8010,380,4.98,7910,8010
غگزح,ح . گز سكه,1645,82017473,138281459478,1606,1686,1686,80,4.98,1686,80,4.98,1686,1686
درازك,دارويي‌ رازك‌,1623,8001173,128669926050,16370,16200,16450,80,0.49,16080,-290,-1.77,15600,16870
خودكفا,اقتصادي و خودكفايي آزادگان,1622,17042100,131615122850,7820,7840,7740,-80,-1.02,7720,-100,-1.28,7590,7860
وگستر,گسترش سرمايه گذاري ايرانيان,1614,21304100,113968572670,5090,5350,5360,270,5.3,5350,260,5.11,5210,5440
آريان,سرمايه گذاري پارس آريان,1604,22191056,97831874826,4501,4520,4441,-60,-1.33,4414,-87,-1.93,4366,4549
كسرا,سراميك‌هاي‌صنعتي‌اردكان‌,1596,21683550,128970130620,6090,5810,6100,10,0.16,5950,-140,-2.3,5740,6200
فوكا,فولاد كاويان,1596,14137280,186029697750,13550,13150,13170,-380,-2.8,13160,-390,-2.88,13150,13410
واحيا,م .صنايع و معادن احياء سپاهان,1587,16983689,275462279770,16010,16490,16010,0,0,16220,210,1.31,15760,16490
وگردش,بانك گردشگري,1584,15832747,127781597780,8170,8150,8060,-110,-1.35,8070,-100,-1.22,7930,8300
وطوبي,سرمايه گذاري اقتصاد شهر طوبي,1581,38903748,84667805606,2239,2250,2204,-35,-1.56,2176,-63,-2.81,2102,2282
خموتور,موتورسازان‌تراكتورسازي‌ايران‌,1580,22160118,161633914920,7040,7190,7250,210,2.98,7290,250,3.55,7130,7390
ولشرق,ليزينگ ايران و شرق,1577,26026235,89607466039,3645,3700,3445,-200,-5.49,3443,-202,-5.54,3390,3700
دلقما,دارويي‌ لقمان‌,1575,44034543,137190015172,3268,3180,3130,-138,-4.22,3116,-152,-4.65,3105,3350
بجهرم,توسعه مولد نيروگاهي جهرم,1567,35166784,78283761084,2280,2257,2240,-40,-1.75,2226,-54,-2.37,2171,2299
غبشهر,صنعتي‌ بهشهر,1565,33127627,99422028079,3026,3000,2961,-65,-2.15,3001,-25,-0.83,2950,3070
غدام,خوراك‌  دام‌ پارس‌,1559,1828533,87028950730,49450,49950,47000,-2450,-4.95,47590,-1860,-3.76,46980,50500
كزغال,زغال سنگ پروده طبس,1551,1870542,37552070000,20150,19650,20150,0,0,20100,-50,-0.25,19650,20550
حآسا,آسيا سير ارس,1531,10396462,120467595370,10890,11650,11650,760,6.98,11590,700,6.43,11180,11650
سمايه,بانك سرمايه,1522,17563500,96990252730,5640,5690,5480,-160,-2.84,5520,-120,-2.13,5480,5720
نوين,بيمه نوين,1520,42695516,82774397950,2000,2034,1970,-30,-1.5,1939,-61,-3.05,1861,2040
فارس,صنايع پتروشيمي خليج فارس,1506,21591941,202170746810,9310,9220,9400,90,0.97,9360,50,0.54,9220,9500
سبزوا,سيمان لار سبزوار,1483,16743337,92547429000,5390,5500,5500,110,2.04,5530,140,2.6,5390,5680
خزر,فنرسازي‌زر,1479,13936696,72705640800,5390,5350,5270,-120,-2.23,5220,-170,-3.15,5030,5450
شتوكا,توكا رنگ فولاد سپاهان,1471,6586448,120594364860,17440,17810,18350,910,5.22,18310,870,4.99,17700,18660
شفارس,صنايع‌ شيميايي‌ فارس‌,1466,51587007,70616516986,1418,1400,1379,-39,-2.75,1369,-49,-3.46,1326,1440
زماهان,مجتمع توليد گوشت مرغ ماهان,1455,10289466,81984493380,8390,8390,8090,-300,-3.58,7970,-420,-5.01,7810,8500
شلعاب,لعابيران‌,1442,11266216,79012513410,7220,7080,7120,-100,-1.39,7010,-210,-2.91,6860,7320
شغدير,پتروشيمي غدير,1437,2077720,144461516970,67040,67200,70390,3350,5,69530,2490,3.71,67200,70390
كرازي,كارخانجات‌توليدي‌شيشه‌رازي‌,1428,62276348,93829966215,1530,1530,1539,9,0.59,1507,-23,-1.5,1467,1559
فسبزوار,پارس فولاد سبزوار,1423,1254424,29883674790,24100,23620,23820,-280,-1.16,23880,-220,-0.91,23410,24450
ثمسكن,سرمايه‌گذاري‌ مسكن‌,1417,25456984,114172486275,4549,4600,4577,28,0.62,4485,-64,-1.41,4350,4680
شيران,س. صنايع‌شيميايي‌ايران,1415,10465008,112288042070,10620,10530,10960,340,3.2,10730,110,1.04,10350,11050
فجر,فولاد اميركبيركاشان,1408,14181164,229489376980,15250,15250,16310,1060,6.95,16180,930,6.1,15250,16310
لطيف,محصولات كاغذي لطيف,1402,765870,45892865900,59200,59500,61050,1850,3.13,59900,700,1.18,58000,61800
لبخند,صندوق س. لبخند فارابي-د,1388,86707444,945301162037,10894,10902,10903,9,0.08,10902,8,0.07,10902,10903
خلنت,لنت‌ ترمزايران‌,1383,2685630,93433902290,36090,35000,35370,-720,-2,34790,-1300,-3.6,34290,36350
اميد,تامين سرمايه اميد,1378,23857037,132702146010,5340,5230,5600,260,4.87,5560,220,4.12,5190,5600
شكام,صنايع شيميايي كيمياگران امروز,1374,16176962,134805623230,7990,8040,8380,390,4.88,8330,340,4.26,8040,8380
حبندر,دريايي و کشتيراني خط دريابندر,1368,2998892,43404383100,14800,15040,14390,-410,-2.77,14470,-330,-2.23,14360,15040
ورازي,بيمه رازي,1367,54006646,80392926667,1532,1487,1487,-45,-2.94,1489,-43,-2.81,1487,1526
آكورد,صندوق س. آرمان آتي كوثر-د,1346,15153930,676785131795,44628,44660,44660,32,0.07,44661,33,0.07,44660,44661
خديزل,بهمن  ديزل,1341,17632949,121285937890,7110,7000,6900,-210,-2.95,6880,-230,-3.23,6760,7190
غشهداب,كشت و صنعت شهداب ناب خراسان,1336,31464534,68517283659,2212,2141,2182,-30,-1.36,2178,-34,-1.54,2102,2230
حريل,ريل پردازسير,1330,16463744,60909404442,3741,3750,3755,14,0.37,3700,-41,-1.1,3510,3860
ثغرب,شركت سرمايه گذاري مسكن شمالغرب,1326,8663924,67125301870,7980,7950,7810,-170,-2.13,7750,-230,-2.88,7520,8040
زكشت,كشاورزي مكانيزه اصفهان كشت,1323,2943523,84778265550,30450,28750,29100,-1350,-4.43,28800,-1650,-5.42,28350,30450
زكوثر,سرمايه گذاري كشاورزي كوثر,1321,6288472,101035144970,16500,16850,16300,-200,-1.21,16070,-430,-2.61,15700,16850
پدرخش,درخشان‌ تهران‌,1309,12091274,160545930780,12710,13340,13340,630,4.96,13280,570,4.48,12860,13340
وخاور,بانك خاورميانه,1304,17908409,76602067649,4318,4228,4300,-18,-0.42,4277,-41,-0.95,4201,4360
اتكاسا,بيمه اتكايي سامان,1299,4898749,20613043577,4267,4201,4256,-11,-0.26,4208,-59,-1.38,4150,4281
جهرم,پتروشيمي جهرم,1288,42970493,39860286295,931,958,917,-14,-1.5,928,-3,-0.32,904,958
وملي,گروه‌ صنعتي‌ ملي‌ (هلدينگ‌,1283,589614,83695356660,148220,143000,143990,-4230,-2.85,141950,-6270,-4.23,140810,148500
كيسون,شركت كيسون,1283,58399402,100377306742,1614,1750,1730,116,7.19,1719,105,6.51,1698,1760
زنگان,صنعت روي زنگان,1268,1175888,76444962650,68150,67400,66150,-2000,-2.93,65000,-3150,-4.62,63400,69400
غچين,كشت‌ و صنعت‌ چين‌ چين,1268,35853239,226395574190,6020,6280,6320,300,4.98,6310,290,4.82,6120,6320
وآوا,سرمايه گذاري آوا نوين,1257,17087868,53838982234,3343,3340,3187,-156,-4.67,3151,-192,-5.74,3109,3360
ولغدر,ليزينگ‌خودروغدير,1252,17096864,74002122607,4302,4320,4400,98,2.28,4328,26,0.6,4111,4450
كگاز,شيشه‌ و گاز,1234,6976031,107811932020,15210,15760,15200,-10,-0.07,15450,240,1.58,14800,15970
پارند,صندوق س. پارند پايدار سپهر,1229,75436920,761626142905,10090,10097,10096,6,0.06,10096,6,0.06,10096,10097
كبافق,معادن‌ بافق‌,1228,3292509,106091395630,33400,34190,32050,-1350,-4.04,32220,-1180,-3.53,31730,34190
حسير,ريل سير كوثر,1227,2824001,71794153400,26100,26200,25350,-750,-2.87,25400,-700,-2.68,24450,26850
تاپيكو,س. نفت و گاز و پتروشيمي تأمين,1220,9890970,129110970870,13300,13430,13170,-130,-0.98,13050,-250,-1.88,12870,13430
غپآذر,شير پگاه آذربايجان شرقي,1215,1503127,68538903550,44500,45350,45250,750,1.69,45600,1100,2.47,44050,47600
سيمرغ,سيمرغ,1211,3463207,88384586630,26110,26060,25990,-120,-0.46,25520,-590,-2.26,25120,27350
كمينا,شيشه سازي مينا,1207,13045171,129994866510,10200,10000,9900,-300,-2.94,9960,-240,-2.35,9900,10320
خريخت,صنايع‌ريخته‌گري‌ايران‌,1185,14553780,59861549512,4204,4164,4160,-44,-1.05,4113,-91,-2.16,4004,4295
كچاد,معدني‌وصنعتي‌چادرملو,1184,6987530,82810784940,11780,11670,11940,160,1.36,11830,50,0.42,11650,12080
شاوان,پالايش نفت لاوان,1183,4776938,100677847950,20850,21000,21250,400,1.92,21100,250,1.2,20500,21450
شاراك,پتروشيمي شازند,1177,2712202,87192570500,32690,32600,32120,-570,-1.74,32190,-500,-1.53,31980,33390
پارس,پتروشيمي پارس,1174,34220896,82746313657,2408,2408,2423,15,0.62,2415,7,0.29,2394,2442
پارتا,مجتمع صنعتي آرتاويل تاير,1170,5410135,49504812930,8900,9300,9340,440,4.94,9150,250,2.81,8570,9340
ختراك,ريخته‌گري‌ تراكتورسازي‌ ايران‌,1162,12240849,180400453290,14230,14250,14650,420,2.95,14740,510,3.58,14160,14940
فايرا,آلومينيوم‌ايران‌,1161,12865514,78812706030,5960,6080,6240,280,4.7,6100,140,2.35,5930,6250
سكرد,سيمان كردستان,1161,8498964,63720132870,7720,7760,7620,-100,-1.3,7500,-220,-2.85,7180,7780
كرماشا,صنايع پتروشيمي كرمانشاه,1160,1871623,121921470940,64470,64950,65370,900,1.4,65140,670,1.04,64870,65690
زدشت,كشت و صنعت دشت خرم دره,1154,3887713,117400892800,31050,29200,30900,-150,-0.48,30200,-850,-2.74,28950,31200
خفنر,فنرسازي‌خاور,1150,4460958,53419484600,12410,11860,12130,-280,-2.26,11970,-440,-3.55,11550,12590
دبالك,مواد اوليه دارويي البرز بالك,1149,10619128,90926181800,9040,8930,8830,-210,-2.32,8560,-480,-5.31,8410,9200
آپ,آسان پرداخت پرشين,1144,9751266,70487506020,7320,7230,7240,-80,-1.09,7230,-90,-1.23,7070,7430
ثپرديس,سرمايه گذاري مسكن پرديس,1139,11810921,65602087460,5890,5720,5660,-230,-3.9,5550,-340,-5.77,5480,5960
تپسي,پيشگامان فن آوري و دانش آراميس,1128,21975206,108672604290,5150,5140,4920,-230,-4.47,4950,-200,-3.88,4900,5140
كپشير,پشم‌شيشه‌ايران‌,1121,7882964,69281277850,8440,8650,8840,400,4.74,8790,350,4.15,8460,8860
كروي,توسعه‌ معادن‌ روي‌ ايران‌,1118,5366510,157693052340,29000,28560,30000,1000,3.45,29380,380,1.31,28370,30000
دسانكو,داروسازي سبحان انكولوژي,1118,7921732,55260168640,7070,6930,7030,-40,-0.57,6980,-90,-1.27,6730,7260
واحصا,احياء صنايع خراسان,1118,1336911,89503056550,65350,65800,67300,1950,2.98,66950,1600,2.45,63650,67300
ولكار,ليزينگ كارآفرين,1113,1610689,13766038690,8580,8530,8540,-40,-0.47,8550,-30,-0.35,8440,8740
سفارس,سيمان فارس و خوزستان,1113,5463582,117529967390,21090,20730,21710,620,2.94,21510,420,1.99,20730,21930
تجلي,تجلي توسعه معادن و فلزات,1111,29182106,42991630643,1506,1500,1480,-26,-1.73,1473,-33,-2.19,1444,1535
ريشمك,توليد و صادرات ريشمك,1110,4822855,108364624100,22300,22200,23550,1250,5.61,22450,150,0.67,21200,23650
ونوين,بانك‌اقتصادنوين‌,1095,28467687,104183833570,3689,3690,3719,30,0.81,3660,-29,-0.79,3583,3721
توريل,توكاريل,1094,14542499,149089450410,10680,10260,10480,-200,-1.87,10250,-430,-4.03,10150,10890
غصينو,صنعتي مينو,1091,4315471,56226066470,13170,13090,13030,-140,-1.06,13030,-140,-1.06,12780,13500
تكمبا,كمباين‌ سازي‌ ايران‌,1090,11052572,67072676280,6400,6220,6140,-260,-4.06,6070,-330,-5.16,5960,6490
خشرق,الكتريك‌ خودرو شرق‌,1090,3984255,71138521170,17740,17940,18100,360,2.03,17850,110,0.62,17150,18300
كي بي سي,شركت كي بي سي,1088,6084022,78113816890,12850,12670,12940,90,0.7,12840,-10,-0.08,12300,13190
سفار,سيمان‌فارس‌,1083,1490774,144665576190,93000,97650,97600,4600,4.95,97040,4040,4.34,94140,97650
فسازان,غلتك سازان سپاهان,1082,20510559,83595379052,4068,3931,4210,142,3.49,4076,8,0.2,3900,4230
اوان,مبين وان كيش,1082,7640546,112812343210,15140,15120,15200,60,0.4,14760,-380,-2.51,14090,15550
غمينو,شركت صنايع غذايي مينو شرق,1080,7359087,61728068600,8540,8560,8430,-110,-1.29,8390,-150,-1.76,8150,8660
تكشا,گسترش‌صنايع‌وخدمات‌كشاورزي‌,1070,2731917,75070735440,26830,28170,27350,520,1.94,27480,650,2.42,25550,28170
كارين,صندوق س نگين سامان-ثابت,1070,41570543,416245971063,10006,10013,10013,7,0.07,10013,7,0.07,10012,10014
دزهراوي,داروسازي‌زهراوي‌,1069,10194228,52205911483,5304,5320,5210,-94,-1.77,5121,-183,-3.45,5039,5320
وپسا,س. پتروشيمي ساختمان  خليج فارس,1067,31777336,57339489480,1854,1836,1805,-49,-2.64,1804,-50,-2.7,1799,1861
فنورد,نوردوقطعات‌ فولادي‌,1065,3956571,62960253700,15890,16270,16300,410,2.58,15910,20,0.13,15260,16340
اطلس,صندوق س.توسعه اطلس مفيد-س,1062,483333,154277719699,317977,319888,321830,3853,1.21,319195,1218,0.38,314001,322500
پخش,پخش البرز,1062,6925008,372334928500,51300,52100,53850,2550,4.97,53750,2450,4.78,51950,53850
ومدير,گ.مديريت ارزش سرمايه ص ب كشوري,1058,7524444,31894897858,4278,4300,4235,-43,-1.01,4239,-39,-0.91,4182,4300
قشكر,شكرشاهرود,1055,23642196,56174409696,2483,2500,2388,-95,-3.83,2376,-107,-4.31,2359,2540
آوند,صندوق س. آوند مفيد-د,1055,77854907,859566109390,11032,11041,11041,9,0.08,11041,9,0.08,11040,11041
وصنعت,سرمايه گذاري توسعه صنعت وتجارت,1055,19174212,40248944939,2140,2170,2130,-10,-0.47,2099,-41,-1.92,2029,2205
سدور,سيمان‌ دورود,1044,4548355,40359751750,9150,9040,9040,-110,-1.2,8870,-280,-3.06,8700,9190
كپشيرح,ح . پشم‌شيشه‌ايران‌,1040,12902409,64749754488,5006,5011,4964,-42,-0.84,5018,12,0.24,4854,5168
فاذر,صنايع‌ آذرآب‌,1038,58379341,95514700393,1561,1630,1639,78,5,1636,75,4.8,1583,1639
زنجان,صنايع كشاورزي وكود زنجان,1037,21387003,57776429761,2646,2645,2720,74,2.8,2701,55,2.08,2636,2725
تملت,تامين سرمايه بانك ملت,1026,10611042,33930056567,3272,3240,3160,-112,-3.42,3198,-74,-2.26,3123,3296
قنيشا,قند  نيشابور,1008,18694221,52944063241,2931,2960,2857,-74,-2.52,2832,-99,-3.38,2786,2965
قاسم,قاسم ايران,1007,15416090,111886197480,7420,7230,7330,-90,-1.21,7260,-160,-2.16,7090,7550
تپمپي,پمپ‌ سازي‌ ايران‌,1005,4912136,113502034540,24450,24930,23290,-1160,-4.74,23110,-1340,-5.48,22740,24930
سرو,صندوق س سروسودمند مدبران-سهام,1000,2205598,206110486700,93740,94800,93910,170,0.18,93450,-290,-0.31,92050,94950
پلاسك,پلاسكوكار,991,21368012,89326226792,4381,4235,4200,-181,-4.13,4180,-201,-4.59,4162,4379
رابين,صندوق س. توسعه افق رابين-د,990,14810001,148100010000,10000,10000,10000,0,0,10000,0,0,10000,10000
دسبحان,سبحان دارو,989,8506887,60875830470,7440,7150,7240,-200,-2.69,7160,-280,-3.76,7070,7420
افق,فروشگاههاي زنجيره اي افق كوروش,973,3593517,53652913250,15150,14830,14800,-350,-2.31,14990,-160,-1.06,14740,15430
پرسپوليس,پرسپوليس,965,3482599,8861049207,2508,2482,2523,15,0.6,2538,30,1.2,2482,2558
قصفها,قنداصفهان‌,962,1077765,107535339980,95580,100350,97560,1980,2.07,99780,4200,4.39,96600,100350
وايران,ليزينگ ايرانيان,951,13075337,55005516414,4425,4449,4200,-225,-5.08,4207,-218,-4.93,4116,4450
وسينا,بانك سينا,942,27651380,84692169816,3111,3052,3090,-21,-0.68,3063,-48,-1.54,2903,3140
وبوعلي,سرمايه‌گذاري‌بوعلي‌,926,11990094,32348032051,2786,2720,2709,-77,-2.76,2698,-88,-3.16,2640,2795
ودي,بيمه  دي,924,12581145,59069432249,4910,4790,4719,-191,-3.89,4695,-215,-4.38,4567,4980
ساذري,آذريت‌,920,6539595,52827117560,8090,7910,8140,50,0.62,8080,-10,-0.12,7850,8330
چدن,توليدي چدن سازان,919,19657771,49304961572,2532,2460,2480,-52,-2.05,2508,-24,-0.95,2400,2617
وسين,بيمه سينا,916,45035118,94981132248,2051,2112,2112,61,2.97,2109,58,2.83,2076,2112
چكاوه,صنايع‌كاغذسازي‌كاوه‌,915,4009575,50508393190,12580,12610,12700,120,0.95,12600,20,0.16,12070,12990
فيروزا,صندوق ارمغان فيروزه آسيا-ثابت,915,32095011,1039422370060,32364,32385,32386,22,0.07,32386,22,0.07,32385,32386
غشصفا,شيرپاستوريزه‌پگاه‌اصفهان‌,913,3129132,67999713700,23110,23110,21820,-1290,-5.58,21730,-1380,-5.97,21500,23110
ونيرو,سرمايه‌گذاري‌نيرو,907,23336454,61408196201,2678,2600,2667,-11,-0.41,2631,-47,-1.76,2550,2715
البرز,بيمه البرز,906,24002861,50335632876,2115,2159,2085,-30,-1.42,2097,-18,-0.85,2057,2159
دماوند,توليد نيروي برق دماوند,905,2431737,50732365150,21350,21200,20900,-450,-2.11,20850,-500,-2.34,20400,21850
رتاپ,تجارت الكترونيك  پارسيان,905,9609786,29806905284,3122,3057,3110,-12,-0.38,3102,-20,-0.64,3042,3199
بخاور,بيمه زندگي خاورميانه,898,17500186,49753382404,2963,2970,2849,-114,-3.85,2843,-120,-4.05,2756,2970
قشرين,قند شيرين خراسان,898,16974269,159911569120,9170,9430,9440,270,2.94,9420,250,2.73,9090,9440
سشمال,سيمان‌ شمال‌,894,8115330,101645451240,12410,12080,12840,430,3.46,12530,120,0.97,12080,12980
خراسان,پتروشيمي خراسان,894,835271,97040636060,113830,113790,117150,3320,2.92,116180,2350,2.06,113790,118800
شراز,پالايش نفت شيراز,893,6264866,94037106260,14920,14890,15070,150,1.01,15010,90,0.6,14780,15190
فباهنر,مس‌ شهيدباهنر,889,2162920,69442703810,31600,31010,32810,1210,3.83,32110,510,1.61,31010,32860
غپاك,لبنيات‌ پاك‌,887,4800350,63495748320,13260,13320,13150,-110,-0.83,13230,-30,-0.23,12870,13670
حفاري,حفاري شمال,886,18489168,82444672427,4482,4482,4459,-23,-0.51,4459,-23,-0.51,4381,4540
هم وزن,صندوق س. شاخصي كيان-س,885,19356611,237209563613,12210,12080,12393,183,1.5,12255,45,0.37,12050,12499
كحافظ,كاشي‌ وسراميك‌ حافظ‌,882,8578913,55481791950,6370,6220,6500,130,2.04,6470,100,1.57,6220,6650
كاذر,فرآورده‌هاي‌نسوزآذر,879,15699567,81488176290,5440,5380,5170,-270,-4.96,5190,-250,-4.6,5170,5440
بپاس,بيمه پاسارگاد,876,4550520,88998102800,19650,19650,19500,-150,-0.76,19600,-50,-0.25,19300,19850
خچرخش,چرخشگر,875,2698934,61835519800,22670,22800,22900,230,1.01,22910,240,1.06,22350,23400
كيميا,معدني كيمياي زنجان گستران,864,15972591,128625521020,7720,7820,8100,380,4.92,8050,330,4.27,7720,8100
وتوصا,گروه س توسعه صنعتي ايران,860,5251689,43026769850,8530,8330,8180,-350,-4.1,8190,-340,-3.99,7980,8540
كقزوي,شيشه‌ قزوين‌,859,7853712,151445887910,18920,19480,19250,330,1.74,19280,360,1.9,18360,19480
حآفرين,ريل پرداز نو آفرين,855,12179165,50959870760,4355,4357,4217,-138,-3.17,4184,-171,-3.93,4138,4399
دكپسول,توليد ژلاتين كپسول ايران,852,621642,40289671300,65700,65700,65450,-250,-0.38,64800,-900,-1.37,63300,67900
وبهمن,سرمايه‌گذاري‌بهمن‌,849,13174352,52027557460,4080,4079,3980,-100,-2.45,3949,-131,-3.21,3850,4179
شصدف,صنعتي دوده فام,848,967935,33444495850,35300,34300,34700,-600,-1.7,34550,-750,-2.12,33800,35450
شگل,گلتاش‌,847,11853095,66270004350,5790,5840,5700,-90,-1.55,5590,-200,-3.45,5440,5850
رمپنا,گروه مپنا (سهامي عام),846,11520345,137818586670,11920,11900,12030,110,0.92,11960,40,0.34,11720,12100
ساوه,سيمان ساوه,843,590755,48235572250,78750,78850,82550,3800,4.83,81650,2900,3.68,78850,82600
كپارس,كاشي‌ پارس‌,841,13870588,125474557660,8790,9050,9150,360,4.1,9050,260,2.96,8820,9220
زاگرس,پتروشيمي زاگرس,840,973887,129059240750,130400,129250,132600,2200,1.69,132500,2100,1.61,126000,136000
فنوال,نورد آلومينيوم‌,840,6972184,48406585830,7130,7010,7050,-80,-1.12,6940,-190,-2.66,6700,7200
بكهنوج,توليد برق ماهتاب كهنوج,837,24534393,35038244043,1430,1417,1440,10,0.7,1428,-2,-0.14,1415,1469
زشريف,كشت وصنعت شريف آباد,833,7559739,36695966120,5100,5050,4900,-200,-3.92,4850,-250,-4.9,4750,5050
خفناور,مهندسي صنعتي روان فن آور,823,4873122,119727009900,24950,24700,24900,-50,-0.2,24550,-400,-1.6,24250,25300
وحافظ,بيمه حافظ,820,18152612,59518077622,3355,3335,3390,35,1.04,3279,-76,-2.27,3255,3450
بنو,بيمه تجارت نو,814,8478547,34730753918,4175,4030,4160,-15,-0.36,4096,-79,-1.89,4000,4249
وثوق,سرمايه گذاري وثوق امين,812,2938704,67673137500,22950,23550,23000,50,0.22,23000,50,0.22,22300,23550
كامياب,صندوق س. كامياب آشنا-د,810,32382900,452018189629,13949,13959,13959,10,0.07,13959,10,0.07,13958,13959
فجام,جام‌دارو,809,10295761,56858536430,5780,5780,5550,-230,-3.98,5520,-260,-4.5,5500,5830
نمرينو,ايران‌ مرينوس‌,807,696433,78620919490,110050,114500,115550,5500,5,112890,2840,2.58,104710,115550
لسرما,سرما آفرين‌,807,2387002,64567573360,28040,29100,27270,-770,-2.75,27050,-990,-3.53,26640,29100
نطرين,عطرين نخ قم,806,4749686,35836752300,7750,7740,7620,-130,-1.68,7550,-200,-2.58,7250,7800
غشان,شيرپاستوريزه‌پگاه‌خراسان‌,803,7652797,54708923210,7600,7400,7170,-430,-5.66,7150,-450,-5.92,7070,7700
وآرين,شركت توسعه اقتصادي آرين,803,19961313,28744268893,1478,1496,1434,-44,-2.98,1440,-38,-2.57,1434,1496
وهنر,گروه توسعه هنر ايران,797,17868797,52852870121,2926,2926,2936,10,0.34,2958,32,1.09,2841,3013
پارسيان,بيمه پارسيان,793,8852526,31687112393,3638,3550,3599,-39,-1.07,3579,-59,-1.62,3495,3700
خفولا,خدمات فني فولاد يزد,787,2437973,122527815700,49550,50100,51000,1450,2.93,50250,700,1.41,48100,51000
فن آوا,گروه فن آوا,783,9334312,61103094860,6470,6450,6490,20,0.31,6550,80,1.24,6290,6660
ضستا1108,اختيارخ شستا-1300-1401/11/05,780,384211,384218000,2,1,1,-1,-50,1,-1,-50,1,2
حآساح,ح.آسيا سير ارس,777,6858301,45375571230,6220,6490,6650,430,6.91,6620,400,6.43,6410,6650
اعتلا,شركت سرمايه گذاري اعتلاء البرز,775,13146937,68571590480,5380,5220,5290,-90,-1.67,5220,-160,-2.97,5120,5510
زگلدشت,كشت و دام گلدشت نمونه اصفهان,774,5856255,105469693920,17640,17220,18000,360,2.04,18010,370,2.1,17200,18840
فزرين,زرين معدن آسيا,774,8382377,59719157580,7100,6770,7200,100,1.41,7120,20,0.28,6770,7250
تفارس,تامين سرمايه خليج فارس,772,15815494,89054650670,5780,5650,5680,-100,-1.73,5630,-150,-2.6,5610,5740
شليا,شركت مواد ويژه ليا,768,3431442,147155498300,41800,43050,43050,1250,2.99,42900,1100,2.63,41600,43050
دامين,داروسازي‌ امين‌,766,8254598,30205781052,3656,3630,3620,-36,-0.98,3659,3,0.08,3510,3738
ساربيل,سيمان آرتا اردبيل,766,957651,44851984490,45320,47000,46960,1640,3.62,46840,1520,3.35,46000,47580
تماوند,تامين سرمايه دماوند,765,9234253,57006455200,6150,6250,6170,20,0.33,6170,20,0.33,5990,6310
سبهان,سيمان‌ بهبهان‌,758,969312,53754100900,55610,53100,56290,680,1.22,55460,-150,-0.27,53100,57250
ارفع,شركت آهن و فولاد ارفع,748,2865895,51939017150,17940,17510,18320,380,2.12,18050,110,0.61,17510,18400
پاسا,ايران‌ياساتايرورابر,746,6981352,71163733460,10560,10110,10400,-160,-1.52,10190,-370,-3.5,10040,10800
شسپا,نفت سپاهان,743,10346562,42305232512,4123,4122,4124,1,0.02,4107,-16,-0.39,4024,4158
پكوير,كوير تاير,738,7188703,42670081540,5770,5640,6050,280,4.85,5940,170,2.95,5640,6110
كهمدا,شيشه‌ همدان‌,735,4008838,45572065180,11410,11190,11510,100,0.88,11370,-40,-0.35,11190,11780
كفپارس,فرآورده‌هاي‌ نسوز پارس‌,735,11139984,48349157795,4360,4390,4410,50,1.15,4340,-20,-0.46,4130,4500
بساما,بيمه سامان,726,3275437,37101987650,11450,11450,11490,40,0.35,11330,-120,-1.05,11000,11750
پلوله,گازلوله‌,724,3656021,111591502550,29800,30650,30650,850,2.85,30500,700,2.35,29100,30650
وحكمت,بيمه حكمت صبا,722,24698783,45287423504,1882,1933,1826,-56,-2.98,1834,-48,-2.55,1826,1933
خرينگ,رينگ‌سازي‌مشهد,716,1694653,48574366950,29050,28700,28750,-300,-1.03,28660,-390,-1.34,27810,29800
شپاكسا,پاكسان‌,715,17431921,36377821229,2121,2101,2111,-10,-0.47,2087,-34,-1.6,2001,2178
نفيس,صندوق س.پشتوانه طلاي صبا,712,4456310,59234553867,12546,13040,13484,938,7.48,13292,746,5.95,13040,13690
خليبل,ماليبل سايپا,708,2038028,55041662950,26800,27600,27600,800,2.99,27000,200,0.75,26000,27600
ستران,سيمان‌ تهران‌,707,4313289,152729926670,35970,35100,36000,30,0.08,35410,-560,-1.56,35020,36060
وتوكا,سرمايه‌گذاري‌توكافولاد(هلدينگ,699,4485748,40469559010,9420,9060,9130,-290,-3.08,9020,-400,-4.25,8770,9690
ملت,بيمه ملت,693,18627699,31423927423,1691,1691,1670,-21,-1.24,1687,-4,-0.24,1665,1738
كترام,توليدي‌ كاشي‌ تكسرام‌,692,6855283,58714459900,8790,8570,8680,-110,-1.25,8560,-230,-2.62,8360,8880
رنيك,جنرال مكانيك,689,2545570,39369444220,15130,15070,15600,470,3.11,15470,340,2.25,15070,15730
شفارا,پتروشيمي فارابي,689,10846310,60831040570,5540,5610,5680,140,2.53,5610,70,1.26,5380,5700
لكما,كارخانجات‌مخابراتي‌ايران‌,680,23541852,28060099917,1227,1192,1191,-36,-2.93,1192,-35,-2.85,1191,1200
شپترو,پتروشيمي آبادان,678,20151452,37009135577,1884,1833,1842,-42,-2.23,1837,-47,-2.49,1828,1885
ضستا6004,اختيارخ شستا-865-1402/06/08,677,170345,60363321000,358,380,360,2,0.56,354,-4,-1.12,336,387
زمگسا,كشاورزي‌ ودامپروي‌ مگسال‌,677,2497822,81734236850,33600,33600,33100,-500,-1.49,32720,-880,-2.62,31920,33910
كطبس,ذغال‌سنگ‌ نگين‌ ط‌بس‌,675,1897626,31152955280,16350,16300,16530,180,1.1,16420,70,0.43,15910,17240
قزوين,كارخانجات‌ قند قزوين‌,671,7373646,48732347970,6700,6710,6530,-170,-2.54,6610,-90,-1.34,6380,6890
سرچشمه,سرمايه گذاري مس سرچشمه,669,31800054,150656494747,4515,4532,4740,225,4.98,4738,223,4.94,4532,4740
دجابر,داروسازي‌ جابرابن‌حيان‌,668,3209957,43025796370,13720,13650,13790,70,0.51,13400,-320,-2.33,13080,13790
چفيبر,فيبر ايران‌,665,5636321,31917450610,5660,5660,5780,120,2.12,5660,0,0,5390,5830
ضستا1205,اختيارخ شستا-1000-1401/12/03,664,162343,18690220000,123,140,120,-3,-2.44,115,-8,-6.5,96,140
ثنام,س ساختماني ب نام آوران مهندسي,662,4534621,32027827690,7260,7050,7060,-200,-2.75,7060,-200,-2.75,7050,7170
دارو,كارخانجات‌داروپخش‌,662,2511243,52810556310,21310,21900,21330,20,0.09,21030,-280,-1.31,20340,21900
وثنو,سرمايه گذاري ساختماني نوين,657,14436573,31411129645,2228,2183,2210,-18,-0.81,2176,-52,-2.33,2162,2228
كسعدي,كاشي‌ سعدي‌,653,3744159,39882332030,11120,10790,10780,-340,-3.06,10650,-470,-4.23,10570,11300
وتعاون,بيمه تعاون,650,17136785,30834970883,1878,1898,1820,-58,-3.09,1799,-79,-4.21,1785,1898
آسيا,بيمه آسيا,650,14430230,27807812440,1971,1983,1935,-36,-1.83,1927,-44,-2.23,1871,1988
وهور,مديريت انرژي اميد  تابان هور,650,23730280,36577218691,1591,1599,1536,-55,-3.46,1541,-50,-3.14,1521,1618
ساينا,صنايع بهداشتي ساينا,647,917890,28658977150,30950,30500,31450,500,1.62,31200,250,0.81,30500,32100
ضدي203,اختيارخ دي-600-14020217,642,107587,37028190000,360,360,363,3,0.83,344,-16,-4.44,314,387
مفاخر,توسعه فناوري اطلاعات خوارزمي,641,3825597,31096046800,8190,8340,8430,240,2.93,8130,-60,-0.73,7800,8480
وپست,پست بانك ايران,641,7826582,45723393080,5860,6000,5910,50,0.85,5840,-20,-0.34,5640,6000
خكمك,كمك‌فنرايندامين‌,640,1811919,42363084580,24110,23900,23420,-690,-2.86,23380,-730,-3.03,22910,24500
سپاها,سيمان‌سپاهان‌,639,4777499,57712812420,12280,12350,12200,-80,-0.65,12080,-200,-1.63,11720,12480
پارسان,گسترش نفت و گاز پارسيان,638,2068416,68490221230,33080,33090,33010,-70,-0.21,33100,20,0.06,33010,33400
سيلام,سيمان‌ ايلام‌,636,4386658,53338264670,11890,11790,12200,310,2.61,12160,270,2.27,11790,12480
ونفت,سرمايه‌گذاري‌ صنعت‌ نفت‌,636,5477241,24000442233,4448,4336,4446,-2,-0.04,4382,-66,-1.48,4250,4510
وپترو,سرمايه‌گذاري صنايع پتروشيمي‌,635,4531695,73651144580,16040,15560,16500,460,2.87,16250,210,1.31,15560,16530
قمرو,قند مرودشت‌,632,2314306,27122881070,12160,12090,11870,-290,-2.38,11720,-440,-3.62,11360,12200
ثبات,صندوق س. ثبات ويستا -د,632,119743895,1600680902589,13359,13367,13368,9,0.07,13368,9,0.07,13367,13368
ثامان,سامان‌ گستراصفهان‌,629,2572104,40936228210,16580,15810,15910,-670,-4.04,15920,-660,-3.98,15760,16660
وزمين,بانك ايران زمين,626,5638564,41064169600,7400,7260,7410,10,0.14,7280,-120,-1.62,7260,7410
دتماد,توليدمواداوليه‌داروپخش‌,625,1567950,60966938060,38870,39200,38750,-120,-0.31,38880,10,0.03,38000,39550
وصنا,گروه‌صنايع‌بهشهرايران‌,625,8677438,24139030067,2828,2770,2817,-11,-0.39,2782,-46,-1.63,2705,2947
كسرام,پارس‌ سرام‌,625,6974583,44111418710,6610,6490,6280,-330,-4.99,6320,-290,-4.39,6280,6680
پاكشو,گروه صنعتي پاكشو,624,3844924,23988787660,6440,6350,6310,-130,-2.02,6400,-40,-0.62,6170,6410
تيپيكو,سرمايه گذاري دارويي تامين,623,2211731,56733554890,25930,26000,26360,430,1.66,25770,-160,-0.62,25080,26370
خمحور,توليدمحورخودرو,622,8056822,33918001590,4241,4151,4190,-51,-1.2,4210,-31,-0.73,4075,4291
دالبر,البرزدارو,621,4987041,38121162180,7680,7410,7800,120,1.56,7640,-40,-0.52,7340,7870
درهآور,دارويي ره آورد تامين,613,1910756,129370527250,66550,64200,68200,1650,2.48,67700,1150,1.73,64200,68950
ضسپا1206,اختيارخ خساپا-2200-1401/12/10,613,111762,35830043000,327,440,375,48,14.68,321,-6,-1.83,265,440
كنور,توسعه معدني و صنعتي صبانور,612,1976946,34124194180,17250,16890,17900,650,3.77,17250,0,0,16650,17940
آرام,صندوق س شاخصي آرام مفيد,612,2818372,33224686320,11740,11700,11880,140,1.19,11790,50,0.43,11550,11910
حتايد,تايدواترخاورميانه,610,11443862,61888325210,5500,5490,5490,-10,-0.18,5410,-90,-1.64,5290,5490
قهكمت,قندهكمتان‌,608,3611417,30878725320,8900,8970,8520,-380,-4.27,8550,-350,-3.93,8460,8970
اپرداز,آتيه داده پرداز,606,7176878,36444889590,5230,5240,5140,-90,-1.72,5080,-150,-2.87,4970,5360
غگرجي,بيسكويت‌  گرجي‌,606,12089844,22096367602,1878,1871,1842,-36,-1.92,1828,-50,-2.66,1785,1908
بميلا,توسعه سرمايه گذاري ميلاد پارس,600,4658520,44235709470,9680,9690,9470,-210,-2.17,9500,-180,-1.86,9390,9790
زرفام,صندوق س.پشتوانه طلا زرفام آشنا,598,1320468,23240705690,16473,17150,17846,1373,8.33,17600,1127,6.84,17139,17949
فرآور,فرآوري‌موادمعدني‌ايران‌,597,2178347,59891376800,27900,27900,27500,-400,-1.43,27490,-410,-1.47,26570,28290
شنفت,نفت‌ پارس‌,597,3968487,30971116910,7990,8020,7900,-90,-1.13,7880,-110,-1.38,7570,8020
آباد,توريستي ورفاهي آبادگران ايران,596,1562553,41931226920,27940,27100,27230,-710,-2.54,26840,-1100,-3.94,26550,27500
غشهد,شهد ايران ‌,596,5713847,38440863890,6970,6730,6800,-170,-2.44,6730,-240,-3.44,6630,6930
آ س پ,آ.س.پ,595,5636868,36243667660,6390,6250,6500,110,1.72,6430,40,0.63,6170,6600
غشاذر,پگاه‌آذربايجان‌غربي‌,583,4291942,29338175120,7150,7130,6940,-210,-2.94,6840,-310,-4.34,6650,7130
شبصير,توليدات پتروشيمي قائد بصير,580,758735,91642875350,121850,123850,121850,0,0,120800,-1050,-0.86,119350,124950
شرنگي,شيميايي رنگين,579,774981,33177938900,44000,42750,43850,-150,-0.34,42800,-1200,-2.73,42700,44100
ضسپا1205,اختيارخ خساپا-2000-1401/12/10,577,94445,45736096000,439,480,555,116,26.42,484,45,10.25,390,558
ومعلم,بيمه معلم,577,11321746,20849923791,1914,1926,1869,-45,-2.35,1842,-72,-3.76,1819,1950
كفرا,فراورده‌ هاي‌ نسوزايران‌,574,3373732,29714113910,8730,8570,8730,0,0,8810,80,0.92,8410,9060
كمنگنز,معادن‌منگنزايران‌,572,2472765,28409839680,11640,11970,11560,-80,-0.69,11490,-150,-1.29,11240,11980
بموتو,موتوژن‌,571,6292579,18392993922,2938,2999,2946,8,0.27,2923,-15,-0.51,2890,2999
دعبيد,لابراتوارداروسازي‌  دكترعبيدي‌,568,2469002,34156717380,14400,14050,13980,-420,-2.92,14140,-260,-1.81,13680,14250
كاوه,فولاد كاوه جنوب كيش,566,5653756,43642113600,7720,7560,7710,-10,-0.13,7720,0,0,7550,8000
فولاي,صنايع فولاد آلياژي يزد,564,15548286,86840986894,5232,5540,5598,366,7,5585,353,6.75,5405,5598
فروس,فروسيليس‌ ايران‌,563,4346447,29165999090,6690,6690,6690,0,0,6710,20,0.3,6400,6900
تكنار,مجتمع معادن مس تكنار,558,695101,43602196850,61450,62000,63250,1800,2.93,62750,1300,2.12,61500,63250
شكربن,كربن‌ ايران‌,555,9606953,35706071881,3734,3789,3721,-13,-0.35,3717,-17,-0.46,3625,3800
طخود1205,اختيارف خودرو-2000-1401/12/03,550,231307,4026746000,23,21,14,-9,-39.13,17,-6,-26.09,12,25
زفكا,كشت و دامداري فكا,549,5339937,71884134720,13490,13400,13420,-70,-0.52,13460,-30,-0.22,13030,13850
سفانو,سيمان فارس نو,546,920677,59981211790,61200,64080,64730,3530,5.77,65150,3950,6.45,62310,65480
رفاه,فروشگاه هاي زنجيره اي رفاه,539,493652,150952490150,300300,309300,309300,9000,3,305800,5500,1.83,297150,309300
وسپه,سرمايه‌گذاري‌ سپه‌,539,7639114,37006127999,4849,4850,4840,-9,-0.19,4845,-4,-0.08,4752,4929
ولملت,واسپاري ملت,535,6547010,33316846430,5040,5150,5230,190,3.77,5090,50,0.99,4860,5300
داوه,داروسازي آوه سينا,533,3003216,25238141580,8770,8340,8400,-370,-4.22,8400,-370,-4.22,8160,8800
بزاگرس,نيروگاه زاگرس كوثر,532,5826082,27347435127,4792,4789,4684,-108,-2.25,4694,-98,-2.05,4560,4886
ثتوسا,س.توسعه و عمران استان اردبيل,530,1720535,33605788980,19220,19790,19530,310,1.61,19530,310,1.61,18830,19790
خعمرا,توسعه و عمران شهرستان نائين,529,3171241,18585184870,6020,6200,5840,-180,-2.99,5860,-160,-2.66,5840,6200
شكلر,نيروكلر,528,1416686,42004666630,29100,29470,29970,870,2.99,29650,550,1.89,28770,30910
مداران,داده‌پردازي‌ايران‌,527,3975036,28361368280,7290,7300,7100,-190,-2.61,7130,-160,-2.19,6990,7360
دسانكوح,ح . داروسازي سبحان انكولوژي,527,7620151,37309832911,5232,4913,4999,-233,-4.45,4896,-336,-6.42,4866,5207
فلامي,لاميران‌,526,2762562,61913269290,21390,22280,22450,1060,4.96,22410,1020,4.77,21510,22450
سپر,صندوق س سپر سرمايه بيدار- ثابت,525,11481569,190724472037,16602,16613,16611,9,0.05,16611,9,0.05,16610,16614
غفارس,شير پاستوريزه پگاه فارس,524,4014708,35128985970,8980,9040,8850,-130,-1.45,8750,-230,-2.56,8540,9100
غالبر,لبنيات‌ كالبر,522,2024545,55112627620,25980,25450,27270,1290,4.97,27220,1240,4.77,25450,27270
دسبحا,گروه دارويي سبحان,522,2250299,24156272630,10570,10660,10750,180,1.7,10700,130,1.23,9900,11080
بسويچ,پارس‌سويچ‌,519,7841977,36575272290,4890,4670,4730,-160,-3.27,4660,-230,-4.7,4650,4800
ولراز,ليزينگ رازي,518,1889399,50037850150,27200,27550,26700,-500,-1.84,26500,-700,-2.57,26400,27550
فافزا,فولاد افزا سپاهان,514,915693,37606521750,42100,42500,40850,-1250,-2.97,41050,-1050,-2.49,40850,42700
ثباغ,شهر سازي و خانه سازي باغميشه,512,3704099,35633314610,9530,9800,9790,260,2.73,9620,90,0.94,9200,9880
وسبحان,سرمايه گذاري سبحان,511,16682835,36919482319,2254,2210,2259,5,0.22,2213,-41,-1.82,2143,2270
فافق,صنايع مس افق كرمان,508,8392994,43568315330,5310,5390,5160,-150,-2.82,5190,-120,-2.26,5160,5390
پكرمان,گروه‌ صنعتي‌ بارز,507,3523660,70517621920,19100,20050,20050,950,4.97,20010,910,4.76,19350,20050
ساراب,سيمان‌ داراب‌,505,946284,22536864430,22990,23400,24390,1400,6.09,23820,830,3.61,22590,24560
وسكاب,س.ص.بازنشستگي كاركنان بانكها,503,5772988,18045016577,3155,3160,3123,-32,-1.01,3126,-29,-0.92,3080,3180
داراب,پتروشيمي داراب,502,9752829,10119226517,1063,1033,1035,-28,-2.63,1038,-25,-2.35,1032,1081
دتوزيع,توزيع دارو پخش,501,1571053,53440833300,33100,34700,34700,1600,4.83,34000,900,2.72,33400,34750
پارند2,صندوق س. پارند پايدار سپهر,501,50100000,50100000,10090,1,1,-10089,-99.99,1,-10089,-99.99,1,1
گوهر2,صندوق سكه طلاي كيان,500,5000000,5000000,107442,1,1,-107441,-100,1,-107441,-100,1,1
بالبر,كابل‌ البرز,495,596816,38823692800,68410,65250,64990,-3420,-5,65050,-3360,-4.91,64990,67500
سكارون,سيمان كارون,494,352367,20952385400,60300,61650,60600,300,0.5,59450,-850,-1.41,58500,61700
ساروم,سيمان‌اروميه‌,494,2233245,66783669270,30080,30690,29800,-280,-0.93,29900,-180,-0.6,29350,30690
فخاس,فولاد خراسان,493,2396747,27235954020,11350,11530,11590,240,2.11,11350,0,0,11050,11600
فولاژ,فولاد آلياژي ايران,493,3840924,41747929120,10680,10900,11000,320,3,10760,80,0.75,10660,11100
غگلستا,شير پاستوريزه پگاه گلستان,492,1650339,26372094780,16430,16780,16280,-150,-0.91,15980,-450,-2.74,15470,16780
والبر,سرمايه‌ گذاري‌ البرز(هلدينگ‌,489,3141724,19606423080,6270,6130,6280,10,0.16,6250,-20,-0.32,6130,6390
سخزر,سيمان‌ خزر,485,1789535,53183443730,29340,30540,29380,40,0.14,29720,380,1.3,28540,31150
سرود,سيمان‌شاهرود,485,1881398,51754716220,26530,26320,27760,1230,4.64,27510,980,3.69,26320,28380
غپونه,نوش پونه مشهد,481,3157670,54742023490,16550,16840,17370,820,4.95,17340,790,4.77,16840,17370
ضخود1211,اختيارخ خودرو-3250-1401/12/03,480,54032,16705364000,372,380,329,-43,-11.56,309,-63,-16.94,250,440
بفجر,فجر انرژي خليج فارس,480,2541803,53407207780,21070,21000,20970,-100,-0.47,21040,-30,-0.14,20710,21430
اتكاي,بيمه اتكايي ايرانيان,478,3203783,19752868930,6420,6320,6280,-140,-2.18,6170,-250,-3.89,6100,6400
شوينده,مديريت صنعت شوينده ت.ص.بهشهر,477,1011950,18457901510,18750,18750,18490,-260,-1.39,18240,-510,-2.72,18000,19030
شدوص,دوده‌ صنعتي‌ پارس‌,467,2700346,34773181030,12850,12980,13000,150,1.17,12880,30,0.23,12600,13190
ومهان,گروه توسعه مالي مهر آيندگان,466,5922386,33211366120,5640,5730,5600,-40,-0.71,5620,-20,-0.35,5530,5780
پشاهن,توليدي پلاستيك‌ شاهين,465,344115,23559068500,67800,69800,65850,-1950,-2.88,68450,650,0.96,65800,69800
هرمز,فولاد هرمزگان جنوب,465,2768637,36292069000,13250,13240,13100,-150,-1.13,13210,-40,-0.3,12850,13360
ضستا6003,اختيارخ شستا-765-1402/06/08,463,148078,60117289000,408,435,420,12,2.94,406,-2,-0.49,392,435
كوثر,بيمه كوثر,461,8957951,42631809162,4942,4941,4712,-230,-4.65,4759,-183,-3.7,4695,4941
غشوكو,شوكو پارس,459,3603299,33960423640,9670,9700,9380,-290,-3,9420,-250,-2.59,9380,9750
سخاش,سيمان‌خاش‌,458,418384,30322937120,71130,72000,73470,2340,3.29,72480,1350,1.9,70050,73700
مبين,مبين انرژي خليج فارس,455,1576328,50671894280,32220,31330,32050,-170,-0.53,32190,-30,-0.09,31330,32970
شخارك,پتروشيمي‌ خارك‌,455,494394,19779584820,40590,39450,40000,-590,-1.45,40470,-120,-0.3,39450,41270
وفتخار,سرمايه گذاري افتخار سهام,453,4836037,17135319925,3551,3445,3575,24,0.68,3543,-8,-0.23,3445,3654
پرديس,سرمايه گذاري پرديس,453,8975907,33839334137,3782,3900,3831,49,1.3,3770,-12,-0.32,3663,3900
تبرك,گروه كارخانجات صنعتي تبرك,452,4008304,40910698850,10250,10300,10270,20,0.2,10210,-40,-0.39,9920,10440
رانفور,خدمات‌انفورماتيك‌,449,5279124,23631100405,4527,4430,4481,-46,-1.02,4508,-19,-0.42,4376,4562
جوين,كشت و صنعت جوين,446,7018659,40256201630,5900,5770,5730,-170,-2.88,5740,-160,-2.71,5730,5840
دلر,داروسازي‌ اكسير,443,1707600,39939336920,23780,23800,23280,-500,-2.1,23390,-390,-1.64,22660,24290
هامرز,صندوق س اعتماد هامرز-ثابت,443,36384187,367737717121,10100,10107,10108,8,0.08,10107,7,0.07,10107,10108
بالاس,مهندسي ساختمان تاسيسات راه آهن,442,1807106,63226389250,36050,37100,34250,-1800,-4.99,35000,-1050,-2.91,34250,37100
شفا,سرمايه گذاري شفادارو,438,1094026,20216490840,18970,18220,18200,-770,-4.06,18480,-490,-2.58,18050,19200
وتوسم,سرمايه‌گذاري‌توسعه‌ملي‌,436,3751570,19338336610,5260,5360,5110,-150,-2.85,5150,-110,-2.09,5050,5360
وكادو,تكادو,434,1619253,30532890250,18980,19500,18780,-200,-1.05,18860,-120,-0.63,18440,19500
باران,بيمه زندگي باران,430,7800584,30139901998,3977,3900,3858,-119,-2.99,3864,-113,-2.84,3858,3925
تاصيكو,سرمايه گذاري صدرتامين,428,2996313,36581074790,12290,11900,12280,-10,-0.08,12260,-30,-0.24,11900,12340
كساوه,صنايع‌ كاشي‌ و سراميك‌ سينا,427,1074754,56574283170,52530,51430,52800,270,0.51,52640,110,0.21,51430,53960
حپترو,حمل و نقل پتروشيمي( سهامي عام,423,1004103,39334201090,41170,40160,39120,-2050,-4.98,39170,-2000,-4.86,39120,40160
تپكو,توليدتجهيزات‌سنگين‌هپكو,422,15440394,25862659950,1627,1675,1675,48,2.95,1675,48,2.95,1675,1675
ونيكي,سرمايه‌گذاري‌ ملي‌ايران‌,419,2887763,19750043970,6960,6700,6960,0,0,6940,-20,-0.29,6690,7000
وبشهر,توسعه‌ صنايع‌ بهشهر(هلدينگ,417,4377817,31907752700,7470,7250,7300,-170,-2.28,7340,-130,-1.74,7130,7470
غبهنوش,بهنوش‌ ايران‌,417,364568,20908207780,58120,58000,57310,-810,-1.39,57350,-770,-1.32,56500,59190
ضسپا1207,اختيارخ خساپا-2400-1401/12/10,416,69267,15415071000,234,280,253,19,8.12,223,-11,-4.7,170,280
داسوه,داروسازي‌ اسوه‌,416,1391768,65316841680,47310,47900,47900,590,1.25,46930,-380,-0.8,45300,48000
تپولا,مهندسي مرآت پولاد,412,1719547,33972587600,20260,19880,20300,40,0.2,19760,-500,-2.47,19660,20400
وسرمد,بيمه  سرمد,412,9686979,16762475650,1782,1729,1729,-53,-2.97,1730,-52,-2.92,1729,1799
بمپنا,توليد برق عسلويه  مپنا,406,3469768,22434376620,6610,6500,6590,-20,-0.3,6470,-140,-2.12,6360,6720
سبجنو,سيمان‌ بجنورد,404,630198,27465396420,43270,45200,43890,620,1.43,43580,310,0.72,42770,45200
سباقر,سيمان باقران,399,3914237,57886482790,14370,14800,14800,430,2.99,14790,420,2.92,14600,14800
ضسپا1204,اختيارخ خساپا-1900-1401/12/10,397,90208,49820323000,501,529,654,153,30.54,552,51,10.18,446,685
دپارس,پارس‌ دارو,392,1529493,61326334590,42020,41190,40010,-2010,-4.78,40100,-1920,-4.57,39920,41860
ركيش,كارت اعتباري ايران كيش,390,4867638,15291828859,3188,3124,3132,-56,-1.76,3142,-46,-1.44,3067,3255
تابا,تابان نيرو سپاهان,389,1247719,31765708300,26100,26200,25400,-700,-2.68,25450,-650,-2.49,25350,26650
فروسيل,فروسيليسيم خمين,389,3274517,59813386130,18060,17840,18260,200,1.11,18270,210,1.16,17200,18800
دابور,داروسازي‌ ابوريحان‌,386,1417286,27559175260,19850,19610,19500,-350,-1.76,19450,-400,-2.02,19050,19900
واميد,گروه مديريت سرمايه گذاري اميد,381,2357487,30913648860,13260,13100,13000,-260,-1.96,13220,-40,-0.3,12910,13290
كپرور,فرآوري زغال سنگ پروده طبس,380,2102859,20345657690,9500,9590,9780,280,2.95,9680,180,1.89,9390,9950
زيتون,صندوق س زيتون نماد پايا- مختلط,379,1603075,23008923780,14360,14340,14400,40,0.28,14350,-10,-0.07,14240,14460
غبهار,كشت وصنعت بهاران گلبهار خراسان,378,2347006,38420746210,15910,16360,16380,470,2.95,16370,460,2.89,15980,16380
ضستا1206,اختيارخ شستا-1100-1401/12/03,375,139693,11204915000,88,100,84,-4,-4.55,80,-8,-9.09,66,100
ضخاو1207,اختيارخ وخاور-5000-1401/12/01,372,107310,8198988000,112,155,100,-12,-10.71,76,-36,-32.14,60,155
كاج,صندوق س. نوع دوم نو ويرا -د,372,14941477,158190989606,10581,10588,10588,7,0.07,10587,6,0.06,10587,10588
بهپاك,صنعتي بهپاك,371,4146938,29074468550,7040,6900,6990,-50,-0.71,7010,-30,-0.43,6810,7120
دروز,داروسازي‌ روزدارو,369,1908150,41474030810,21020,20200,22070,1050,5,21740,720,3.43,20200,22070
كلوند,كاشي‌ الوند,368,1063510,36292170050,34350,34220,34080,-270,-0.79,34120,-230,-0.67,33330,35240
شاملا,معدني‌ املاح‌  ايران‌,365,2421783,28331197110,11870,11820,11910,40,0.34,11700,-170,-1.43,11320,12080
شجم,صنايع پتروشيمي تخت جمشيد,365,2053938,17728757830,8880,8870,8590,-290,-3.27,8630,-250,-2.82,8450,8870
مدير,ص.س.مديريت ثروت ص.بازنشستگي-س,361,2625253,31881987858,12065,12150,12214,149,1.23,12144,79,0.65,12000,12329
ثشرق,سرمايه گذاري مسكن شمال شرق,359,5708908,27324627319,4941,4950,4880,-61,-1.23,4786,-155,-3.14,4695,5130
فردا,صندوق س آواي فرداي زاگرس-ثابت,359,13329795,200995084711,15068,15078,15078,10,0.07,15079,11,0.07,15078,15080
كشرق,صنعتي و معدني شمال شرق شاهرود,356,173832,19553666900,110200,115100,113150,2950,2.68,112500,2300,2.09,109700,115100
قشهد,شهد,355,1147895,18714218700,16280,16600,16310,30,0.18,16300,20,0.12,15810,16790
واتي,سرمايه‌ گذاري‌ آتيه‌ دماوند,354,2951704,31188712130,10620,10510,10620,0,0,10570,-50,-0.47,10300,10800
خوساز,محورسازان‌ايران‌خودرو,354,3876077,88955967150,21860,22950,22950,1090,4.99,22950,1090,4.99,22950,22950
غگلپا,شير پاستوريزه پگاه گلپايگان,352,307089,19213235100,63150,63500,62800,-350,-0.55,62550,-600,-0.95,61600,64200
فنفت,صنايع تجهيزات نفت,350,1405870,51033081000,35250,36300,36300,1050,2.98,36300,1050,2.98,36300,36300
ثاژن,سخت آژند,350,2634511,13173261970,5080,5080,5010,-70,-1.38,5000,-80,-1.57,4980,5100
وسديد,گروه ‌صنعتي‌سديد,348,12783826,34273437506,2603,2681,2681,78,3,2681,78,3,2681,2681
جم پيلن,پتروشيمي جم پيلن,347,479525,67633607050,142080,139100,143200,1120,0.79,141370,-710,-0.5,138500,143200
ما,بيمه  ما,346,3585579,11937675889,3370,3490,3305,-65,-1.93,3338,-32,-0.95,3240,3490
ضستا0105,اختيارخ شستا-1100-1402/01/09,344,143850,13026560000,111,120,102,-9,-8.11,91,-20,-18.02,80,120
ثعتما,س. ساختماني اعتماد گستر,336,1086759,14983620110,13690,13800,13840,150,1.1,13790,100,0.73,13530,14030
بايكا,كارخانجات كابلسازي ‌ايران‌,335,1029711,18264535980,18200,17660,17980,-220,-1.21,17740,-460,-2.53,17660,18690
حبندرح,ح.دريايي وكشتيراني خط دريابندر,333,1091506,11463708930,10810,10700,10500,-310,-2.87,10500,-310,-2.87,10490,10720
سصوفي,سيمان‌ صوفيان‌,332,1079510,26153111960,24250,24020,24700,450,1.86,24230,-20,-0.08,23000,24960
تصميم,صندوق س با درآمد ثابت تصميم,326,4453406,101737153407,22831,22845,22846,15,0.07,22845,14,0.06,22844,22846
ثجوان,تامين مسكن جوانان,325,3220312,16279323740,5200,5130,5050,-150,-2.88,5060,-140,-2.69,5050,5160
سغدير,توسعه سرمايه و صنعت غدير,325,3050503,21731609680,6980,7160,7060,80,1.15,7120,140,2.01,6900,7230
كاريس,صندوق س.سپند كاريزما-س,324,2246279,39173460782,17392,17485,17587,195,1.12,17439,47,0.27,17200,17588
ثزاگرس,سرمايه گذاري توسعه عمران زاگرس,322,1290802,38951744100,30350,30000,31250,900,2.97,30200,-150,-0.49,29450,31250
ولتجار,واسپاري تجار ايرانيان,320,9787172,26064971483,2738,2660,2656,-82,-2.99,2663,-75,-2.74,2656,2740
وتوشه,سرمايه‌ گذاري‌ پارس‌ توشه‌,320,5202497,30246978650,5760,5420,5830,70,1.22,5810,50,0.87,5420,5960
وآفر,سرمايه گذاري ارزش آفرينان,319,1550234,41061420450,27250,27700,26450,-800,-2.94,26500,-750,-2.75,26450,27700
تايرا,تراكتورسازي‌ايران‌,317,703694,19700141890,28430,28400,28210,-220,-0.77,28190,-240,-0.84,27370,28890
فراز,صندوق س.سهام فراز داريك-س,316,3198385,58210665466,18072,18290,18300,228,1.26,18200,128,0.71,18072,18300
وآفري,بيمه كارآفرين,315,5046370,14476844114,2795,2751,2876,81,2.9,2869,74,2.65,2751,2878
ثتران,سرمايه گذاري مسكن تهران,314,15460800,74258222400,4575,4803,4803,228,4.98,4803,228,4.98,4803,4803
فبيرا,بسته‌ بندي‌ ايران‌,312,9119294,18590095559,2098,2080,2036,-62,-2.96,2039,-59,-2.81,2036,2097
نيرو,نيرو سرمايه,311,833672,26686578850,32750,32750,33000,250,0.76,32000,-750,-2.29,31800,33400
حسينا,توسعه خدمات دريايي وبندري سينا,304,1597207,17347575760,10940,11000,10900,-40,-0.37,10860,-80,-0.73,10710,11050
كساپا,سايپاشيشه‌,303,1932973,49767572730,24620,25850,25000,380,1.54,25750,1130,4.59,23850,25850
غمهرا,توليدي‌مهرام‌,298,2385278,18758233800,7720,7420,8100,380,4.92,7860,140,1.81,7420,8100
واعتبار,سرمايه گذاري اعتبار ايران,296,7750471,22816330198,2912,2973,3000,88,3.02,2944,32,1.1,2857,3015
آساميد,صندوق س.مشترك آسمان اميد -د,294,20681272,353042776012,17058,17069,17071,13,0.08,17071,13,0.08,17069,17071
گنج2,صندوق س. طلا كيميا زرين كاردان,292,2901998,2901998,18605,1,1,-18604,-99.99,1,-18604,-99.99,1,1
حخزر,كشتيراني درياي خزر,291,1083928,30765163250,28850,28150,28500,-350,-1.21,28400,-450,-1.56,27800,29000
شتولي,تولي‌پرس‌,290,496137,8096374410,16050,16370,16370,320,1.99,16320,270,1.68,15730,16370
وارس,سرمايه گذاري ارس صبا,290,1420965,25155976690,17250,17730,17760,510,2.96,17700,450,2.61,17010,17760
قتربت,قند تربت حيدريه,288,755888,14878945710,19890,19910,19750,-140,-0.7,19680,-210,-1.06,19300,20230
سفاسي,شركت فارسيت اهواز,287,3822145,15383442040,4144,4064,4020,-124,-2.99,4025,-119,-2.87,4020,4118
دفرا,فرآورده‌هاي‌ تزريقي‌ ايران‌,284,797313,21916480970,27660,27270,27500,-160,-0.58,27490,-170,-0.61,26400,28270
گنج,صندوق س. طلا كيميا زرين كاردان,283,1289084,25643784017,18605,19500,19901,1296,6.97,19893,1288,6.92,19500,20375
آوند2,صندوق س. آوند مفيد-د,280,28000000,28000000,11032,1,1,-11031,-99.99,1,-11031,-99.99,1,1
فاهواز,نورد و لوله اهواز,280,3253067,14550206604,4518,4513,4456,-62,-1.37,4473,-45,-1,4428,4583
ضستا1106,اختيارخ شستا-1100-1401/11/05,278,100458,1272209000,20,22,10,-10,-50,13,-7,-35,7,24
زعف0210پ20,زعفران0210نگين وحدت جام(پ),275,240721,76607289178,302273,315000,319000,16727,5.53,318241,15968,5.28,314101,320352
سنوين,سرمايه گذاري اقتصاد نوين,273,2095016,12224037470,5700,5870,5870,170,2.98,5830,130,2.28,5530,5870
ضجار2022,اختيارخ وتجارت-1500-1402/02/20,272,30686,17588898000,589,599,564,-25,-4.24,573,-16,-2.72,510,624
شرانل,نفت ايرانول,271,404622,25046041800,61350,61300,61900,550,0.9,61650,300,0.49,61000,62300
ارزش,صندوق س ارزش آفرين بيدار-سهام,269,1277092,17738257970,13820,13800,13960,140,1.01,13890,70,0.51,13750,13970
پلاست,كارخانجات توليدي پلاستيران,268,1437824,16808286090,11960,11800,11610,-350,-2.93,11690,-270,-2.26,11610,11830
سفارود,كارخانه فارسيت درود,265,1099804,14685521640,13610,13370,13340,-270,-1.98,13350,-260,-1.91,13340,13820
سخوز,سيمان خوزستان,265,3615200,120535131440,32890,32380,34000,1110,3.37,33340,450,1.37,32110,34140
كاسپين,داروسازي كاسپين تامين,255,949973,15000855480,16090,15700,15890,-200,-1.24,15790,-300,-1.86,15410,16410
تسه1400,امتيازتسهيلات مسكن سال1400,253,3465,4193501903,1169537,1203624,1228013,58476,5,1210246,40709,3.48,1190000,1228013
كيا,كيا الكترود شرق,252,5888217,51351645240,8307,8715,8722,415,5,8721,414,4.98,8680,8722
غنيلي,مجتمع توليدي نيلي صنعت كرمان,248,5992000,31122448000,4947,5194,5194,247,4.99,5194,247,4.99,5194,5194
آوا,صندوق س.سهام آواي معيار-س,247,1791008,17246084849,9335,9488,9846,511,5.47,9629,294,3.15,9421,9846
وجامي,سرمايه گذاري جامي,245,3555286,14273515584,4119,4180,3996,-123,-2.99,4015,-104,-2.52,3996,4180
لوتوس,تامين سرمايه لوتوس پارسيان,244,1934298,9605332691,4992,4900,5000,8,0.16,4987,-5,-0.1,4900,5035
گوهران,سرمايه گذاري توسعه گوهران اميد,242,985835,4820515333,4909,4944,4908,-1,-0.02,4903,-6,-0.12,4850,4944
ماني,صندوق س. با درآمد ثابت ماني,240,9761490,130666900720,13379,13386,13386,7,0.05,13386,7,0.05,13385,13387
سيدكو,سرمايه گذاري توسعه صنايع سيمان,240,1691049,17061317140,10060,10360,10270,210,2.09,10080,20,0.2,9770,10500
تسه0011,امتيازتسهيلات مسكن بهمن 1400,238,2323,2807063671,1192175,1175001,1216000,23825,2,1208379,16204,1.36,1175001,1251783
وفتخارح,ح . سرمايه گذاري افتخار سهام,238,5897383,10651202731,1775,1828,1828,53,2.99,1806,31,1.75,1741,1828
سدشت,صنايع سيمان دشتستان,237,490782,15814503720,30870,31990,32410,1540,4.99,32180,1310,4.24,31250,32410
وسنا,سرمايه گذاري نيروگاهي ايران,236,2111855,19471754430,9500,9220,9220,-280,-2.95,9220,-280,-2.95,9220,9450
جم,پتروشيمي جم,235,942031,35509303380,37320,38900,38080,760,2.04,37460,140,0.38,37000,38900
رايكا,صندوق س نوع دوم رايكا- ثابت	,233,9990981,106051517642,10606,10614,10615,9,0.08,10615,9,0.08,10614,10615
سهگمت,سيمان‌هگمتان‌,233,552752,23079979340,39600,39000,42000,2400,6.06,41750,2150,5.43,39000,42370
فغدير,آهن و فولاد غدير ايرانيان,230,828295,13330422670,16280,16590,16300,20,0.12,16090,-190,-1.17,15760,16590
سمازن,سيمان‌مازندران‌,226,991187,16332418360,16580,15810,16590,10,0.06,16480,-100,-0.6,15810,16740
حپارسا,توسعه حمل و نقل ريلي پارسيان,225,880429,43810401800,48750,50000,50200,1450,2.97,49750,1000,2.05,47700,50300
ضهرم1205,اختيارخ اهرم-11000-1401/12/22,222,5863,20830765000,3709,3980,3900,191,5.15,3553,-156,-4.21,3000,4150
غناب,روغن‌ نباتي‌ ناب,221,38925,25862723100,652200,667900,658000,5800,0.89,664400,12200,1.87,653000,671500
درازي,پخش رازي,221,1049393,26351291150,25300,24750,25250,-50,-0.2,25100,-200,-0.79,24750,26800
كگهر,سنگ آهن گهرزمين,218,143519,6417962700,45200,45200,44700,-500,-1.11,45150,-50,-0.11,44350,45700
هجرت,پخش هجرت,212,863553,26167367250,30400,31100,29950,-450,-1.48,30300,-100,-0.33,29800,31400
كصدف,كاشي صدف سرام استقلال آباده,212,594348,15614354550,26200,26400,26550,350,1.34,26250,50,0.19,25650,26900
قپيرا,فرآورده‌هاي‌غدايي‌وقندپيرانشهر,211,919717,8269499720,9220,8910,8980,-240,-2.6,9090,-130,-1.41,8840,9300
تسه0009,امتيازتسهيلات مسكن آذر 1400,209,2516,3067185401,1194802,1151003,1245990,51188,4.28,1219072,24270,2.03,1151001,1254542
سهرمز,سيمان‌هرمزگان‌,208,267017,7362603810,27950,27480,27750,-200,-0.72,27760,-190,-0.68,27430,28300
زعف0210پ10,زعفران0210نگين طلاي سرخ(پ),204,894461,286542370272,320629,320352,320352,-277,-0.09,320352,-277,-0.09,320352,320352
لبخند2,صندوق س. لبخند فارابي-د,200,20000000,20000000,10894,1,1,-10893,-99.99,1,-10893,-99.99,1,1
خبنيان,بنيان ديزل,200,1246995,12844048500,10840,10300,10300,-540,-4.98,10830,-10,-0.09,10300,10300
سقاين,سيمان‌ قائن‌,200,190347,9982966590,52630,52570,52600,-30,-0.06,52510,-120,-0.23,51800,53490
گوهرانح,ح . س. توسعه گوهران اميد,200,2385677,6425652021,2750,2820,2651,-99,-3.6,2693,-57,-2.07,2632,2820
ضسپا1208,اختيارخ خساپا-2600-1401/12/10,198,40624,6316084000,192,229,185,-7,-3.65,155,-37,-19.27,81,229
پاداش,صندوق س. ارزش پاداش-د,198,46901708,480963153582,10248,10254,10255,7,0.07,10255,7,0.07,10254,10255
ضشنا1106,اختيارخ شپنا-7000-1401/11/19,198,11862,10922160000,947,947,909,-38,-4.01,921,-26,-2.75,830,990
سپ,پرداخت الكترونيك سامان كيش,197,344683,5731892330,16990,16830,16630,-360,-2.12,16960,-30,-0.18,16520,16970
شكف,كف,197,169530,6952693300,41700,41550,40900,-800,-1.92,41000,-700,-1.68,40900,42300
وصندوق,سرمايه‌گذاري‌صندوق‌بازنشستگي‌,196,3536418,52071384020,14830,15030,14970,140,0.94,14780,-50,-0.34,14660,15030
سپيدما,صندوق س. سپيد دماوند-د,193,23003383,330964119050,14379,14387,14388,9,0.06,14388,9,0.06,14387,14388
آساس,صندوق س.آسمان آرماني سهام-س,191,155382,39276367196,252390,249480,254999,2609,1.03,252773,383,0.15,249480,254999
كاردان,صندوق س تجارت شاخصي كاردان,190,154041,38597569250,250990,253000,253050,2060,0.82,250570,-420,-0.17,248000,253480
كازرو,پتروشيمي كازرون,188,3588484,43374125080,12260,12150,12380,120,0.98,12090,-170,-1.39,11920,12510
پسهند,صنايع‌ لاستيكي‌  سهند,187,175956,6784308690,39070,39480,38690,-380,-0.97,38840,-230,-0.59,37800,39600
سمتاز,سيمان ممتازان كرمان,186,1221711,44766265100,35600,36650,36650,1050,2.95,36650,1050,2.95,35900,36650
دهدشت,صنايع پتروشيمي دهدشت,185,2317436,26512709270,11760,11420,11410,-350,-2.98,11440,-320,-2.72,11410,11640
ضخود1206,اختيارخ خودرو-2200-1401/12/03,184,24660,25165423000,1104,1080,1050,-54,-4.89,1020,-84,-7.61,902,1110
كخاك,صنايع‌خاك‌چيني‌ايران‌,184,559491,8243267650,15010,15000,14820,-190,-1.27,14900,-110,-0.73,14580,15100
ويسا,سرمايه گذاري ايساتيس پويا,182,1179320,7298715980,6370,6240,6180,-190,-2.98,6230,-140,-2.2,6180,6360
زعف0210پ05,زعفران0210نگين زرين(پ),177,126871,40261185943,304677,310000,319500,14823,4.87,317340,12663,4.16,309000,319900
سلام,صندوق س سلام فارابي-سهام,177,1319510,14711998610,11150,11250,11250,100,0.9,11150,0,0,10970,11320
گشان,توسعه بين المللي پديده شانديز,177,1065981,48129042150,43850,45150,45150,1300,2.96,45150,1300,2.96,45150,45150
دشيري,شيرين دارو,175,141018,15368228100,105850,108900,109000,3150,2.98,109000,3150,2.98,107300,109000
رشد,صندوق س.رشد پايدار آبان-د,174,2915312,29210992036,10015,10017,10021,6,0.06,10020,5,0.05,10017,10021
بنيرو,نيروترانس‌,170,1386587,4361972993,3205,3229,3134,-71,-2.22,3187,-18,-0.56,3100,3235
ضخود1208,اختيارخ خودرو-2600-1401/12/03,170,12392,8060231000,779,800,754,-25,-3.21,650,-129,-16.56,550,810
سامانح,ح. بانك سامان,169,4192564,6418815484,1487,1531,1531,44,2.96,1531,44,2.96,1531,1531
اوصتا,صندوق انديشه ورزان صباتامين -د,166,14334908,374937311249,26138,26155,26155,17,0.07,26156,18,0.07,26155,26156
حگردش,ريل گردش ايرانيان,166,5590874,31420711880,5460,5620,5620,160,2.93,5620,160,2.93,5620,5620
شساخت,مهندسي و ساختمان صنايع نفت,164,381446,14378728350,38550,38000,38000,-550,-1.43,38250,-300,-0.78,37400,38750
مارون,پتروشيمي مارون,163,51763,9500173000,178300,183500,182950,4650,2.61,178800,500,0.28,182000,185400
تسه0010,امتيازتسهيلات مسكن دي1400,163,1629,1968887716,1203546,1143399,1211000,7454,0.62,1208648,5102,0.42,1143399,1250000
اگ020719,گام بانك صادرات ايران0207,161,666511,543176344347,813792,816199,814917,1125,0.14,814955,1163,0.14,814917,816250
ضسپا1209,اختيارخ خساپا-2800-1401/12/10,160,45886,4864860000,146,149,140,-6,-4.11,106,-40,-27.4,60,159
وامير,گروه صنعتي و معدني امير,159,100694,31493795000,303700,312800,312800,9100,3,312750,9050,2.98,303800,312800
انار,صندوق س.انارنماد ارزش-درسهام,157,654791,8756185880,13480,13400,13460,-20,-0.15,13370,-110,-0.82,13260,13480
ضسپا1210,اختيارخ خساپا-3000-1401/12/10,155,40977,3583985000,116,159,110,-6,-5.17,87,-29,-25,52,159
فجوش,جوش‌ و اكسيژن‌ ايران‌,152,2057320,4783269000,2396,2325,2325,-71,-2.96,2389,-7,-0.29,2325,2325
ضستا1107,اختيارخ شستا-1200-1401/11/05,152,68418,157148000,6,3,2,-4,-66.67,2,-4,-66.67,1,4
شكبير,پتروشيمي اميركبير,148,337464,27511750400,84000,82100,81500,-2500,-2.98,83300,-700,-0.83,81500,82800
نخل,صندوق س.خليج فارس-د,148,14542324,145611609719,10007,10012,10013,6,0.06,10013,6,0.06,10012,10014
فبستم,صنايع ‌بسته‌بندي‌ مشهد,146,489802,6574310060,13830,13450,13420,-410,-2.96,13550,-280,-2.02,13420,13450
ضخود3072,اختيارخ خودرو-3500-1402/03/03,145,26748,13485263000,604,450,550,-54,-8.94,504,-100,-16.56,450,639
سجام,مجتمع سيمان غرب آسيا,142,3300163,7590007760,2312,2320,2291,-21,-0.91,2303,-9,-0.39,2280,2337
تسه0006,امتيازتسهيلات مسكن شهريور1400,141,1995,2402067013,1179744,1170001,1208002,28258,2.4,1204044,24300,2.06,1170001,1238731
ضستا1203,اختيارخ شستا-800-1401/12/03,139,27020,6734730000,253,260,265,12,4.74,249,-4,-1.58,227,270
ضستا0106,اختيارخ شستا-1200-1402/01/09,138,17160,1505270000,102,107,97,-5,-4.9,88,-14,-13.73,70,107
وسالت,بانك قرض الحسنه رسالت,137,135446,9278051000,70600,68500,68500,-2100,-2.97,68500,-2100,-2.97,68500,68500
وپخش,داروپخش‌ (هلدينگ‌,135,403028,16121368800,40140,41380,40470,330,0.82,40100,-40,-0.1,39320,41380
ضخود1212,اختيارخ خودرو-3500-1401/12/03,134,22784,5133207000,296,330,240,-56,-18.92,225,-71,-23.99,180,330
حاريا,كشتيراني آريا,133,1163657,6790286210,5940,5830,5830,-110,-1.85,5840,-100,-1.68,5830,5950
تسه9912,امتياز تسهيلات مسكن اسفند99,132,2252,2848324361,1220328,1239999,1260029,39701,3.25,1264798,44470,3.64,1239999,1281343
تسه9911,امتياز تسهيلات مسكن بهمن99,131,1960,2422169358,1194875,1209000,1242059,47184,3.95,1235801,40926,3.43,1208998,1244994
لخانه,لوازم‌ خانگي‌ پارس‌,131,1013089,20069093090,19240,19810,19810,570,2.96,19810,570,2.96,19800,19810
گنجين2,صندوق س. گنجينه يكم آويد-د,129,12843932,12843932,17508,1,1,-17507,-99.99,1,-17507,-99.99,1,1
وامين,س. امين توان آفرين ساز,129,338245,3936961200,11320,11400,11650,330,2.92,11350,30,0.27,11400,11650
سكرما,سيمان‌ كرمان‌,129,457934,8130890610,17710,17710,18000,290,1.64,17730,20,0.11,17400,18020
سغرب,سيمان‌غرب‌,128,458943,11416332170,24720,24500,25000,280,1.13,24840,120,0.49,24500,25020
اخزا101,اسناد خزانه-م1بودجه01-040326,127,593300,328444280000,552460,553000,553310,850,0.15,553590,1130,0.2,552420,554000
كارين2,صندوق س نگين سامان-ثابت,127,12688581,12688581,10006,1,1,-10005,-99.99,1,-10005,-99.99,1,1
فسا,پتروشيمي فسا,125,4592074,4408391040,933,960,960,27,2.89,944,11,1.18,960,960
گپارس,امور رفاهي كارگزاران پارس,125,63191,8680370700,133450,137350,137450,4000,3,136700,3250,2.44,129600,137450
زعف0210پ18,زعفران0210نگين بهرامن(پ),124,74999,23954779729,301388,307000,320350,18962,6.29,319401,18013,5.98,307000,320352
كيان2,صندوق س. با درآمد ثابت كيان,123,12300000,12300000,39933,1,1,-39932,-100,1,-39932,-100,1,1
حگهر,حمل و نقل گهرترابر سيرجان,122,622887,6984413270,11370,11210,11290,-80,-0.7,11210,-160,-1.41,10850,11400
شپاس,نفت پاسارگاد,122,1689375,33719925000,19010,19960,19960,950,5,19960,950,5,19960,19960
دكيمي,كيميدارو,122,1427384,51651679260,33830,36190,35180,1350,3.99,36190,2360,6.98,35170,36190
ولقمان,سرمايه گذاري لقمان,121,1230162,5693143404,4704,4610,4581,-123,-2.61,4660,-44,-0.94,4563,4760
صنم,ص.س.صندوق در صندوق صنم,119,807398,10778033425,13124,13300,13410,286,2.18,13349,225,1.71,13157,13520
كباده,توليد خاك نسوزاستقلال آباده,117,307753,5303244760,17500,17050,17220,-280,-1.6,17350,-150,-0.86,17000,17790
دريا,صندوق س درياي آبي فيروزه-سهام,117,460701,5283958420,11630,11790,11710,80,0.69,11470,-160,-1.38,11320,11790
تسه0007,امتيازتسهيلات مسكن مهر1400,116,922,1113356070,1182389,1180001,1210013,27624,2.34,1207544,25155,2.13,1180001,1241508
تشتاد,صنايع توليدي اشتاد ايران‌,116,1103104,6508313600,5730,5900,5900,170,2.97,5840,110,1.92,5900,5900
تسه0008,امتيازتسهيلات مسكن آبان1400,115,804,971956725,1201250,1160000,1210000,8750,0.73,1208901,7651,0.64,1160000,1260000
سخند,صندوق س.سپهرخبرگان نفت-د,115,422657,3808066315,9002,8994,9057,55,0.61,9010,8,0.09,8994,9070
كفرآور,فرآورده هاي سيمان شرق,114,1691065,25332153700,14550,14980,14980,430,2.96,14980,430,2.96,14980,14980
ضستا1204,اختيارخ شستا-900-1401/12/03,112,21153,3629408000,168,180,170,2,1.19,172,4,2.38,160,193
آفاق,صندوق س نوع دوم افق آتي-ثابت,112,2948726,29527042570,10007,10014,10014,7,0.07,10013,6,0.06,10013,10014
گنگين,اقتصادي نگين گردشگري ايرانيان,111,1314428,49201019550,37450,36350,36350,-1100,-2.94,37450,0,0,36350,37850
تسه0002,امتيازتسهيلاتمسكن ارديبهشت1400,110,1668,2126099770,1232247,1230001,1277001,44754,3.63,1274640,42393,3.44,1230001,1293859
فيروزه,صندوق شاخص30 شركت فيروزه- سهام,109,263271,5505306350,20940,21340,21110,170,0.81,20910,-30,-0.14,20600,21340
سيستم,همكاران سيستم,108,1351692,10192613470,7660,7670,7570,-90,-1.17,7620,-40,-0.52,7430,7820
آرمان,بيمه آرمان,106,1113591,5768061060,5290,5150,5300,10,0.19,5220,-70,-1.32,5140,5300
وكار,بانك‌ كارآفرين‌,104,1236521,4046008707,3248,3270,3271,23,0.71,3250,2,0.06,3270,3290
فماك,ماداكتو استيل كرد,102,1990218,31917773446,16868,16025,16025,-843,-5,16037,-831,-4.93,16025,17711
شگامرن,مجتمع پترو صنعت گامرون,100,73578,26872145880,347829,365000,365220,17391,5,365220,17391,5,365000,365220
ضستا6010,اختيارخ شستا-1465-1402/06/08,100,26238,3806494000,146,170,150,4,2.74,145,-1,-0.68,101,170
ضجار2027,اختيارخ وتجارت-2000-1402/02/20,98,15094,3846696000,312,331,299,-13,-4.17,255,-57,-18.27,240,331
تسه0005,امتيازتسهيلات مسكن مرداد 1400,98,1029,1243309948,1186458,1160000,1212001,25543,2.15,1208270,21812,1.84,1160000,1245755
ممسني,پتروشيمي ممسني,96,1584839,19896478350,12920,12750,12570,-350,-2.71,12550,-370,-2.86,12540,12790
شسم,توليد سموم‌ علف‌ كش,96,15492,4812587800,304600,310650,310650,6050,1.99,310300,5700,1.87,310550,310650
تسه0003,امتيازتسهيلات مسكن خرداد1400,95,791,994538222,1209105,1230011,1269560,60455,5,1257318,48213,3.99,1230011,1269560
زرين,صندوق س. سهام زرين كوروش-س,95,1507875,22446128502,14936,14835,14929,-7,-0.05,14886,-50,-0.33,14504,14990
زعف0210پ16,زعفران0210نگين بيرجند(پ),95,80072,25367769085,300219,300500,317998,17779,5.92,316812,16593,5.53,300500,320352
تاتمس,كارخانجات صنعتي وتوليدي اتمسفر,94,31733,3586912800,113750,115950,114000,250,0.22,113250,-500,-0.44,111700,115950
ثنظام,س. ساختماني نظام مهندسي ايران,94,421962,21665276750,49950,50450,51400,1450,2.9,51350,1400,2.8,50400,51400
ساروج,بين المللي ساروج بوشهر,94,132211,3460622850,26100,26800,26350,250,0.96,26150,50,0.19,26000,26800
ضترا3023,اختيارخ شتران-3750-1402/03/28,93,20060,23293671000,1700,1151,1250,-450,-26.47,1161,-539,-31.71,1150,1251
هامرز2,صندوق س اعتماد هامرز-ثابت,93,9300000,9300000,10100,1,1,-10099,-99.99,1,-10099,-99.99,1,1
ضدي202,اختيارخ دي-550-14020217,92,9631,3502392000,391,400,399,8,2.05,364,-27,-6.91,330,429
حرهشا,رهشاد سپاهان (سهامي عام,92,86063,9008690500,101800,104050,104850,3050,3,104700,2900,2.85,104000,104850
ضخود1210,اختيارخ خودرو-3000-1401/12/03,92,12099,4947583000,499,480,430,-69,-13.83,409,-90,-18.04,365,480
آينده,بازرگاني آينده سازان بهشت پارس,91,447993,3691462320,8490,8240,8240,-250,-2.94,8240,-250,-2.94,8240,8240
تسه0001,امتيازتسهيلات مسكن فروردين1400,91,1187,1513739057,1229724,1245001,1275000,45276,3.68,1275265,45541,3.7,1245001,1291210
اخزا002,اسنادخزانه-م2بودجه00-031024,90,245800,151880370000,617440,617000,618010,570,0.09,617900,460,0.07,606410,619000
تسه0004,امتيازتسهيلات مسكن تير1400,88,627,763427277,1193042,1158810,1210000,16958,1.42,1217587,24545,2.06,1158810,1252694
ضستا1207,اختيارخ شستا-1200-1401/12/03,88,16500,773414000,52,60,44,-8,-15.38,47,-5,-9.62,37,60
طخود1207,اختيارف خودرو-2400-1401/12/03,88,23012,715194000,44,44,25,-19,-43.18,31,-13,-29.55,21,45
فخاسح,ح . فولاد خراسان,87,341450,3327710140,9990,9900,9710,-280,-2.8,9750,-240,-2.4,9270,9900
ضصاد1124,اختيارخ وبصادر-1400-1401/11/19,85,11311,5517743000,519,420,538,19,3.66,488,-31,-5.97,420,550
ضجار2020,اختيارخ وتجارت-1300-1402/02/20,84,10058,6686207000,694,625,695,1,0.14,665,-29,-4.18,625,725
زعف0210پ09,زعفران0210نگين نوين(پ)	,82,51967,16467451561,301414,309000,317000,15586,5.17,316883,15469,5.13,308999,320352
كهرام,توليدي گرانيت بهسرام,80,67326,3809832650,57700,57000,56550,-1150,-1.99,56800,-900,-1.56,56550,57050
ثاصفا,شركت‌ ساختمان‌ اصفهان‌,80,253451,4083095610,15650,16110,16110,460,2.94,15830,180,1.15,16110,16110
قاروم,قند اروميه,77,11171,1478630950,133800,136000,131150,-2650,-1.98,133550,-250,-0.19,131150,136450
خاتم,صندوق س خاتم ايساتيس پويا-ثابت,77,1218065,18757617577,15390,15399,15399,9,0.06,15400,10,0.06,15399,15401
ددام,داروسازي زاگرس فارمد پارس,75,470017,5085583940,10310,10820,10820,510,4.95,10470,160,1.55,10820,10820
ساحل,صندوق س.اوراق دولت خليج فارس-د,74,4569334,50179593371,10974,10982,10982,8,0.07,10982,8,0.07,10981,10982
ضجار2026,اختيارخ وتجارت-1900-1402/02/20,73,15379,4688930000,343,311,330,-13,-3.79,305,-38,-11.08,280,360
شزنگ,تجهيزنيروي‌زنگان‌,73,67580,4882655000,70850,72250,72250,1400,1.98,72150,1300,1.83,72250,72250
برن0204پ01,برنج طارم0204تجارت مازندران(پ),73,4830,3978516384,831776,832500,815000,-16776,-2.02,823709,-8067,-0.97,810000,832500
ولانا,شركت ليزينگ آريا دانا,71,837511,19974637350,23200,23850,23850,650,2.8,23850,650,2.8,23850,23850
ضخود1204,اختيارخ خودرو-1900-1401/12/03,70,19201,24233565000,1343,1385,1299,-44,-3.28,1262,-81,-6.03,1110,1385
ضخود1207,اختيارخ خودرو-2400-1401/12/03,69,5083,4166941000,897,910,928,31,3.46,820,-77,-8.58,755,970
دارا,صندوق س. دارا الگوريتم-د,68,11273723,112860501510,10005,10011,10010,5,0.05,10011,6,0.06,10010,10011
ترمه,صندوق سرمايه گذاري ترمه-سهام	,68,85931,919212570,10770,10650,10670,-100,-0.93,10700,-70,-0.65,10620,10990
فردا2,صندوق س آواي فرداي زاگرس-ثابت,68,66740777,66740777,15068,1,1,-15067,-99.99,1,-15067,-99.99,1,1
وشمال,س. چشم انداز توسعه شمال,67,161545,3432831250,20850,21250,21250,400,1.92,21100,250,1.2,21250,21250
ضستا1105,اختيارخ شستا-1000-1401/11/05,67,7963,484372000,77,99,83,6,7.79,61,-16,-20.78,42,99
فسديد,لوله‌وتجهيزات‌ سديد - ورشكسته,66,62553,3960468650,62850,63450,63450,600,0.95,63300,450,0.72,62850,63450
تكنو,تكنوتار,65,860038,9434616860,10450,10970,10970,520,4.98,10750,300,2.87,10970,10970
يارا,صندوق س. آريا-د,62,11461497,146524058477,12776,12785,12785,9,0.07,12784,8,0.06,12784,12785
اخزا005,اسنادخزانه-م5بودجه00-030626,62,116200,77761957000,668850,667170,669220,370,0.06,669210,360,0.05,666860,670000
دسينا,داروسازي‌ سينا,62,1279334,12793340000,9530,10000,10000,470,4.93,9890,360,3.78,10000,10000
ضدي207,اختيارخ دي-800-14020217,61,6780,1505659000,217,210,244,27,12.44,222,5,2.3,188,255
ضترا3024,اختيارخ شتران-4000-1402/03/28,61,3259,3900395000,1169,1500,1150,-19,-1.63,1197,28,2.4,1121,1500
سلام2,صندوق س سلام فارابي-سهام,60,600000,600000,11150,1,1,-11149,-99.99,1,-11149,-99.99,1,1
ضسپا1203,اختيارخ خساپا-1800-1401/12/10,58,20354,14513721000,593,630,740,147,24.79,713,120,20.24,550,770
كايتا,ايتالران‌,56,57301,1977776450,34300,35300,34050,-250,-0.73,34350,50,0.15,33350,35300
ضسپا3027,اختيارخ خساپا-2600-1402/03/24,55,11322,4597367000,413,420,430,17,4.12,406,-7,-1.69,380,430
زعف0210پ19,زعفران0210نگين تروند قاينات(پ),55,35423,11131855045,300661,310001,316500,15839,5.27,314255,13594,4.52,302000,320352
تداوم,صندوق تداوم اطمينان تمدن-ثابت,54,1823823,18407628171,10087,10093,10093,6,0.06,10093,6,0.06,10092,10094
ضستا0104,اختيارخ شستا-1000-1402/01/09,52,15552,1953137000,168,200,168,0,0,126,-42,-25,110,200
فلات,گروه صنايع معادن فلات ايرانيان,52,354294,9565938000,26250,27000,27000,750,2.86,26950,700,2.67,27000,27000
ضهرم1208,اختيارخ اهرم-14000-1401/12/22,51,2239,3313571000,1591,1790,1500,-91,-5.72,1480,-111,-6.98,1300,1890
ضستا6002,اختيارخ شستا-665-1402/06/08,51,17019,8193789000,499,490,489,-10,-2,481,-18,-3.61,470,495
اخزا007,اسنادخزانه-م7بودجه00-030912,51,223500,142122619000,635920,635410,636900,980,0.15,635900,-20,0,635030,636900
اخزا006,اسنادخزانه-م6بودجه00-030723,51,201400,132231435000,655850,655810,656510,660,0.1,656560,710,0.11,655810,658000
درسا,صندوق سرمايه گذاري درسا - سهام,50,1090354,13566838620,12470,12500,12570,100,0.8,12440,-30,-0.24,12240,12620
دحاوي,الحاوي,50,684831,7608472410,10790,11110,11110,320,2.97,11020,230,2.13,11110,11110
سلار,شركت سيمان لارستان,50,117573,3055670250,26750,26100,26000,-750,-2.8,26500,-250,-0.93,25950,26100
ضدي215,اختيارخ دي-1400-14020217,50,5248,497884000,99,199,94,-5,-5.05,95,-4,-4.04,94,100
ضستا6006,اختيارخ شستا-1065-1402/06/08,48,7522,1804026000,255,255,241,-14,-5.49,240,-15,-5.88,215,255
اخزا001,اسنادخزانه-م1بودجه00-030821,48,137300,88507860000,644310,642500,655000,10690,1.66,644630,320,0.05,640830,655000
اخزا0022,اسنادخزانه-م2بودجه00-031024,47,1548,954250760,617440,615560,617010,-430,-0.07,616440,-1000,-0.16,614610,617010
ضجار2025,اختيارخ وتجارت-1800-1402/02/20,47,3788,1384526000,387,375,380,-7,-1.81,366,-21,-5.43,350,388
نهال2,صندوق س. طلاي سرخ نوويرا,44,43500000,43500000,14366,1,1,-14365,-99.99,1,-14365,-99.99,1,1
داريوش,صندوق س. ثروت داريوش -س,44,192499,2429451585,12583,12202,12830,247,1.96,12621,38,0.3,12202,12830
افق ملت,صندوق س در سهام افق ملت,44,7379,1286122390,174930,174930,175000,70,0.04,174290,-640,-0.37,172050,175000
ضهاي3000,اختيارخ هاي وب-1845-1402/03/03,42,2324,2848207832,1073,1200,1185,112,10.44,1131,58,5.41,1050,1200
داريك,صندوق س.اعتماد داريك-د,42,4838735,69959259235,14447,14457,14459,12,0.08,14458,11,0.08,14457,14459
وآتوس,توسعه س. كشاورزي آرين توسكا,42,76994,11056338400,139450,143600,143600,4150,2.98,143600,4150,2.98,143600,143600
ضخاور110,اختيارخ خاور-3500-14020116,41,1400,1126726000,963,1021,800,-163,-16.93,805,-158,-16.41,750,1021
ثروتم,صندوق س. ثروت آفرين پارسيان-س,41,295628,32249999101,109589,108916,110299,710,0.65,109090,-499,-0.46,108916,110306
فالوم,آلومتك‌,40,505057,4818243780,9270,9540,9540,270,2.91,9400,130,1.4,9540,9540
اهرم2,صندوق س سهامي كاريزما- اهرمي,40,4000000,4000000,14310,1,1,-14309,-99.99,1,-14309,-99.99,1,1
ضهرم1204,اختيارخ اهرم-10000-1401/12/22,40,1689,7950683000,4741,4800,4750,9,0.19,4707,-34,-0.72,4200,5008
رماس,صندوق س.راهبرد ممتازابن سينا-س,40,171762,2282910655,13051,12900,13300,249,1.91,13291,240,1.84,12900,13470
ضخود1209,اختيارخ خودرو-2800-1401/12/03,40,4073,2131160000,600,331,630,30,5,523,-77,-12.83,331,665
ضسپا3028,اختيارخ خساپا-2800-1402/03/24,40,6216,2166594000,550,320,549,-1,-0.18,349,-201,-36.55,315,549
طسپا1203,اختيارف خساپا-1800-1401/12/10,39,13061,254180000,23,20,24,1,4.35,19,-4,-17.39,16,27
ضخود3070,اختيارخ خودرو-3000-1402/03/03,38,1871,1548162000,887,887,820,-67,-7.55,827,-60,-6.76,751,929
ضخود1214,اختيارخ خودرو-4000-1401/12/03,38,5859,641505000,130,130,100,-30,-23.08,109,-21,-16.15,50,139
ضملت3020,اختيارخ وبملت-2227-1402/03/28,38,3164,3796477000,1177,1250,1200,23,1.95,1200,23,1.95,1005,1250
وملت,سرمايه گذاري ملت,38,905978,2001305402,2166,2209,2209,43,1.99,2183,17,0.78,2209,2209
ضهرم1207,اختيارخ اهرم-13000-1401/12/22,38,2632,5732186000,2343,2120,2301,-42,-1.79,2178,-165,-7.04,1900,2535
اگ020318,گام بانك تجارت0203,38,167067,149524965000,894130,895000,895000,870,0.1,895000,870,0.1,895000,895000
برليان,صندوق سرمايه گذاري برليان-سهام,36,128300,1384846120,10760,10980,10700,-60,-0.56,10790,30,0.28,10650,10990
ضسپا3025,اختيارخ خساپا-2200-1402/03/24,36,2927,1974784000,697,734,725,28,4.02,675,-22,-3.16,561,735
صايند,صندوق س. گنجينه آينده روشن-د,35,1612769,16328412472,10115,10099,10125,10,0.1,10124,9,0.09,10099,10126
ضستا6001,اختيارخ شستا-565-1402/06/08,35,4410,2478060000,583,580,575,-8,-1.37,562,-21,-3.6,538,620
اخزا0052,اسنادخزانه-م5بودجه00-030626,35,1439,956429240,668850,652000,668010,-840,-0.13,664650,-4200,-0.63,652000,668020
الماس,صندوق س.امين تدبيرگران فردا-س,35,5301,745558880,139002,138003,142900,3898,2.8,140645,1643,1.18,138003,142900
فكمند,گسترش قطعه سازي كمند,34,287668,12901909800,43550,44850,44850,1300,2.99,43800,250,0.57,44850,44850
ضستا6000,اختيارخ شستا-465-1402/06/08,34,2211,1481659000,709,651,669,-40,-5.64,670,-39,-5.5,651,700
گنجينه,صندوق س. گنجينه داريوش-د,34,13385824,134233047355,10009,10028,10028,19,0.19,10028,19,0.19,10028,10029
ضسپا3026,اختيارخ خساپا-2400-1402/03/24,34,5278,2567314000,521,470,550,29,5.57,486,-35,-6.72,461,579
ضترا1143,اختيارخ شتران-3090-1401/11/19,34,922,1808247676,1074,1300,1249,175,16.29,1212,138,12.85,1150,1347
ضسپا3029,اختيارخ خساپا-3000-1402/03/24,34,9458,2880020000,375,330,330,-45,-12,305,-70,-18.67,290,330
اخزا004,اسنادخزانه-م4بودجه00-030522,33,58300,39924520000,684480,680000,685490,1010,0.15,684810,330,0.05,678610,685490
ارمغان,ص سرمايه گذاري ارمغان ايرانيان,33,703016,7082282029,10069,10075,10076,7,0.07,10074,5,0.05,10074,10076
فاما,صنعتي‌ آما,32,148144,1134783040,7160,7660,7660,500,6.98,7190,30,0.42,7660,7660
ضستا6008,اختيارخ شستا-1265-1402/06/08,32,10038,2174346000,223,170,200,-23,-10.31,217,-6,-2.69,150,222
ومشان,س. فني و مهندسي مشانير,31,43849,4538371500,106650,103500,103500,-3150,-2.95,103500,-3150,-2.95,103500,103500
اخزا003,اسنادخزانه-م3بودجه00-030418,31,44900,31494046000,699020,693730,701370,2350,0.34,701430,2410,0.34,693730,703900
ضخاور1105,اختيارخ خاور-2600-14011109,30,431,435008000,1137,1060,1054,-83,-7.3,1009,-128,-11.26,851,1190
اخزا103,اسناد خزانه-م3بودجه01-040520,30,84500,44957975000,532610,530440,532510,-100,-0.02,532050,-560,-0.11,530360,533980
هپارس029,اختيارف ت­ وپارس-2000-02/09/08,29,1453318,1453318,1,1,1,0,0,1,0,0,1,1
ضستا1104,اختيارخ شستا-900-1401/11/05,29,6477,878604000,139,152,156,17,12.23,136,-3,-2.16,126,156
زعف0210پ08,زعفران0210نگين روستا(پ),28,22712,7230274016,302473,309000,319499,17026,5.63,318346,15873,5.25,309000,320352
سكه0312پ01,تمام سكه طرح جديد0312 رفاه,28,5700,11771497500,2063593,2065175,2065175,1582,0.08,2065175,1582,0.08,2065175,2065175
ضستا6005,اختيارخ شستا-965-1402/06/08,28,1525,456205000,286,350,304,18,6.29,299,13,4.55,284,399
آسام,صندوق س.آرمان سپهر آشنا-م,27,57762,960687943,16565,16645,16646,81,0.49,16632,67,0.4,16520,16646
ضهرم1209,اختيارخ اهرم-15000-1401/12/22,27,1232,1270966000,1077,1275,1050,-27,-2.51,1032,-45,-4.18,911,1350
صنوين,صندوق سرمايه‌گذاري صنوين-مختلط,27,3727,511109720,138400,138200,138140,-260,-0.19,137140,-1260,-0.91,136790,138500
ضخود1213,اختيارخ خودرو-3750-1401/12/03,27,3950,474176000,183,120,150,-33,-18.03,120,-63,-34.43,115,155
نگين,ص.س. زمين و ساختمان نگين شهرري,26,17695,1396544510,79130,79360,78550,-580,-0.73,78920,-210,-0.27,78550,79380
وبازار,صندوق س شاخصي بازارآشنا,26,87707,1204578930,14050,13780,13920,-130,-0.93,13730,-320,-2.28,13660,13920
ضچكا1208,اختيارخ چكاپا-3250-1401/12/07,26,1391,227745000,210,239,162,-48,-22.86,164,-46,-21.9,145,239
اخزا0062,اسنادخزانه-م6بودجه00-030723,26,856,560612200,655850,654000,655310,-540,-0.08,654920,-930,-0.14,654000,655350
اخزا910,اسنادخزانه-م10بودجه99-020807,26,79100,65691857000,828840,829450,831200,2360,0.28,830490,1650,0.2,829450,832000
پادا,صندوق س.پاداش سرمايه پارس-س,26,120841,15860664664,129963,129151,131400,1437,1.11,131252,1289,0.99,127400,131799
ضشنا2025,اختيارخ شپنا-5859-1402/02/24,26,1998,3078184000,1774,1790,1550,-224,-12.63,1541,-233,-13.13,1500,2008
ضجار2029,اختيارخ وتجارت-2400-1402/02/20,25,1983,310510000,243,249,150,-93,-38.27,157,-86,-35.39,130,249
تامين05,اجاره تامين اجتماعي14050509,25,5000000,5000000000000,1000000,1000000,1000000,0,0,1000000,0,0,1000000,1000000
ضهاي3009,اختيارخ هاي وب-3690-1402/03/03,25,175,30322732,205,171,222,17,8.29,160,-45,-21.95,145,222
ضدي206,اختيارخ دي-750-14020217,25,945,238787000,252,250,260,8,3.17,253,1,0.4,230,263
اخزا009,اسناد خزانه-م9بودجه00-031101,24,51900,31789046000,615000,600170,614000,-1000,-0.16,612510,-2490,-0.4,600170,617990
هيوا,صندوق س. ثروت هيوا-س,24,40576,466389625,11640,11687,11648,8,0.07,11494,-146,-1.25,11400,11687
ضهرم1203,اختيارخ اهرم-9000-1401/12/22,24,412,2287200000,5721,5600,5800,79,1.38,5551,-170,-2.97,5500,5800
ضصاد1123,اختيارخ وبصادر-1300-1401/11/19,24,1806,1100659000,641,623,630,-11,-1.72,609,-32,-4.99,580,647
ضشنا1108,اختيارخ شپنا-8000-1401/11/19,23,613,203460000,396,490,310,-86,-21.72,332,-64,-16.16,301,490
اگ020555,گام بانك اقتصاد نوين0205,23,100055,85467244780,851687,858996,854200,2513,0.3,854203,2516,0.3,854200,858996
آتيمس,صندوق س.آرمان آتيه درخشان مس-س,23,5727,1279979502,223987,223161,224990,1003,0.45,223499,-488,-0.22,222039,225000
طخود1206,اختيارف خودرو-2200-1401/12/03,23,5435,118389000,26,20,21,-5,-19.23,22,-4,-15.38,18,31
ضخاور1104,اختيارخ خاور-2400-14011109,23,1284,1545989000,1301,1210,1265,-36,-2.77,1204,-97,-7.46,1200,1265
ضستا6007,اختيارخ شستا-1165-1402/06/08,22,2755,572816000,196,196,215,19,9.69,208,12,6.12,186,230
فنرژي,گسترش صنايع انرژي آذرآب,21,45778,798826100,17800,17450,17450,-350,-1.97,17740,-60,-0.34,17450,17450
زعف0210پ11,زعفران0210نگين سحرخيز(پ),21,25523,8176344096,320629,320352,320352,-277,-0.09,320352,-277,-0.09,320352,320352
طلا2,صندوق س.پشتوانه طلاي لوتوس,20,2000000,2000000,158380,1,1,-158379,-100,1,-158379,-100,1,1
ضهرم1206,اختيارخ اهرم-12000-1401/12/22,20,600,1672741000,2266,2800,3080,814,35.92,2788,522,23.04,2600,3090
ضسلا7005,اختيارخ سلام-11000-1402/07/19,19,1705,4404545000,2534,3000,2650,116,4.58,2583,49,1.93,2530,3000
وثخوز,سرمايه گذاري و توسعه خوزستان,19,57389,1804884050,30550,31450,31450,900,2.95,30700,150,0.49,31450,31450
ضستا1103,اختيارخ شستا-800-1401/11/05,19,1814,400728000,223,250,256,33,14.8,221,-2,-0.9,205,256
اخزا1012,اسناد خزانه-م1بودجه01-040326,19,740,401085660,552460,525180,552000,-460,-0.08,542010,-10450,-1.89,525180,552000
ضپلا1208,اختيارخ پالايش-100000-01/12/16,18,2491,508599510,19917,20500,23974,4057,20.37,20417,500,2.51,19950,23974
زعف0210پ22,زعفران0210نگين گليران(پ),18,8313,2663086086,319329,320352,320352,1023,0.32,320352,1023,0.32,320351,320352
عقيق,صندوق سرمايه گذاري عقيق-سهام,17,45118,2385615200,53550,53000,53000,-550,-1.03,52880,-670,-1.25,52500,53300
زعف0210پ23,زعفران0210نگين مدبرتوس(پ)	,17,4262,1339261500,299282,309000,317990,18708,6.25,314233,14951,5,309000,318000
ضستا0107,اختيارخ شستا-1300-1402/01/09,17,3087,228783000,83,72,80,-3,-3.61,74,-9,-10.84,69,80
زعف0210پ25,زعفران0210نگين زرپران (پ),17,4898,1560409208,300150,320352,320352,20202,6.73,318581,18431,6.14,315000,320352
ضملت1148,اختيارخ وبملت-3500-1401/11/24,17,2152,495541000,296,200,230,-66,-22.3,230,-66,-22.3,200,314
ضشنا1105,اختيارخ شپنا-6500-1401/11/19,17,1010,1413720000,1382,1350,1399,17,1.23,1400,18,1.3,1350,1429
ضسپا1201,اختيارخ خساپا-1600-1401/12/10,16,496,439262000,779,880,887,108,13.86,886,107,13.74,880,889
ضچكا1207,اختيارخ چكاپا-3000-1401/12/07,16,1743,496897000,309,260,270,-39,-12.62,285,-24,-7.77,151,300
ضشنا1104,اختيارخ شپنا-6000-1401/11/19,16,750,1249067000,1806,1602,1750,-56,-3.1,1665,-141,-7.81,1600,1849
ضترا1145,اختيارخ شتران-3710-1401/11/19,16,569,606190172,602,550,740,138,22.92,658,56,9.3,550,740
ضخاور1103,اختيارخ خاور-2200-14011109,15,217,311331000,1510,1641,1478,-32,-2.12,1435,-75,-4.97,1400,1641
ضجار2021,اختيارخ وتجارت-1400-1402/02/20,14,10113,5947039000,624,588,600,-24,-3.85,588,-36,-5.77,588,600
گنجين,صندوق س. گنجينه يكم آويد-د,14,548951,9614443785,17508,17520,17514,6,0.03,17514,6,0.03,17514,17520
سپيدما2,صندوق س. سپيد دماوند-د,14,135000000,135000000,14379,1,1,-14378,-99.99,1,-14378,-99.99,1,1
ضملت1143,اختيارخ وبملت-2400-1401/11/24,14,1695,2016401000,1277,1150,1289,12,0.94,1190,-87,-6.81,1150,1289
بازده,صندوق س. بازده ثابت-د,14,615156,6387343698,10377,10383,10383,6,0.06,10383,6,0.06,10383,10385
ضخاور1107,اختيارخ خاور-3000-14011109,14,1157,730819000,724,655,730,6,0.83,632,-92,-12.71,620,730
اخزا908,اسنادخزانه-م8بودجه99-020606,14,92300,79891391000,862510,861910,865700,3190,0.37,865560,3050,0.35,861910,865700
بتك,كارخانجات كابل سازي‌ تك‌,14,279,103230000,377550,370000,370000,-7550,-2,377400,-150,-0.04,370000,370000
آرمانح,ح.بيمه آرمان,14,18999,73865427,4006,3886,3888,-118,-2.95,3888,-118,-2.95,3886,3889
بذر,صندوق س بذر اميد آفرين-سهام,14,970,123136600,128980,125800,128400,-580,-0.45,126940,-2040,-1.58,125800,128400
اخزا0042,اسنادخزانه-م4بودجه00-030522,13,709,483005670,684480,680000,683020,-1460,-0.21,681250,-3230,-0.47,677110,683500
اخزا0072,اسنادخزانه-م7بودجه00-030912,13,529,335225430,635920,620580,635020,-900,-0.14,633700,-2220,-0.35,620580,635020
اخزا008,اسنادخزانه-م8بودجه00-030919,13,110700,70073261000,632570,632580,633000,430,0.07,633000,430,0.07,632580,633020
ضسپا3020,اختيارخ خساپا-1600-1402/03/24,13,234,261546000,1180,1170,1150,-30,-2.54,1118,-62,-5.25,1076,1170
طخود1204,اختيارف خودرو-1900-1401/12/03,12,1244,11860000,13,7,9,-4,-30.77,10,-3,-23.08,7,18
اخزا0032,اسنادخزانه-م3بودجه00-030418,12,407,283409870,699020,692170,699710,690,0.1,696340,-2680,-0.38,692170,699720
ضترا1144,اختيارخ شتران-3401-1401/11/19,12,451,722186210,747,1000,910,163,21.82,990,243,32.53,900,1010
ضهاي3010,اختيارخ هاي وب-4152-1402/03/03,12,733,142960088,182,238,181,-1,-0.55,180,-2,-1.1,160,199
ضفلا1174,اختيارخ فولاد-5500-1401/11/26,12,829,626320000,785,721,850,65,8.28,756,-29,-3.69,721,850
ضپلا1207,اختيارخ پالايش-90000-01/12/16,12,1935,562542900,30116,28700,31000,884,2.94,29072,-1044,-3.47,28700,31999
كورز,ورزيران‌,12,1602,812133900,492200,506950,506950,14750,3,506950,14750,3,506950,506950
ضپلا1210,اختيارخ پالايش-120000-01/12/16,11,3889,399870000,8084,17000,10000,1916,23.7,10282,2198,27.19,9000,17000
ضصاد3026,اختيارخ وبصادر-2000-1402/03/17,11,473,181245000,394,399,398,4,1.02,383,-11,-2.79,345,399
برن0203پ02,برنج فجر0203 تجارت مازندران(پ),11,884,504912050,571816,570000,580000,8184,1.43,571167,-649,-0.11,570000,580000
ضهاي3006,اختيارخ هاي وب-2998-1402/03/03,11,828,328393464,353,320,495,142,40.23,366,13,3.68,311,500
ضترا3022,اختيارخ شتران-3500-1402/03/28,11,10002,13703900000,1900,1950,1370,-530,-27.89,1370,-530,-27.89,1370,1950
ضخود3073,اختيارخ خودرو-3750-1402/03/03,11,829,374180000,617,500,420,-197,-31.93,451,-166,-26.9,420,500
ضسلا1207,اختيارخ سلام-11000-1401/12/22,11,500,460000000,924,920,920,-4,-0.43,920,-4,-0.43,920,920
ضسلا7006,اختيارخ سلام-12000-1402/07/19,11,2204,4200818000,1800,2599,1900,100,5.56,1906,106,5.89,1900,2600
ضخود3071,اختيارخ خودرو-3250-1402/03/03,11,461,303018000,863,650,641,-222,-25.72,657,-206,-23.87,641,675
هم وزن2,صندوق س. شاخصي كيان-س,10,5500000,5500000,12210,1,1,-12209,-99.99,1,-12209,-99.99,1,1
ضخود3068,اختيارخ خودرو-2600-1402/03/03,10,800,275991000,1167,801,1165,-2,-0.17,345,-822,-70.44,200,1165
اطلس2,صندوق س.توسعه اطلس مفيد-س,10,47000,47000,317977,1,1,-317976,-100,1,-317976,-100,1,1
آگاس2,صندوق س.هستي بخش آگاه-س,10,1200000,1200000,99144,1,1,-99143,-100,1,-99143,-100,1,1
اخزا903,اسنادخزانه-م3بودجه99-011110,10,5400,5363025000,992340,992000,996190,3850,0.39,993150,810,0.08,992000,996190
آساس2,صندوق س.آسمان آرماني سهام-س,10,97110,97110,252390,1,1,-252389,-100,1,-252389,-100,1,1
اخزا0012,اسنادخزانه-م1بودجه00-030821,10,309,198720640,644310,643010,643110,-1200,-0.19,643110,-1200,-0.19,643010,643210
تاراز,صندوق س آواي تاراز زاگرس-سهام,10,27953,374490500,13460,13330,13470,10,0.07,13400,-60,-0.45,13190,13500
ضجار2028,اختيارخ وتجارت-2200-1402/02/20,10,3287,702745000,231,300,219,-12,-5.19,214,-17,-7.36,208,300
ضستا1202,اختيارخ شستا-700-1401/12/03,10,585,207393000,389,360,359,-30,-7.71,355,-34,-8.74,341,361
ضسپا1200,اختيارخ خساپا-1500-1401/12/10,10,1360,1412130000,924,970,1050,126,13.64,1038,114,12.34,970,1079
اخزا0102,اسناد خزانه-م10بودجه00-031115,10,573,347073370,608893,605120,605720,-3173,-0.52,605710,-3183,-0.52,605120,607200
ضخود3074,اختيارخ خودرو-4000-1402/03/03,10,586,240460000,480,440,420,-60,-12.5,410,-70,-14.58,400,440
تملي107,تسهيلات مسكن ب.ملي-مهر1401,10,224,186008808,874101,830398,830396,-43705,-5,830396,-43705,-5,830396,830398
اخزا010,اسناد خزانه-م10بودجه00-031115,10,157700,96037755600,608893,611999,609501,608,0.1,608990,97,0.02,605112,612000
ضشنا1109,اختيارخ شپنا-9000-1401/11/19,10,300,48584000,155,200,200,45,29.03,162,7,4.52,139,200
ضهرم7010,اختيارخ اهرم-15000-1402/07/23,9,2002,8162108000,4800,4054,4100,-700,-14.58,4077,-723,-15.06,4054,4100
كاج2,صندوق س. نوع دوم نو ويرا -د,9,9000000,9000000,10581,1,1,-10580,-99.99,1,-10580,-99.99,1,1
سيناد,صندوق س.سپهرسودمند سينا-د,9,91766,919001120,10007,10014,10015,8,0.08,10015,8,0.08,10014,10015
اخزا909,اسنادخزانه-م9بودجه99-020316,9,3800,3473885000,912640,912700,914100,1460,0.16,914180,1540,0.17,912700,916000
ضصاد1125,اختيارخ وبصادر-1500-1401/11/19,9,720,287078000,453,350,460,7,1.55,399,-54,-11.92,350,460
ضخود1109,اختيارخ خودرو-2600-1401/11/12,9,472,318153000,781,690,653,-128,-16.39,674,-107,-13.7,600,750
اخزا821,اسنادخزانه-م21بودجه98-020906,9,83100,67702880000,814110,813070,814300,190,0.02,814720,610,0.07,813060,815100
ضخود1200,اختيارخ خودرو-1500-1401/12/03,9,98,166940000,1581,1880,1750,169,10.69,1703,122,7.72,1600,1880
ضستا1208,اختيارخ شستا-1300-1401/12/03,9,757,28018000,23,40,39,16,69.57,37,14,60.87,30,42
گام020661,گواهي اعتبار مولد شهر0206,9,100000,83500000000,838000,835000,835000,-3000,-0.36,835000,-3000,-0.36,835000,835000
تابان04,اجاره تابان سپهر14031126,9,1025000,1033051400000,1004810,1018530,919100,-85710,-8.53,1007850,3040,0.3,919100,1018530
اراد24,مرابحه عام دولت2-ش.خ ساير0212,9,820000,783401000000,932400,950000,955400,23000,2.47,955370,22970,2.46,950000,955400
طستا1104,اختيارف شستا-900-1401/11/05,8,1561,1861000,2,1,2,0,0,1,-1,-50,1,2
طشنا1106,اختيارف شپنا-7000-1401/11/19,8,420,37630000,139,72,100,-39,-28.06,90,-49,-35.25,72,109
ثنا,صندوق س.زرين نهال ثنا-س,8,21233,247734518,11652,11600,11900,248,2.13,11667,15,0.13,11562,12000
ضخود3067,اختيارخ خودرو-2400-1402/03/03,8,59,72439000,1274,1250,1230,-44,-3.45,1228,-46,-3.61,1195,1250
ضخاور106,اختيارخ خاور-2700-14020116,8,1100,1499500000,1452,1400,1400,-52,-3.58,1363,-89,-6.13,1350,1400
ضدار1207,اختيارخ ص.دارا-120000-01/12/16,7,7000,678080000,18000,8808,9000,-9000,-50,9687,-8313,-46.18,8808,10000
ضسلا7004,اختيارخ سلام-10000-1402/07/19,7,327,1119640000,3195,3400,3456,261,8.17,3424,229,7.17,3400,3456
اخزا0092,اسناد خزانه-م9بودجه00-031101,7,292,176955330,615000,593910,603250,-11750,-1.91,606010,-8990,-1.46,593910,620000
ضجار2018,اختيارخ وتجارت-1100-1402/02/20,7,121,101050000,909,850,930,21,2.31,835,-74,-8.14,810,930
ضبساما305,اختيارخ بساما-12000-14020310,7,90,82700000,892,950,950,58,6.5,919,27,3.03,880,950
ضسپا1202,اختيارخ خساپا-1700-1401/12/10,7,560,461400000,736,790,850,114,15.49,824,88,11.96,790,850
ضپلا1206,اختيارخ پالايش-80000-01/12/16,6,405,162400000,40777,40000,42000,1223,3,40099,-678,-1.66,39800,42000
طهرم7000,اختيارف اهرم-6500-1402/07/23,6,53,12505000,160,300,216,56,35,236,76,47.5,216,999
ولملتح,ح . واسپاري ملت,6,15948,62197200,4028,3900,3900,-128,-3.18,3900,-128,-3.18,3900,3900
داريك2,صندوق س.اعتماد داريك-د,6,4400000,4400000,14447,1,1,-14446,-99.99,1,-14446,-99.99,1,1
اخزا1032,اسناد خزانه-م3بودجه01-040520,6,244,123459120,532610,505980,505980,-26630,-5,505980,-26630,-5,505980,505980
نشان,صندوق س. نشان هامرز-د,6,20624,238989950,11580,11587,11588,8,0.07,11588,8,0.07,11587,11588
كمان,س.خ.كمان كاريزما 35% تاديه,6,366000,175497366000,476987,479501,479501,2514,0.53,479501,2514,0.53,479501,479501
ضصاد1126,اختيارخ وبصادر-1600-1401/11/19,6,208,67998000,337,280,373,36,10.68,327,-10,-2.97,280,373
اخزا911,اسنادخزانه-م11بودجه99-020906,6,11100,9047400000,814990,814630,815500,510,0.06,815080,90,0.01,814630,815500
تملي706,تسهيلات مسكن ب. ملي-شهريور97,6,63,40904002,664036,664036,630835,-33201,-5,649270,-14766,-2.22,630835,664036
ضخود0112,اختيارخ خودرو-3750-1402/01/09,6,370,92500000,266,250,250,-16,-6.02,250,-16,-6.02,250,250
سكه0211پ02,تمام سكه طرح جديد0211ملت,6,1100,2271692500,2063593,2065175,2065175,1582,0.08,2065175,1582,0.08,2065175,2065175
اوج,صندوق س.اوج دماوند-س,5,1079,12046456,11281,11165,11164,-117,-1.04,11164,-117,-1.04,11164,11165
ثبات2,صندوق س. ثبات ويستا -د,5,47900000,47900000,13359,1,1,-13358,-99.99,1,-13358,-99.99,1,1
سكه0112پ03,تمام سكه طرح جديد0112سامان,5,600,1239105000,2063593,2065175,2065175,1582,0.08,2065175,1582,0.08,2065175,2065175
مكرج112,مشاركت شهرداري كرج-3ماهه18%,5,50000,50000000000,1000000,1000000,1000000,0,0,1000000,0,0,1000000,1000000
ضملي7028,اختيارخ فملي-4187-1402/07/05,5,1150,2645000000,2419,2300,2300,-119,-4.92,2300,-119,-4.92,2300,2300
اخزا0082,اسنادخزانه-م8بودجه00-030919,5,305,192633750,632570,631510,632010,-560,-0.09,631590,-980,-0.15,631310,632010
ضملي7030,اختيارخ فملي-4853-1402/07/05,5,2003,3806000000,1290,1900,2000,710,55.04,1900,610,47.29,1900,2000
ضستا0108,اختيارخ شستا-1400-1402/01/09,5,23,1346000,56,61,41,-15,-26.79,59,3,5.36,40,61
ضخود1111,اختيارخ خودرو-3000-1401/11/12,5,94,33150000,424,251,395,-29,-6.84,353,-71,-16.75,251,410
زعف0210پ24,زعفران0210نگين پارسيلون(پ),5,5000,1578000000,295000,315000,317000,22000,7.46,315600,20600,6.98,315000,317000
اخزا820,اسنادخزانه-م20بودجه98-020806,5,14200,11798350000,834990,830020,831000,-3990,-0.48,830870,-4120,-0.49,830020,831000
ضخود1201,اختيارخ خودرو-1600-1401/12/03,5,36,61580000,1602,1637,1999,397,24.78,1711,109,6.8,1637,2599
طسپا1204,اختيارف خساپا-1900-1401/12/10,5,548,13660000,37,32,20,-17,-45.95,25,-12,-32.43,20,32
اخزا906,اسنادخزانه-م6بودجه99-020321,5,100400,91634710000,911400,913100,912700,1300,0.14,912700,1300,0.14,910050,913100
اخزا905,اسنادخزانه-م5بودجه99-020218,5,20400,19016920000,929730,932200,932100,2370,0.25,932200,2470,0.27,932100,932300
ضخود0113,اختيارخ خودرو-4000-1402/01/09,5,600,147000000,270,245,245,-25,-9.26,245,-25,-9.26,245,245
پاداش2,صندوق س. ارزش پاداش-د,5,31300000,31300000,10248,1,1,-10247,-99.99,1,-10247,-99.99,1,1
پاسار04,اجاره انرژي پاسارگاد14040302,5,1000000,1000000000000,1000000,1000000,1000000,0,0,1000000,0,0,1000000,1000000
ضترا1147,اختيارخ شتران-4327-1401/11/19,5,110,35651012,246,200,250,4,1.63,200,-46,-18.7,152,250
ضسپا3021,اختيارخ خساپا-1700-1402/03/24,4,6,6212000,1090,1100,984,-106,-9.72,1035,-55,-5.05,984,1100
ضبساما306,اختيارخ بساما-13000-14020310,4,60,36000000,900,500,700,-200,-22.22,600,-300,-33.33,500,700
طهاي3009,اختيارف هاي وب-3690-1402/03/03,4,6,4617840,711,710,710,-1,-0.14,710,-1,-0.14,710,710
ضستا6009,اختيارخ شستا-1365-1402/06/08,4,789,111568000,151,144,208,57,37.75,141,-10,-6.62,141,208
ضخود1203,اختيارخ خودرو-1800-1401/12/03,4,35,49980000,1332,1210,1400,68,5.11,1428,96,7.21,1210,1450
ضشنا1111,اختيارخ شپنا-11000-1401/11/19,4,1000,5250000,445,30,5,-440,-98.88,5,-440,-98.88,5,30
اخزا9094,اسنادخزانه-م9بودجه99-020316,4,3190989,2919116737200,912640,914800,914800,2160,0.24,914800,2160,0.24,914800,914800
كاردان2,صندوق س تجارت شاخصي كاردان,4,218001,218001,250990,1,1,-250989,-100,1,-250989,-100,1,1
مرواريد,صندوق س. مرواريد بها بازار-س,4,1815,20385733,11358,11131,11270,-88,-0.77,11232,-126,-1.11,11131,11270
ضترا1142,اختيارخ شتران-2781-1401/11/19,4,48,113907200,1446,1500,1600,154,10.65,1467,21,1.45,1250,1600
طهاي3006,اختيارف هاي وب-2998-1402/03/03,4,402,124074640,241,230,300,59,24.48,285,44,18.26,230,300
ضدار1204,اختيارخ ص.دارا-90000-01/12/16,4,111,11368000,36632,20001,34999,-1633,-4.46,10241,-26391,-72.04,4200,34999
ضسرو1016,اختيارخ سرو-74000-1402/10/06,4,310,122254700,38593,39437,39437,844,2.19,39437,844,2.19,39437,39437
ويستا,صندوق س. ويستا -س,4,9892,132416820,13232,13194,13408,176,1.33,13386,154,1.16,13194,13408
ضصاد1122,اختيارخ وبصادر-1200-1401/11/19,4,34,23200000,700,650,700,0,0,682,-18,-2.57,600,700
طهرم1207,اختيارف اهرم-13000-1401/12/22,4,17,15690000,1900,800,990,-910,-47.89,923,-977,-51.42,800,990
چنوپا,نيوپان‌ 22 بهمن‌,4,2521,43361200,16700,17200,17200,500,2.99,17200,500,2.99,17200,17200
گام020756,گواهي اعتبار مولد سامان0207,4,205000,167530000000,836000,817100,817100,-18900,-2.26,817220,-18780,-2.25,817100,822000
ثمين,صندوق س. ثروت افزون ثمين-س,4,7240,98760560,13550,13600,13640,90,0.66,13641,91,0.67,13600,13650
ضخود2036,اختيارخ خودرو-4000-1402/02/13,4,308,113860000,300,369,370,70,23.33,370,70,23.33,369,370
كحافظ2,كاشي‌ وسراميك‌ حافظ‌,4,20000000,127400000000,6370,6370,6370,0,0,6370,0,0,6370,6370
ضصاد3027,اختيارخ وبصادر-2200-1402/03/17,4,50,17950000,300,300,399,99,33,359,59,19.67,300,399
كارا4,صندوق س. كارا -د,4,115540660,1522240605500,13166,13174,13175,9,0.07,13175,9,0.07,13174,13175
اخزا904,اسنادخزانه-م4بودجه99-011215,3,100300,97542660000,971890,972200,972510,620,0.06,972510,620,0.06,972200,972510
ضصاد3028,اختيارخ وبصادر-2400-1402/03/17,3,70,20990000,298,299,300,2,0.67,300,2,0.67,299,300
ضهاي3001,اختيارخ هاي وب-2030-1402/03/03,3,13,15197680,1089,960,1115,26,2.39,1078,-11,-1.01,950,1115
ضپلا1211,اختيارخ پالايش-130000-01/12/16,3,966,40300000,2556,4000,5000,2444,95.62,4172,1616,63.22,4000,5000
زير0203پ01,زيره سبز 0203 كيميابذر(پ),3,66,105602000,1525000,1600000,1600125,75125,4.93,1600030,75030,4.92,1600000,1600125
ضهاي3003,اختيارخ هاي وب-2399-1402/03/03,3,10,7588000,950,700,700,-250,-26.32,700,-250,-26.32,700,700
ضتفارس600,اختيارخ تفارس-2195-14020629,3,100,350000000,1500,3500,3500,2000,133.33,3500,2000,133.33,3500,3500
ضسلا1206,اختيارخ سلام-10000-1401/12/22,3,505,853445000,1587,1690,1690,103,6.49,1690,103,6.49,1689,1690
ضترا1146,اختيارخ شتران-4018-1401/11/19,3,35,25090326,485,549,400,-85,-17.53,443,-42,-8.66,400,549
افران4,صندوق س افرا نماد پايدار-ثابت,3,47933000,907936886000,18931,18942,18942,11,0.06,18942,11,0.06,18941,18942
ضترا1141,اختيارخ شتران-2472-1401/11/19,3,18,53717600,1632,1850,1850,218,13.36,1844,212,12.99,1800,1850
اخزا011,اسناد خزانه-م11بودجه00-030619,3,10000,6318858000,629940,661430,630000,60,0.01,631890,1950,0.31,630000,661430
ضشنا1107,اختيارخ شپنا-7500-1401/11/19,3,20,11750000,598,650,550,-48,-8.03,587,-11,-1.84,550,650
ضچكا1206,اختيارخ چكاپا-2800-1401/12/07,3,10,2000000,649,200,200,-449,-69.18,200,-449,-69.18,200,200
سكه0111پ05,تمام سكه طرح جديد0111آينده,3,600,1239105000,2063593,2065175,2065175,1582,0.08,2065175,1582,0.08,2065175,2065175
اراد61,مرابحه عام دولت61-ش.خ0309,3,35000,35000000000,1000000,1000000,1000000,0,0,1000000,0,0,1000000,1000000
صباايده01,مرابحه ايده پردازصبادانا050929,3,35000,31587500000,950000,902500,902500,-47500,-5,902500,-47500,-5,902500,902500
اخزا914,اسنادخزانه-م14بودجه99-021025,3,24500,19330260000,787640,787600,789100,1460,0.19,788990,1350,0.17,787600,789100
طشنا1105,اختيارف شپنا-6500-1401/11/19,3,7,155000,54,33,15,-39,-72.22,22,-32,-59.26,13,33
سحرخيز2,صندوق س. گروه زعفران سحرخيز,3,2590000,2590000,19892,1,1,-19891,-99.99,1,-19891,-99.99,1,1
ضكاريس205,اختيارخ كاريس-16000-14020205,3,50,123600000,2821,2320,2700,-121,-4.29,2472,-349,-12.37,2320,2700
اراد50,مرابحه عام دولت5-ش.خ0302,3,95000,95000000000,1000000,1000000,1000000,0,0,1000000,0,0,1000000,1000000
جستا0000,آتي شستا-1401/11/12,3,4,4386000,1090,1092,1100,10,0.92,1096,6,0.55,1092,1100
تاراز2,صندوق س آواي تاراز زاگرس-سهام,3,210000,210000,13460,1,1,-13459,-99.99,1,-13459,-99.99,1,1
شپنا2,پالايش نفت اصفهان,3,296500000,2277400000000,7680,7680,7750,70,0.91,7681,1,0.01,7680,7750
افران2,صندوق س افرا نماد پايدار-ثابت,3,37000000,37000000,18931,1,1,-18930,-99.99,1,-18930,-99.99,1,1
سپر4,صندوق س سپر سرمايه بيدار- ثابت,3,35372140,586520966800,16602,16580,16580,-22,-0.13,16581,-21,-0.13,16580,16620
ضملي1170,اختيارخ فملي-5500-1401/11/12,3,6,9091000,2099,1611,1420,-679,-32.35,1515,-584,-27.82,1420,1611
كارا2,صندوق س. كارا -د,3,112000000,112000000,13166,1,1,-13165,-99.99,1,-13165,-99.99,1,1
فيروزا2,صندوق ارمغان فيروزه آسيا-ثابت,3,41460000,41460000,32364,1,1,-32363,-100,1,-32363,-100,1,1
ضكاريس207,اختيارخ كاريس-18000-14020205,3,29,39707000,1322,1400,1300,-22,-1.66,1369,47,3.56,1300,1400
اراد60,مرابحه عام دولتي6-ش.خ0210,3,500000,466610000000,928000,933220,933220,5220,0.56,933220,5220,0.56,933220,933220
ضدي200,اختيارخ دي-450-14020217,3,190,99790000,450,525,526,76,16.89,525,75,16.67,525,526
ضسپا3030,اختيارخ خساپا-3250-1402/03/24,3,1210,393500000,312,300,350,38,12.18,325,13,4.17,300,350
ضخود0111,اختيارخ خودرو-3500-1402/01/09,2,140,52000000,380,350,380,0,0,371,-9,-2.37,350,380
ضخود1113,اختيارخ خودرو-3500-1401/11/12,2,23,2663000,98,117,110,12,12.24,116,18,18.37,110,117
ضحفا1208,اختيارخ حفارس-16000-1401/12/24,2,53,68900000,1300,1300,1300,0,0,1300,0,0,1300,1300
اراد1034,مرابحه عام دولت103-ش.خ050821,2,10776800,8715807049200,1020000,808713,808800,-211200,-20.71,808756,-211244,-20.71,808713,808800
دريا2,صندوق س درياي آبي فيروزه-سهام,2,12910,12910,11630,1,1,-11629,-99.99,1,-11629,-99.99,1,1
سپر2,صندوق س سپر سرمايه بيدار- ثابت,2,29000000,29000000,16602,1,1,-16601,-99.99,1,-16601,-99.99,1,1
آكورد2,صندوق س. آرمان آتي كوثر-د,2,1500000,1500000,44628,1,1,-44627,-100,1,-44627,-100,1,1
اخزا9142,اسنادخزانه-م14بودجه99-021025,2,65,50916000,787640,783600,783200,-4440,-0.56,783320,-4320,-0.55,783200,783600
اخزا9102,اسنادخزانه-م10بودجه99-020807,2,91,71653400,828840,787400,787400,-41440,-5,787400,-41440,-5,787400,787400
تملي704,تسهيلات مسكن ب. ملي-تير97,2,34,25880120,724934,761180,761180,36246,5,761180,36246,5,761180,761180
فملي2,ملي‌ صنايع‌ مس‌ ايران‌,2,212000000,1619200000000,7640,7610,7640,0,0,7638,-2,-0.03,7610,7640
ضخاور1106,اختيارخ خاور-2800-14011109,2,101,86890000,1291,860,890,-401,-31.06,860,-431,-33.38,860,890
سپرمي,پرميت‌,2,304,10092800,33500,33200,33200,-300,-0.9,33500,0,0,33200,33200
تملي711,تسهيلات مسكن ب. ملي-بهمن97,2,4,2660544,638355,670272,660000,21645,3.39,665136,26781,4.2,660000,670272
ضسرو1015,اختيارخ سرو-68000-1402/10/06,2,2,879240,42185,43962,43962,1777,4.21,43962,1777,4.21,43962,43962
تملي710,تسهيلات مسكن ب. ملي-دي97,2,10,6543840,623223,654384,654384,31161,5,654384,31161,5,654384,654384
ضستا0101,اختيارخ شستا-700-1402/01/09,2,601,222372000,460,370,372,-88,-19.13,370,-90,-19.57,370,372
ضسپا3024,اختيارخ خساپا-2000-1402/03/24,2,41,34550000,848,840,950,102,12.03,843,-5,-0.59,840,950
تملي708,تسهيلات مسكن ب. ملي-آبان97,2,4,2587774,622750,653887,640000,17250,2.77,646943,24193,3.88,640000,653887
كرماشا2,صنايع پتروشيمي كرمانشاه,2,4199100,272941500000,64470,65000,65000,530,0.82,65000,530,0.82,65000,65000
غدير05,اجاره غديرايرانيان14050114,2,10000,9820000000,935350,982000,982000,46650,4.99,982000,46650,4.99,982000,982000
ضهاي3004,اختيارخ هاي وب-2583-1402/03/03,2,240,109787520,612,422,422,-190,-31.05,422,-190,-31.05,422,422
ضفلا7023,اختيارخ فولاد-2150-1402/07/26,2,13,42900000,3332,3300,3300,-32,-0.96,3300,-32,-0.96,3300,3300
ضترا1149,اختيارخ شتران-5000-1401/11/19,2,30,2410000,100,81,80,-20,-20,80,-20,-20,80,81
طستا1105,اختيارف شستا-1000-1401/11/05,2,51,155000,10,3,5,-5,-50,3,-7,-70,3,5
كمند2,صندوق س. با درآمد ثابت كمند,2,357000000,357000000,10099,1,1,-10098,-99.99,1,-10098,-99.99,1,1
ضملت1150,اختيارخ وبملت-4000-1401/11/24,2,16,1520000,92,95,95,3,3.26,95,3,3.26,95,95
ضسلا1205,اختيارخ سلام-9000-1401/12/22,2,200,520000000,2655,2600,2600,-55,-2.07,2600,-55,-2.07,2600,2600
ضملت1145,اختيارخ وبملت-2800-1401/11/24,2,27,21600000,604,800,800,196,32.45,800,196,32.45,800,800
ضخود1108,اختيارخ خودرو-2400-1401/11/12,2,6,5029000,970,1029,800,-170,-17.53,838,-132,-13.61,800,1029
ضخود3069,اختيارخ خودرو-2800-1402/03/03,2,20,16920000,970,891,801,-169,-17.42,846,-124,-12.78,801,891
ضهرم1202,اختيارخ اهرم-8000-1401/12/22,2,4,10580000,7120,925,7805,685,9.62,2645,-4475,-62.85,925,7805
اگ0207192,گام بانك صادرات ايران0207,2,500000,407400000000,813792,814800,814800,1008,0.12,814800,1008,0.12,814800,814800
شبندر2,پالايش نفت بندرعباس,2,217000000,2035460000000,9380,9380,9380,0,0,9380,0,0,9380,9380
وغدير2,سرمايه‌گذاري‌غدير(هلدينگ‌,2,98250000,1814352500000,18470,18470,18450,-20,-0.11,18467,-3,-0.02,18450,18470
سپيدما4,صندوق س. سپيد دماوند-د,1,60000000,863220000000,14379,14387,14387,8,0.06,14387,8,0.06,14387,14387
اراد119,مرابحه عام دولت119-ش.خ060811	,1,100000,95225000000,998550,952250,952250,-46300,-4.64,952250,-46300,-4.64,952250,952250
تملي802,تسهيلات مسكن ب. ملي-ارديبهشت98,1,10,6411070,674849,641107,641107,-33742,-5,641107,-33742,-5,641107,641107
سنفت021,سلف موازي نفت.س صادر اروند 021,1,100,237334200,2372238,2373342,2373342,1104,0.05,2373342,1104,0.05,2373342,2373342
مشير304,مشاركت ش شيراز304-3ماهه18%,1,5000,4675000000,952000,935000,935000,-17000,-1.79,935000,-17000,-1.79,935000,935000
اراد72,مرابحه عام دولت72-ش.خ0311,1,5000,4865000000,926730,973000,973000,46270,4.99,973000,46270,4.99,973000,973000
سمتا025,سلف موازي متانول بوشهر 025,1,100,116105900,1160519,1161059,1161059,540,0.05,1161059,540,0.05,1161059,1161059
تملي709,تسهيلات مسكن ب. ملي-آذر97,1,10,6509510,685211,650951,650951,-34260,-5,650951,-34260,-5,650951,650951
ضستا1200,اختيارخ شستا-500-1401/12/03,1,100,60000000,622,600,600,-22,-3.54,600,-22,-3.54,600,600
ضسرو1019,اختيارخ سرو-100000-1402/10/06,1,1,250000,1,25000,25000,24999,2499900,25000,24999,2499900,25000,25000
ضدي205,اختيارخ دي-700-14020217,1,100,20000000,300,200,200,-100,-33.33,200,-100,-33.33,200,200
ضترا3021,اختيارخ شتران-3250-1402/03/28,1,2,3600000,2100,1800,1800,-300,-14.29,1800,-300,-14.29,1800,1800
كمينا4,شيشه سازي مينا,1,649230000,884900490000,10200,1363,1363,-8837,-86.64,1363,-8837,-86.64,1363,1363
ضستا0103,اختيارخ شستا-900-1402/01/09,1,1,265000,250,265,265,15,6,265,15,6,265,265
ضسرو1018,اختيارخ سرو-90000-1402/10/06,1,1,330000,34000,33000,33000,-1000,-2.94,33000,-1000,-2.94,33000,33000
ضترا3026,اختيارخ شتران-5000-1402/03/28,1,1,900000,980,900,900,-80,-8.16,900,-80,-8.16,900,900
ضهرم1200,اختيارخ اهرم-7000-1401/12/22,1,7,56000000,8052,8000,8000,-52,-0.65,8000,-52,-0.65,8000,8000
نكالا,نهادهاي مالي بورس كالاي ايران,1,27,547020,20260,20260,20260,0,0,20260,0,0,20260,20260
ضصاد3030,اختيارخ وبصادر-2800-1402/03/17,1,10,2000000,230,200,200,-30,-13.04,200,-30,-13.04,200,200
ضصاد3025,اختيارخ وبصادر-1900-1402/03/17,1,1,350000,356,350,350,-6,-1.69,350,-6,-1.69,350,350
ضپلا1209,اختيارخ پالايش-110000-01/12/16,1,2,320000,17988,16000,16000,-1988,-11.05,16000,-1988,-11.05,16000,16000
پارس2,پتروشيمي پارس,1,100000000,240800000000,2408,2408,2408,0,0,2408,0,0,2408,2408
وپويا2,سرمايه گذاري پويا,1,35000000,91350000000,2727,2610,2610,-117,-4.29,2610,-117,-4.29,2610,2610
شبهرن2,نفت‌ بهران‌,1,3000000,59940000000,19960,19980,19980,20,0.1,19980,20,0.1,19980,19980
سبزوا2,سيمان لار سبزوار,1,14000000,77420000000,5390,5530,5530,140,2.6,5530,140,2.6,5530,5530
اخزا0054,اسنادخزانه-م5بودجه00-030626,1,163300,109280360000,668850,669200,669200,350,0.05,669200,350,0.05,669200,669200
سمتا024,سلف موازي متانول بوشهر 024,1,100,102103100,1020556,1021031,1021031,475,0.05,1021031,475,0.05,1021031,1021031
اخزا9082,اسنادخزانه-م8بودجه99-020606,1,13,11180000,862510,860000,860000,-2510,-0.29,860000,-2510,-0.29,860000,860000
سمتا023,سلف موازي استاندارد سمتا023,1,100,104671600,1046229,1046716,1046716,487,0.05,1046716,487,0.05,1046716,1046716
متا0203,آتي متانول-1402/03/17,1,100,90950000,909800,909500,909500,-300,-0.03,909500,-300,-0.03,909500,909500
ضستا1102,اختيارخ شستا-700-1401/11/05,1,19,6403000,337,337,337,0,0,337,0,0,337,337
متا0201,آتي متانول-1402/01/17,1,100,90910000,909300,909100,909100,-200,-0.02,909100,-200,-0.02,909100,909100
ضخاور1100,اختيارخ خاور-1600-14011109,1,50,100500000,2173,2010,2010,-163,-7.5,2010,-163,-7.5,2010,2010
سمتا031,سلف موازي متانول مرجان 031,1,100,96611700,965690,966117,966117,427,0.04,966117,427,0.04,966117,966117
طستا1106,اختيارف شستا-1100-1401/11/05,1,20,1600000,60,80,80,20,33.33,80,20,33.33,80,80
ضسرو1017,اختيارخ سرو-80000-1402/10/06,1,1,370000,33760,37000,37000,3240,9.6,37000,3240,9.6,37000,37000
نسب0201,آتي نفتاي سبك-1402/01/17,1,100,174050000,1710050,1740500,1740500,30450,1.78,1740500,30450,1.78,1740500,1740500
ضخود1202,اختيارخ خودرو-1700-1401/12/03,1,8,11200000,1342,1400,1400,58,4.32,1400,58,4.32,1400,1400
ضدار1211,اختيارخ ص.دارا-160000-01/12/16,1,10,100000,1000,1000,1000,0,0,1000,0,0,1000,1000
ضخود0107,اختيارخ خودرو-2600-1402/01/09,1,50,42500000,610,850,850,240,39.34,850,240,39.34,850,850
سمتا011,سلف موازي استاندارد سمتا011,1,10,99231510,9780839,9923151,9923151,142312,1.46,9923151,142312,1.46,9923151,9923151
وبصادر2,بانك صادرات ايران,1,42400000,80560000000,1939,1900,1900,-39,-2.01,1900,-39,-2.01,1900,1900
گام0207562,گواهي اعتبار مولد سامان0207,1,977,815795000,836000,835000,835000,-1000,-0.12,835000,-1000,-0.12,835000,835000
اراد502,مرابحه عام دولت5-ش.خ0302,1,2700,2700000000,1000000,1000000,1000000,0,0,1000000,0,0,1000000,1000000
جم پيلن2,پتروشيمي جم پيلن,1,700000,99456000000,142080,142080,142080,0,0,142080,0,0,142080,142080
عقيق2,صندوق سرمايه گذاري عقيق-سهام,1,30000,30000,53550,1,1,-53549,-100,1,-53549,-100,1,1
عميلگرد2,سلف ميلگرد آتيه خاورميانه2,1,10630,20005213540,1881030,1881958,1881958,928,0.05,1881958,928,0.05,1881958,1881958
صنم2,ص.س.صندوق در صندوق صنم,1,200000,200000,13124,1,1,-13123,-99.99,1,-13123,-99.99,1,1
ضشنا2027,اختيارخ شپنا-6696-1402/02/24,1,10,11010000,1138,1101,1101,-37,-3.25,1101,-37,-3.25,1101,1101
طصاد3020,اختيارف وبصادر-1400-1402/03/17,1,12,3600000,1,300,300,299,29900,300,299,29900,300,300
طملي1175,اختيارف فملي-8000-1401/11/12,1,4,1000000,150,250,250,100,66.67,250,100,66.67,250,250
ضهرم7004,اختيارخ اهرم-9000-1402/07/23,1,1,8500000,8200,8500,8500,300,3.66,8500,300,3.66,8500,8500
اخزا907,اسنادخزانه-م7بودجه99-020704,1,4600,3905400000,846070,849000,849000,2930,0.35,849000,2930,0.35,849000,849000
رمپنا2,گروه مپنا (سهامي عام),1,16000000,192000000000,11920,12000,12000,80,0.67,12000,80,0.67,12000,12000
نوري2,پتروشيمي نوري,1,4000000,423280000000,105820,105820,105820,0,0,105820,0,0,105820,105820
كيان4,صندوق س. با درآمد ثابت كيان,1,12500000,499650000000,39933,39972,39972,39,0.1,39972,39,0.1,39972,39972
سپنتا031,سلف موازي پنتان پتروكنگان031,1,100,198373600,1982684,1983736,1983736,1052,0.05,1983736,1052,0.05,1983736,1983736
اراد86,مرابحه عام دولت86-ش.خ020404,1,100000,96554000000,971000,965540,965540,-5460,-0.56,965540,-5460,-0.56,965540,965540
ضدي211,اختيارخ دي-1000-14020217,1,50,7000000,130,140,140,10,7.69,140,10,7.69,140,140
ضخود0109,اختيارخ خودرو-3000-1402/01/09,1,1,600000,469,600,600,131,27.93,600,131,27.93,600,600
ارفع2,شركت آهن و فولاد ارفع,1,5000000,89700000000,17940,17940,17940,0,0,17940,0,0,17940,17940
وسين2,بيمه سينا,1,30000000,62280000000,2051,2076,2076,25,1.22,2076,25,1.22,2076,2076
وگستر2,گسترش سرمايه گذاري ايرانيان,1,17633000,91867930000,5090,5210,5210,120,2.36,5210,120,2.36,5210,5210
فردا4,صندوق س آواي فرداي زاگرس-ثابت,1,66321790,999999949620,15068,15078,15078,10,0.07,15078,10,0.07,15078,15078
مارون2,پتروشيمي مارون,1,150000,27300000000,178300,182000,182000,3700,2.08,182000,3700,2.08,182000,182000
اراد115,مرابحه عام دولت115-ش.خ060630,1,10000,10000000000,1000000,1000000,1000000,0,0,1000000,0,0,1000000,1000000
فولاد2,فولاد مباركه اصفهان,1,10000000,61800000000,6140,6180,6180,40,0.65,6180,40,0.65,6180,6180
طهرم1205,اختيارف اهرم-11000-1401/12/22,1,25,12200000,391,488,488,97,24.81,488,97,24.81,488,488
ضصاد3029,اختيارخ وبصادر-2600-1402/03/17,1,10,2500000,290,250,250,-40,-13.79,250,-40,-13.79,250,250
اراد96,مرابحه عام دولت96-ش.خ030414,1,50000,47845000000,956400,956900,956900,500,0.05,956900,500,0.05,956900,956900
ثهام,صندوق س ثروت هامرز-سهام,1,771,10238880,13550,13280,13280,-270,-1.99,13280,-270,-1.99,13280,13280
اوصتا4,صندوق انديشه ورزان صباتامين -د,1,10000000,261530000000,26138,26153,26153,15,0.06,26153,15,0.06,26153,26153
اراد107,مرابحه عام دولت107-ش.خ030724,1,5000,4660000000,904930,932000,932000,27070,2.99,932000,27070,2.99,932000,932000
اخزا9112,اسنادخزانه-م11بودجه99-020906,1,10,7742500,814990,774250,774250,-40740,-5,774250,-40740,-5,774250,774250
سمگا2,گروه سرمايه گذاري ميراث فرهنگي,1,11000000,76450000000,6950,6950,6950,0,0,6950,0,0,6950,6950
اراد1072,مرابحه عام دولت107-ش.خ030724,1,300,283500000,904930,945000,945000,40070,4.43,945000,40070,4.43,945000,945000
وبملت2,بانك ملت,1,631455405,2273239458000,3615,3600,3600,-15,-0.41,3600,-15,-0.41,3600,3600
پترول2,گ.س.وت.ص.پتروشيمي خليج فارس,1,200000000,480000000000,2461,2400,2400,-61,-2.48,2400,-61,-2.48,2400,2400
اخزا9092,اسنادخزانه-م9بودجه99-020316,1,53,45951530,912640,867010,867010,-45630,-5,867010,-45630,-5,867010,867010
اخزا0024,اسنادخزانه-م2بودجه00-031024,1,134398,83004204800,617440,617600,617600,160,0.03,617600,160,0.03,617600,617600
ثهام2,صندوق س ثروت هامرز-سهام,1,100000,100000,13550,1,1,-13549,-99.99,1,-13549,-99.99,1,1
اخزا9032,اسنادخزانه-م3بودجه99-011110,1,4,3972000,992340,993000,993000,660,0.07,993000,660,0.07,993000,993000
انار2,صندوق س.انارنماد ارزش-درسهام,1,500000,500000,13480,1,1,-13479,-99.99,1,-13479,-99.99,1,1
اخزا9072,اسنادخزانه-م7بودجه99-020704,1,32,25720640,846070,803770,803770,-42300,-5,803770,-42300,-5,803770,803770
تملي804,تسهيلات مسكن ب. ملي-تير98,1,1,650304,619338,650304,650304,30966,5,650304,30966,5,650304,650304
پالايش2,صندوق پالايشي يكم-سهام,1,5400000,5400000,117510,1,1,-117509,-100,1,-117509,-100,1,1
پادا2,صندوق س.پاداش سرمايه پارس-س,1,110000,110000,129963,1,1,-129962,-100,1,-129962,-100,1,1
اراد242,مرابحه عام دولت2-ش.خ ساير0212,1,3900,3726060000,932400,955400,955400,23000,2.47,955400,23000,2.47,955400,955400
ضستر1104,اختيارخ خگستر-2600-1401/11/26,1,1,1800000,1399,1800,1800,401,28.66,1800,401,28.66,1800,1800
سمتا021,سلف موازي استاندارد سمتا021,1,100,104035600,1039872,1040356,1040356,484,0.05,1040356,484,0.05,1040356,1040356
شتران2,پالايش نفت تهران,1,10000000,43710000000,4208,4371,4371,163,3.87,4371,163,3.87,4371,4371
ديران2,ايران‌دارو,1,8400000,124068000000,15540,14770,14770,-770,-4.95,14770,-770,-4.95,14770,14770
گام020713,گواهي اعتبار مولد رفاه0207,1,5000,4133300000,815790,826660,826660,10870,1.33,826660,10870,1.33,826660,826660
كارين4,صندوق س نگين سامان-ثابت,1,59711000,597886243000,10006,10013,10013,7,0.07,10013,7,0.07,10013,10013
بوعلي2,پتروشيمي بوعلي سينا,1,4000000,136000000000,34000,34000,34000,0,0,34000,0,0,34000,34000
اراد87,مرابحه عام دولت87-ش.خ030304,1,170000,160344000000,941880,943200,943200,1320,0.14,943200,1320,0.14,943200,943200
تملي702,تسهيلات مسكن ب. ملي-ارديبهشت97,1,17,11728436,657056,689908,689908,32852,5,689908,32852,5,689908,689908
اراد104,مرابحه عام دولت104-ش.خ020303,1,30000,29400000000,982000,980000,980000,-2000,-0.2,980000,-2000,-0.2,980000,980000
غگز,گز سكه,1,2443,5066782,1976,2074,2074,98,4.96,2074,98,4.96,2074,2074
سمتا022,سلف موازي استاندارد سمتا022,1,100,104273200,1042247,1042732,1042732,485,0.05,1042732,485,0.05,1042732,1042732
ضهرم7006,اختيارخ اهرم-11000-1402/07/23,1,1,7000000,7000,7000,7000,0,0,7000,0,0,7000,7000
ضصاد1127,اختيارخ وبصادر-1700-1401/11/19,1,5,1025000,202,205,205,3,1.49,205,3,1.49,205,205
اگ020659,گام بانك سينا0206,1,480,401760000,833750,837000,837000,3250,0.39,837000,3250,0.39,837000,837000
ضترا3025,اختيارخ شتران-4500-1402/03/28,1,1,1001000,1220,1001,1001,-219,-17.95,1001,-219,-17.95,1001,1001
نسب0203,آتي نفتاي سبك-1402/03/17,1,100,173050000,1720020,1730500,1730500,10480,0.61,1730500,10480,0.61,1730500,1730500
ضسپا3023,اختيارخ خساپا-1900-1402/03/24,1,1,960000,910,960,960,50,5.49,960,50,5.49,960,960
طحافرين1207,اختيارف حافرين-4500-14011214,1,6,1200000,100,200,200,100,100,200,100,100,200,200
ضحفا1207,اختيارخ حفارس-15000-1401/12/24,1,12,20268000,2497,1689,1689,-808,-32.36,1689,-808,-32.36,1689,1689
ضخاو1200,اختيارخ وخاور-2800-1401/12/01,1,105,157500000,1826,1500,1500,-326,-17.85,1500,-326,-17.85,1500,1500
ضهرم7001,اختيارخ اهرم-7000-1402/07/23,1,1,9500000,8000,9500,9500,1500,18.75,9500,1500,18.75,9500,9500
ضخود2035,اختيارخ خودرو-3750-1402/02/13,1,10,4500000,690,450,450,-240,-34.78,450,-240,-34.78,450,450
ضصاد1129,اختيارخ وبصادر-1900-1401/11/19,1,219,35040000,249,160,160,-89,-35.74,160,-89,-35.74,160,160
ضدي209,اختيارخ دي-900-14020217,1,300,57000000,170,190,190,20,11.76,190,20,11.76,190,190
