نماد,نام,تعداد,حجم,ارزش,دیروز,اولین,آخرین معامله - مقدار,آخرین معامله - تغییر,آخرین معامله - درصد,قیمت پایانی - مقدار,قیمت پایانی - تغییر,قیمت پایانی - درصد,کمترین,بیشترین
فروژ,صنايع فروآلياژ ايران,105413,41799779,2171127107400,49500,51950,51950,2450,4.95,51950,2450,4.95,50500,51950
گدنا,تهيه توزيع غذاي دنا آفرين فدك,35199,263678562,3294404947010,12030,12870,12870,840,6.98,12490,460,3.82,11600,12870
خودرو,ايران‌ خودرو,34319,1511241065,4740116710902,3231,3341,3154,-77,-2.38,3137,-94,-2.91,3070,3359
خساپا,سايپا,28310,1646720854,4080284294580,2415,2530,2467,52,2.15,2478,63,2.61,2328,2535
خگستر,گسترش‌سرمايه‌گذاري‌ايران‌خودرو,26606,717229754,3030886111230,4374,4510,4187,-187,-4.28,4226,-148,-3.38,4068,4540
پالايش,صندوق پالايشي يكم-سهام,17032,19311469,2291875275550,119180,120500,119000,-180,-0.15,118680,-500,-0.42,116500,120900
شتران,پالايش نفت تهران,16280,402402556,1741949207556,4370,4410,4288,-82,-1.88,4329,-41,-0.94,4240,4480
دي,بانك دي,14948,665446942,578714463197,861,881,863,2,0.23,870,9,1.05,836,900
شستا,سرمايه گذاري تامين اجتماعي,13565,629196934,651713481539,1043,1062,1029,-14,-1.34,1036,-7,-0.67,1017,1068
طلا,صندوق س.پشتوانه طلاي لوتوس,11705,10390609,1657760155745,168722,164500,156700,-12022,-7.13,159544,-9178,-5.44,154802,165800
دارا يكم,صندوق واسطه گري مالي يكم-سهام,10994,13518276,1617575668960,120210,122450,118050,-2160,-1.8,119660,-550,-0.46,116800,122990
عيار,صندوق طلاي عيار مفيد,10378,12733743,827982630682,70071,70153,63315,-6756,-9.64,65023,-5048,-7.2,63064,70480
اهرم,صندوق س سهامي كاريزما- اهرمي,10323,149532573,2165086540040,14540,14900,14310,-230,-1.58,14480,-60,-0.41,13810,15030
كرمان,س. توسعه و عمران استان كرمان,10193,475618533,549605780472,1136,1195,1150,14,1.23,1156,20,1.76,1110,1198
شپنا,پالايش نفت اصفهان,10089,165589522,1269463555530,7750,7830,7710,-40,-0.52,7670,-80,-1.03,7510,7880
شبندر,پالايش نفت بندرعباس,9824,139565686,1302441159320,9390,9480,9300,-90,-0.96,9330,-60,-0.64,9160,9510
خاور,ايران خودرو ديزل,9090,336344721,1244602472829,3713,3818,3718,5,0.13,3700,-13,-0.35,3602,3824
وتجارت,بانك تجارت,8823,352007413,633103606139,1816,1870,1776,-40,-2.2,1799,-17,-0.94,1745,1872
وبملت,بانك ملت,8509,330246579,1175594624786,3594,3635,3529,-65,-1.81,3560,-34,-0.95,3470,3695
تسه1401,امتيازتسهيلات مسكن سال1401,7716,304521,371240677093,1207264,1225000,1210027,2763,0.23,1219097,11833,0.98,1160000,1225000
غزر,صنعتي زر ماكارون,7348,81335293,345097451313,4331,4435,4208,-123,-2.84,4243,-88,-2.03,4116,4435
فولاد,فولاد مباركه اصفهان,7263,136778785,852041899700,6180,6240,6260,80,1.29,6230,50,0.81,6110,6380
كالا,بورس كالاي ايران,6836,37899298,755438614070,20090,20610,19930,-160,-0.8,19930,-160,-0.8,19260,20720
فملي,ملي‌ صنايع‌ مس‌ ايران‌,6636,103056988,805151440810,7700,7820,7830,130,1.69,7810,110,1.43,7690,8050
هماي,صندوق س هماي آگاه-ثابت,6619,198080264,1984557822713,10013,10019,10020,7,0.07,10019,6,0.06,10018,10020
فزر,پويا زركان آق دره,6549,19188148,663400155600,35900,36750,34300,-1600,-4.46,34550,-1350,-3.76,33750,36750
فتوسا,توليد و توسعه سرب روي ايرانيان,6368,44447212,352660940070,7940,8060,8080,140,1.76,7930,-10,-0.13,7450,8400
حفارس,حمل و نقل بين المللي خليج فارس,6178,89880675,1411638551910,15300,15500,15480,180,1.18,15710,410,2.68,15080,16060
وساپا,سرمايه‌گذاري‌ سايپا,6001,134094061,786153646730,5980,6200,5850,-130,-2.17,5860,-120,-2.01,5570,6290
افران,صندوق س افرا نماد پايدار-ثابت,5958,165831779,3143425949630,18942,18955,18956,14,0.07,18956,14,0.07,18955,18956
خبهمن,گروه‌بهمن‌,5913,226216589,506743109613,2290,2360,2200,-90,-3.93,2240,-50,-2.18,2157,2371
هاي وب,داده گسترعصرنوين-هاي وب,5862,172690671,467417186617,2684,2754,2669,-15,-0.56,2707,23,0.86,2600,2800
خنصير,مهندسي‌نصيرماشين‌,5775,31490909,527139860290,17400,17710,16400,-1000,-5.75,16740,-660,-3.79,16190,18390
تليسه,دامداري تليسه نمونه,5557,82552170,338142137870,3969,4120,4079,110,2.77,4096,127,3.2,3930,4210
حكشتي,كشتيراني جمهوري اسلامي ايران,5302,21779628,601216518160,27620,28000,27490,-130,-0.47,27600,-20,-0.07,26330,28460
انرژي,بورس انرژي ايران,5146,8204995,338196133110,42230,43150,40560,-1670,-3.95,41220,-1010,-2.39,39800,43550
وپاسار,بانك  پاسارگاد,4871,68042953,367455522030,5480,5550,5310,-170,-3.1,5400,-80,-1.46,5230,5670
دانا,بيمه دانا,4865,116467002,357157609238,3077,3100,3036,-41,-1.33,3067,-10,-0.32,2958,3238
كمند,صندوق س. با درآمد ثابت كمند,4852,198484874,2007153285700,10106,10112,10113,7,0.07,10112,6,0.06,10112,10113
فرابورس,فرابورس ايران,4838,30839115,349148192680,11190,11530,11270,80,0.71,11320,130,1.16,10810,11710
بوعلي,پتروشيمي بوعلي سينا,4774,12374617,445800736820,34520,35710,36240,1720,4.98,36030,1510,4.37,35200,36240
ورنا,سرمايه‌گذاري‌ رنا(هلدينگ‌,4772,89633516,625602075760,6930,7270,7000,70,1.01,6980,50,0.72,6450,7320
وسپهر,سرمايه گذاري مالي سپهرصادرات,4743,20061097,177866122030,9240,9470,8800,-440,-4.76,8870,-370,-4,8610,9470
نهال,صندوق س. طلاي سرخ نوويرا,4653,22895009,358191173234,14889,15690,15435,546,3.67,15645,756,5.08,15377,15940
ضسپا1211,اختيارخ خساپا-3250-1401/12/10,4553,1853364,123827948000,78,91,54,-24,-30.77,67,-11,-14.1,42,99
ثاميد,توسعه و عمران اميد,4428,41385063,78032383437,1843,1900,1905,62,3.36,1886,43,2.33,1846,1927
اسياتك,انتقال داده هاي آسياتك,4345,11171160,185456402690,16900,17000,16320,-580,-3.43,16600,-300,-1.78,16100,17100
شپديس,پتروشيمي پرديس,4332,3078223,486754509930,158590,160000,157200,-1390,-0.88,158130,-460,-0.29,156700,160850
وآذر,سرمايه‌گذاري‌توسعه‌آذربايجان‌,4210,5896548,761343003450,127900,129800,129850,1950,1.52,129120,1220,0.95,126010,131990
فاذر,صنايع‌ آذرآب‌,4199,350430646,600797178249,1636,1717,1717,81,4.95,1714,78,4.77,1640,1717
ولساپا,ليزينگ رايان‌ سايپا,4195,213936537,357381584192,1748,1800,1661,-87,-4.98,1671,-77,-4.41,1626,1800
خمحركه,نيرو محركه‌,4132,56738745,345021851730,6250,6370,6090,-160,-2.56,6080,-170,-2.72,5820,6490
وساخت,سرمايه‌ گذاري‌ ساختمان‌ايران‌,4113,337567445,578970265573,1608,1710,1720,112,6.97,1715,107,6.65,1680,1720
ختوقا,قطعات‌ اتومبيل‌ ايران‌,3981,70094891,329338428250,4750,4820,4640,-110,-2.32,4700,-50,-1.05,4430,5030
كوير,توليدي فولاد سپيد فراب كوير,3943,77278065,265346236067,3442,3472,3390,-52,-1.51,3434,-8,-0.23,3270,3574
غنوش,نوش‌ مازندران‌,3903,24981744,239768269990,9670,9850,9490,-180,-1.86,9600,-70,-0.72,9260,10030
خكار,ايركا پارت صنعت,3881,125377421,418787148804,3147,3335,3367,220,6.99,3340,193,6.13,3102,3367
وكبهمن,مديريت سرمايه گذاري كوثربهمن,3850,47583725,170596244463,3414,3624,3526,112,3.28,3585,171,5.01,3502,3635
وبصادر,بانك صادرات ايران,3834,281260852,541744542944,1921,1958,1894,-27,-1.41,1926,5,0.26,1870,1979
نوري,پتروشيمي نوري,3824,3308041,340641373720,103010,105320,102490,-520,-0.5,102970,-40,-0.04,101900,105320
شيراز,پتروشيمي‌شيراز,3816,5869683,512654575750,83800,86380,87950,4150,4.95,87340,3540,4.22,84810,89660
مثقال,صندوق س.پشتوانه طلاي زرين آگاه,3810,12898967,255096078784,20666,22700,19155,-1511,-7.31,19776,-890,-4.31,19100,22700
قچار,فراوردههاي غذايي وقند چهارمحال,3727,22694967,257413176460,11470,11690,11110,-360,-3.14,11340,-130,-1.13,10950,11880
پترول,گ.س.وت.ص.پتروشيمي خليج فارس,3705,87186874,206689618273,2421,2442,2345,-76,-3.14,2371,-50,-2.07,2300,2480
اردستان,سيمان اردستان,3574,1725679,19224064060,10610,11140,11140,530,5,11140,530,5,11140,11140
آپ,آسان پرداخت پرشين,3545,38772566,293753150880,7230,7330,7730,500,6.92,7580,350,4.84,7330,7730
اعتماد,صندوق س.اعتماد آفرين پارسيان-د,3529,66519278,3405005801174,51147,51186,51187,40,0.08,51188,41,0.08,51186,51216
شبريز,پالايش نفت تبريز,3490,13259186,222202677000,16760,16940,16680,-80,-0.48,16760,0,0,16350,17290
كزغال,زغال سنگ پروده طبس,3475,17055493,364107631700,20100,20300,21100,1000,4.98,21350,1250,6.22,20300,21500
كگل,معدني و صنعتي گل گهر,3467,29942264,259685755850,8720,8880,8580,-140,-1.61,8670,-50,-0.57,8400,8930
خصدرا,صنعتي‌ دريايي‌ ايران‌,3455,144530069,332600649173,2247,2274,2302,55,2.45,2301,54,2.4,2240,2314
ميدكو,توسعه معادن وص.معدني خاورميانه,3437,17184071,204407777810,12030,12110,11860,-170,-1.41,11900,-130,-1.08,11520,12320
غگل,گلوكوزان‌,3430,33783872,211932780550,6400,6420,6170,-230,-3.59,6270,-130,-2.03,6000,6560
فلوله,لوله‌وماشين‌سازي‌ايران‌,3394,119839294,285060761691,2277,2277,2390,113,4.96,2379,102,4.48,2277,2390
توان,صندوق س. اهرمي توان مفيد-س,3393,57700868,710072912016,12302,12485,12250,-52,-0.42,12306,4,0.03,12130,12650
كارا,صندوق س. كارا -د,3357,276623166,3647124634199,13175,13184,13185,10,0.08,13184,9,0.07,13184,13187
غديس,پاكديس,3256,27329754,560379987380,19210,19990,20550,1340,6.98,20500,1290,6.72,19790,20550
سپيد,سپيد ماكيان,3242,6907763,139525310240,20260,20580,20100,-160,-0.79,20200,-60,-0.3,19680,20740
ثبهساز,بهساز كاشانه تهران,3224,25002800,48921543043,1938,1974,1949,11,0.57,1957,19,0.98,1910,2045
ثنور,سرمايه گذاري كوه نور,3215,26190254,186626661200,7250,7180,7280,30,0.41,7130,-120,-1.66,7040,7380
امين يكم,صندوق درآمد ثابت امين يكم فردا,3145,160896869,1592468588917,9798,9854,9929,131,1.34,9897,99,1.01,9801,9938
بگيلان,توسعه مسير برق گيلان,3144,10765843,167829658380,14910,15650,15650,740,4.96,15590,680,4.56,15060,15650
سحرخيز,صندوق س. گروه زعفران سحرخيز,3135,11782634,264445508086,21281,22260,22243,962,4.52,22444,1163,5.46,21600,23300
وخارزم,سرمايه گذاري خوارزمي,3125,54466683,244235551824,4500,4600,4480,-20,-0.44,4484,-16,-0.36,4370,4650
فاسمين,كالسيمين‌,3066,15783648,422873880970,25830,27330,26590,760,2.94,26790,960,3.72,25830,27540
شلرد,كود شيميايي اوره لردگان,3048,33686747,306147403340,8860,9110,9040,180,2.03,9090,230,2.6,8910,9120
غگيلا,شيرپاستوريزه پگاه گيلان,3022,8099901,196645678650,25700,25700,24300,-1400,-5.45,24300,-1400,-5.45,23950,25700
بركت,گروه دارويي بركت,2991,12243788,158473437920,13030,13010,12870,-160,-1.23,12940,-90,-0.69,12530,13400
ديران,ايران‌دارو,2979,16341402,250454137470,14920,15460,15190,270,1.81,15330,410,2.75,14480,15660
ثفارس,عمران‌وتوسعه‌فارس‌,2953,35287122,317019677540,8860,9000,8720,-140,-1.58,8980,120,1.35,8530,9300
آگاس,صندوق س.هستي بخش آگاه-س,2932,7051022,713810191745,100069,101600,100883,814,0.81,101235,1166,1.17,99610,101997
كيان,صندوق س. با درآمد ثابت كيان,2922,28645510,1145402320286,39958,39984,39985,27,0.07,39985,27,0.07,39836,40188
دتوليد,داروسازي توليد دارو,2880,22932219,260659541450,10680,11350,11420,740,6.93,11370,690,6.46,10800,11420
ارزش مسكن,ص.س.املاك ومستغلات ارزش مسكن,2826,1461933,16788696651,11514,11500,11477,-37,-0.32,11484,-30,-0.26,11391,11568
اپال,فرآوري معدني اپال كاني پارس,2824,6632002,111895936090,17300,17080,16800,-500,-2.89,16880,-420,-2.43,16630,17440
خمهر,مهركام‌پارس‌,2812,92645779,235950739708,2630,2661,2540,-90,-3.42,2547,-83,-3.16,2499,2728
سكه مركزي,سلف تمام سكه 001 مركزي,2787,504300,1112678545000,2273203,2270000,2190000,-83203,-3.66,2206382,-66821,-2.94,2166310,2270000
كدما,معدني‌ دماوند,2784,2729490,158914167090,59860,60640,57120,-2740,-4.58,58220,-1640,-2.74,56870,61290
غدشت,دشت‌ مرغاب‌,2751,4541824,172072544820,39230,38530,37270,-1960,-5,37890,-1340,-3.42,37270,39290
سآبيك,سيمان آبيك,2705,3825874,56361418560,14430,14700,14660,230,1.59,14730,300,2.08,14410,15100
حآسا,آسيا سير ارس,2683,14281293,159119414110,11590,12290,10780,-810,-6.99,11140,-450,-3.88,10780,12290
سيتا,سرمايه گذاري سيمان تامين,2668,7032617,80808228870,11170,11190,11500,330,2.95,11490,320,2.86,11190,11620
شاروم,پتروشيمي اروميه,2625,4096006,83631133750,20200,20600,20200,0,0,20400,200,0.99,19500,21050
سنير,سيمان‌ سفيد ني‌ريز,2625,3807000,145706329010,38230,39300,37170,-1060,-2.77,38270,40,0.1,36420,39990
زشگزا,شير و گوشت زاگرس شهركرد,2618,37795701,279620541220,6980,7160,7460,480,6.88,7400,420,6.02,7160,7460
ضخود1205,اختيارخ خودرو-2000-1401/12/03,2606,314754,337269530000,1157,1220,1015,-142,-12.27,1072,-85,-7.35,952,1300
وپارس,بانك‌پارسيان‌,2599,85304897,163344798391,1951,1998,1882,-69,-3.54,1915,-36,-1.85,1856,2000
ولبهمن,شركت بهمن ليزينگ,2597,51231798,156051349399,2941,3070,3019,78,2.65,3046,105,3.57,2961,3126
گوهر,صندوق سكه طلاي كيان,2592,3159460,345101907518,112499,112221,107001,-5498,-4.89,109228,-3271,-2.91,106600,112221
سمگا,گروه سرمايه گذاري ميراث فرهنگي,2588,30029834,204571130860,6930,6980,6710,-220,-3.17,6810,-120,-1.73,6560,7140
افرا,افرانت,2567,6896300,171517837050,24600,25500,24350,-250,-1.02,24850,250,1.02,23600,26050
اخابر,مخابرات ايران,2521,45533795,358948066750,7740,7900,7730,-10,-0.13,7880,140,1.81,7570,8040
ماديرا,صنايع ماديران,2502,49736832,199010362567,4079,4160,3876,-203,-4.98,4001,-78,-1.91,3876,4199
سفارس,سيمان فارس و خوزستان,2502,14559924,333896110840,21510,22000,22900,1390,6.46,22930,1420,6.6,21800,23010
مديريت,س. و خدمات مديريت صند. ب كشوري,2489,18402372,74418625271,4061,4110,4017,-44,-1.08,4044,-17,-0.42,3962,4139
آبادا,توليد نيروي برق آبادان,2451,2959736,35267199980,12080,12470,11920,-160,-1.32,11920,-160,-1.32,11540,12470
قثابت,قند ثابت‌ خراسان‌,2444,46910421,124657240099,2732,2745,2614,-118,-4.32,2657,-75,-2.75,2596,2799
بورس,بورس اوراق بهادار تهران,2398,28755871,193873020830,6810,6990,6710,-100,-1.47,6740,-70,-1.03,6480,7040
غبشهر,صنعتي‌ بهشهر,2397,49453795,145856640276,3001,3004,2890,-111,-3.7,2949,-52,-1.73,2877,3045
تاپكيش,تجارت الكترونيك پارسيان كيش,2397,12256800,118829522500,10230,10300,9670,-560,-5.47,9690,-540,-5.28,9520,10430
سصفها,سيمان‌اصفهان‌,2361,2259487,170896424850,72100,74020,75700,3600,4.99,75640,3540,4.91,73090,75700
آريا,پليمر آريا ساسول,2355,2388711,185754668400,77200,78000,78100,900,1.17,77750,550,0.71,77150,79050
ياقوت,صندوق س ياقوت آگاه-ثابت,2352,26910168,453719749485,16851,16853,16861,10,0.06,16861,10,0.06,16852,16862
خپويش,سازه‌ پويش‌,2341,27582445,614950080190,21250,22310,22310,1060,4.99,22290,1040,4.89,21510,22310
ثشاهد,سرمايه‌ گذاري‌ شاهد,2329,20439231,203384960360,9570,9510,9840,270,2.82,9950,380,3.97,9510,10210
فباهنر,مس‌ شهيدباهنر,2303,6753479,226561648380,32110,33330,33300,1190,3.71,33550,1440,4.48,33010,34350
شفن,پتروشيمي فناوران,2295,24167385,143223441570,5970,6000,5840,-130,-2.18,5930,-40,-0.67,5790,6140
ددانا,داروسازي دانا,2267,2215131,80617403550,36350,36550,36250,-100,-0.28,36400,50,0.14,35800,37200
كهمدا,شيشه‌ همدان‌,2256,38020161,455063173740,11370,11550,12160,790,6.95,11970,600,5.28,11390,12160
ولصنم,ليزينگ‌صنعت‌ومعدن‌,2255,147199755,816224467699,5186,5489,5549,363,7,5545,359,6.92,5369,5549
ومعادن,توسعه‌معادن‌وفلزات‌,2248,29388232,151754193510,5170,5260,5130,-40,-0.77,5160,-10,-0.19,5090,5320
تپكو,توليدتجهيزات‌سنگين‌هپكو,2241,117911648,202954192415,1675,1725,1725,50,2.99,1721,46,2.75,1675,1725
كمرجان,بازرگاني و توليدي مرجان كار,2192,12275469,110195922340,9020,9150,8810,-210,-2.33,8980,-40,-0.44,8500,9400
چخزر,صنايع چوب خزر كاسپين,2183,1491155,51741076500,35050,35850,34350,-700,-2,34700,-350,-1,33850,35850
خديزل,بهمن  ديزل,2172,34634663,231822427040,6880,6930,6630,-250,-3.63,6690,-190,-2.76,6540,7140
دكوثر,داروسازي‌ كوثر,2168,29749233,209126922360,6960,6810,7140,180,2.59,7030,70,1.01,6700,7380
خودكفا,اقتصادي و خودكفايي آزادگان,2143,42009743,332720204540,7720,7740,7950,230,2.98,7920,200,2.59,7590,7950
وملل,اعتباري ملل,2142,47237383,170778550693,3782,3799,3660,-122,-3.23,3615,-167,-4.42,3593,3800
وطوبي,سرمايه گذاري اقتصاد شهر طوبي,2139,65158725,136325482242,2176,2233,2053,-123,-5.65,2092,-84,-3.86,2024,2260
زملارد,كشاورزي و دامپروري ملارد شير,2116,1757273,22909302390,13190,13350,12980,-210,-1.59,13040,-150,-1.14,12540,13700
ختور,رادياتور ايران‌,2101,22701367,135286862210,6070,6290,5880,-190,-3.13,5960,-110,-1.81,5700,6320
سرچشمه,سرمايه گذاري مس سرچشمه,2096,72084011,358223576738,4738,4974,4974,236,4.98,4970,232,4.9,4875,4974
لكما,كارخانجات‌مخابراتي‌ايران‌,2096,87340741,102085576878,1192,1191,1157,-35,-2.94,1169,-23,-1.93,1157,1218
بپيوند,برق و انرژي پيوندگستر پارس,2074,2306728,25855414360,11360,11240,11140,-220,-1.94,11210,-150,-1.32,10570,11790
ثالوند,سرمايه گذاري مسكن الوند,2066,22680289,256988242440,12020,12690,11180,-840,-6.99,11330,-690,-5.74,11180,12690
خموتور,موتورسازان‌تراكتورسازي‌ايران‌,2059,30604074,214083037650,7290,7360,6930,-360,-4.94,7000,-290,-3.98,6930,7490
فگستر,گسترش صنايع روي ايرانيان,2057,11525301,92346115290,7840,8040,7950,110,1.4,8010,170,2.17,7760,8250
پتاير,ايران‌ تاير,2054,60720837,90307016606,1501,1527,1459,-42,-2.8,1487,-14,-0.93,1431,1557
گكوثر,هتل پارسيان كوثر اصفهان,2043,55910098,130273342515,2428,2389,2307,-121,-4.98,2330,-98,-4.04,2307,2439
سپيدار,سپيدار سيستم آسيا,2024,1493050,38234112250,25400,26150,25950,550,2.17,25600,200,0.79,24500,26150
لپارس,پارس‌ الكتريك‌,2013,1380765,111859313390,80480,82990,80000,-480,-0.6,81010,530,0.66,78300,84000
لطيف,محصولات كاغذي لطيف,2005,2065829,131954128250,59900,60700,64050,4150,6.93,63850,3950,6.59,60700,64050
ولپارس,ليزينگ پارسيان,1994,5755259,25217631338,4217,4420,4372,155,3.68,4382,165,3.91,4250,4468
بنو,بيمه تجارت نو,1989,19124086,79264324489,4096,4190,4141,45,1.1,4145,49,1.2,3930,4265
غچين,كشت‌ و صنعت‌ چين‌ چين,1965,25566996,166311825420,6310,6620,6440,130,2.06,6500,190,3.01,6210,6620
آينده,بازرگاني آينده سازان بهشت پارس,1950,16055206,133577021590,8240,8000,8390,150,1.82,8320,80,0.97,8000,8480
اتكاسا,بيمه اتكايي سامان,1931,28121502,121759670857,4208,4200,4334,126,2.99,4330,122,2.9,4200,4334
صبا,گروه مالي صبا تامين,1918,19659822,74597833678,3807,3814,3782,-25,-0.66,3799,-8,-0.21,3767,3878
حتوكا,حمل‌ونقل‌توكا,1913,18624047,149784638680,8010,8200,8040,30,0.37,8040,30,0.37,7690,8320
زبينا,كشاورزي و دامپروري بينالود,1897,32229444,128829056572,3958,4050,3890,-68,-1.72,3997,39,0.99,3801,4150
كرازي,كارخانجات‌توليدي‌شيشه‌رازي‌,1891,44897404,67554160164,1507,1570,1518,11,0.73,1505,-2,-0.13,1466,1570
فخوز,فولاد  خوزستان,1879,53113876,165613406738,3083,3130,3077,-6,-0.19,3118,35,1.14,3070,3220
زر,صندوق س.پشتوانه سكه طلاي زر,1875,1103628,110694758508,107298,107200,98000,-9298,-8.67,100301,-6997,-6.52,97920,107200
غكورش,صنعت غذايي كورش,1867,13500753,134269876450,9860,9910,9900,40,0.41,9950,90,0.91,9760,10050
پدرخش,درخشان‌ تهران‌,1866,11158201,149355250680,13280,13550,13620,340,2.56,13390,110,0.83,12980,13930
سشرق,سيمان‌ شرق‌,1863,13124519,137176544270,10080,10280,10420,340,3.37,10450,370,3.67,10080,10780
سامان,بانك سامان,1861,59798541,164673212228,2803,2830,2719,-84,-3,2754,-49,-1.75,2719,2838
پلاست,كارخانجات توليدي پلاستيران,1860,15157704,173629020620,11690,11340,11490,-200,-1.71,11450,-240,-2.05,11340,12000
فجهان,مجتمع جهان فولاد سيرجان,1845,12069804,38733183510,3211,3213,3176,-35,-1.09,3210,-1,-0.03,3145,3295
خكاوه,سايپا ديزل,1841,17721586,352425484110,20170,20400,19570,-600,-2.97,19980,-190,-0.94,19570,20770
خفنر,فنرسازي‌خاور,1802,7555562,86344928980,11970,12260,11280,-690,-5.76,11430,-540,-4.51,11140,12480
فجر,فولاد اميركبيركاشان,1800,12228431,206791246260,16180,16500,17310,1130,6.98,16910,730,4.51,16230,17310
وهامون,سرمايه گذاري هامون صبا,1792,22440682,48844804343,2182,2174,2140,-42,-1.92,2177,-5,-0.23,2100,2240
كساپا,سايپاشيشه‌,1789,11795347,296857243520,25750,25000,24470,-1280,-4.97,25170,-580,-2.25,24470,27000
توسن,توسعه سامانه ي نرم افزاري نگين,1784,5813072,89186195090,15280,15300,15420,140,0.92,15340,60,0.39,15110,15780
ستران,سيمان‌ تهران‌,1759,11394526,430685856500,35410,36390,37880,2470,6.98,37800,2390,6.75,36200,37880
ثاخت,بين‌المللي‌توسعه‌ساختمان,1752,75253474,222858170033,2830,2919,2971,141,4.98,2961,131,4.63,2892,2971
شگويا,پتروشيمي تندگويان,1738,11371905,136625756230,12050,12270,12010,-40,-0.33,12010,-40,-0.33,11860,12480
غدام,خوراك‌  دام‌ پارس‌,1726,3025918,149289994750,47590,47990,49090,1500,3.15,49340,1750,3.68,47010,49960
وسينا,بانك سينا,1694,70966483,226435639853,3063,3130,3128,65,2.12,3191,128,4.18,3071,3277
وبانك,سرمايه گذاري گروه توسعه ملي,1683,17869799,194241573730,10780,10900,10740,-40,-0.37,10870,90,0.83,10700,11040
چكاپا,گروه صنايع كاغذ پارس,1675,32644458,98215996522,2987,3003,3033,46,1.54,3009,22,0.74,2881,3062
همراه,شركت ارتباطات سيار ايران,1672,19117650,155424236330,8150,8260,8120,-30,-0.37,8130,-20,-0.25,7940,8440
شسينا,صنايع‌شيميايي‌سينا,1666,41472682,97580966890,2408,2373,2320,-88,-3.65,2353,-55,-2.28,2273,2484
استقلال,استقلال,1661,10873952,22693947423,2123,2100,2081,-42,-1.98,2087,-36,-1.7,2081,2146
غسالم,سالمين‌,1659,21599587,98513403029,4606,4749,4499,-107,-2.32,4561,-45,-0.98,4420,4749
ميهن,بيمه ميهن,1655,46320037,307818359760,6360,6460,6630,270,4.25,6650,290,4.56,6380,6670
افق,فروشگاههاي زنجيره اي افق كوروش,1651,11093528,160431792700,14990,15020,14580,-410,-2.74,14460,-530,-3.54,14250,15130
شپلي,پلي اكريل ايران,1648,32167129,363302930900,11000,11200,11330,330,3,11290,290,2.64,10850,11330
وغدير,سرمايه‌گذاري‌غدير(هلدينگ‌,1648,12963341,241926637870,18630,18660,18690,60,0.32,18660,30,0.16,18600,19000
بكام,كارخانجات توليدي شهيد قندي,1639,30308363,77420306458,2664,2696,2530,-134,-5.03,2554,-110,-4.13,2480,2696
نوين,بيمه نوين,1630,44587064,85046440921,1939,1970,1880,-59,-3.04,1907,-32,-1.65,1836,1998
خاذين,سايپاآذين‌,1622,38152475,98651410707,2586,2620,2576,-10,-0.39,2586,0,0,2460,2680
دماوند,توليد نيروي برق دماوند,1600,6952830,150030823950,20850,20800,21300,450,2.16,21600,750,3.6,20750,21850
سامانح,ح. بانك سامان,1597,100822483,157839247906,1531,1576,1550,19,1.24,1566,35,2.29,1487,1576
ثغرب,شركت سرمايه گذاري مسكن شمالغرب,1595,11925252,94249585480,7750,7800,7850,100,1.29,7900,150,1.94,7630,8150
شتوكا,توكا رنگ فولاد سپاهان,1595,6259039,108310674410,18310,18500,17040,-1270,-6.94,17300,-1010,-5.52,17030,18510
ورازي,بيمه رازي,1589,51184682,74567004343,1489,1503,1445,-44,-2.96,1457,-32,-2.15,1445,1517
غويتا,ويتانا,1581,16673836,89977604760,5470,5570,5360,-110,-2.01,5400,-70,-1.28,5180,5620
غپينو,پارس‌ مينو,1581,32343782,111428994474,3442,3515,3420,-22,-0.64,3445,3,0.09,3316,3549
تملت,تامين سرمايه بانك ملت,1570,14126909,45061552775,3198,3190,3200,2,0.06,3190,-8,-0.25,3131,3320
كلر,كلر پارس,1561,1343426,118807281150,86900,87150,88900,2000,2.3,88450,1550,1.78,87150,90400
كي بي سي,شركت كي بي سي,1557,8133424,108525250010,12840,13120,13350,510,3.97,13340,500,3.89,12750,13480
پارس,پتروشيمي پارس,1549,54539097,131713120945,2415,2450,2422,7,0.29,2415,0,0,2396,2450
پارسان,گسترش نفت و گاز پارسيان,1529,5288707,173722201470,33100,33120,32520,-580,-1.75,32850,-250,-0.76,32390,33830
حپترو,حمل و نقل پتروشيمي( سهامي عام,1524,2657287,99508229660,39170,37400,37220,-1950,-4.98,37450,-1720,-4.39,37220,38930
قشير,قند شيروان قوچان و بجنورد,1518,8574828,79670559220,8910,9370,9070,160,1.8,9290,380,4.26,8970,9490
آريان,سرمايه گذاري پارس آريان,1517,21708844,94277583604,4414,4517,4290,-124,-2.81,4349,-65,-1.47,4282,4517
وپويا,سرمايه گذاري پويا,1517,12446300,32728943979,2645,2700,2593,-52,-1.97,2630,-15,-0.57,2552,2728
خزر,فنرسازي‌زر,1512,19309544,98480295190,5220,5450,5050,-170,-3.26,5100,-120,-2.3,4860,5450
زشريف,كشت وصنعت شريف آباد,1500,48312122,249866880670,4850,4950,5180,330,6.8,5170,320,6.6,4890,5180
دامين,داروسازي‌ امين‌,1497,18228770,64651533690,3659,3780,3508,-151,-4.13,3547,-112,-3.06,3458,3780
كسرا,سراميك‌هاي‌صنعتي‌اردكان‌,1485,18004733,107001755550,5950,6070,5980,30,0.5,5940,-10,-0.17,5780,6230
دلقما,دارويي‌ لقمان‌,1482,28815355,89780318189,3116,3100,3159,43,1.38,3116,0,0,2990,3201
فارس,صنايع پتروشيمي خليج فارس,1477,29230289,274464259860,9360,9380,9410,50,0.53,9390,30,0.32,9360,9420
حسير,ريل سير كوثر,1476,4596478,118310556850,25400,25500,26000,600,2.36,25750,350,1.38,24700,26700
ثمسكن,سرمايه‌گذاري‌ مسكن‌,1465,39116004,184287915068,4485,4635,4798,313,6.98,4711,226,5.04,4453,4798
سبزوا,سيمان لار سبزوار,1465,15768823,86031035220,5530,5640,5360,-170,-3.07,5460,-70,-1.27,5200,5700
دسانكو,داروسازي سبحان انكولوژي,1465,14082220,95894252990,6980,7160,6750,-230,-3.3,6810,-170,-2.44,6500,7300
شلعاب,لعابيران‌,1463,23651676,173723081520,7010,7270,7360,350,4.99,7350,340,4.85,7150,7360
ثنوسا,نوسازي‌وساختمان‌تهران‌,1462,24987648,123147581811,4898,4987,4750,-148,-3.02,4928,30,0.61,4660,5140
خچرخش,چرخشگر,1461,4794371,106769276460,22910,23680,22080,-830,-3.62,22270,-640,-2.79,21310,23800
شپارس,بين‌ المللي‌ محصولات‌  پارس‌,1451,17682778,115256350570,6690,6710,6510,-180,-2.69,6520,-170,-2.54,6360,6900
كيمياتك,آريان كيميا تك,1451,3037869,38933640070,12750,12470,12570,-180,-1.41,12820,70,0.55,12410,13260
آكورد,صندوق س. آرمان آتي كوثر-د,1446,11919373,532696180459,44661,44691,44691,30,0.07,44692,31,0.07,44691,44692
وگردش,بانك گردشگري,1437,12560674,100859225840,8070,7910,7970,-100,-1.24,8030,-40,-0.5,7830,8310
كپشيرح,ح . پشم‌شيشه‌ايران‌,1422,14785727,70955830407,5018,4966,4729,-289,-5.76,4799,-219,-4.36,4650,5100
تماوند,تامين سرمايه دماوند,1421,15399266,98583824790,6170,6230,6300,130,2.11,6400,230,3.73,6220,6470
خكرمان,سرمايه گذاري آرمان گستر پاريز,1416,26206336,124820396030,4866,4820,4721,-145,-2.98,4763,-103,-2.12,4721,4929
خوساز,محورسازان‌ايران‌خودرو,1412,9110041,218831237630,22950,24090,24000,1050,4.58,24020,1070,4.66,23110,24090
زقيام,كشت و دام قيام اصفهان,1404,27033941,72565005735,2711,2773,2650,-61,-2.25,2684,-27,-1,2580,2799
ختراك,ريخته‌گري‌ تراكتورسازي‌ ايران‌,1401,14671741,206820447760,14740,15000,14190,-550,-3.73,14100,-640,-4.34,14010,15020
بجهرم,توسعه مولد نيروگاهي جهرم,1384,30515758,67563598430,2226,2211,2188,-38,-1.71,2214,-12,-0.54,2132,2279
مفاخر,توسعه فناوري اطلاعات خوارزمي,1373,12889599,111629457160,8130,8580,8690,560,6.89,8660,530,6.52,8420,8690
وجامي,سرمايه گذاري جامي,1362,27802832,108728609772,4015,3895,3895,-120,-2.99,3911,-104,-2.59,3895,4020
فسازان,غلتك سازان سپاهان,1356,30949589,132129434447,4076,4160,4279,203,4.98,4269,193,4.74,4155,4279
زاگرس,پتروشيمي زاگرس,1354,1831536,249571619150,132500,135000,134400,1900,1.43,136250,3750,2.83,133100,137800
فسبزوار,پارس فولاد سبزوار,1353,1611232,38758841040,23880,23610,23800,-80,-0.34,24060,180,0.75,23600,24300
قهكمت,قندهكمتان‌,1351,9986145,86606020050,8550,8790,8590,40,0.47,8670,120,1.4,8310,8800
فسرب,ملي‌ سرب‌وروي‌ ايران‌,1344,62286737,137552290513,2114,2153,2260,146,6.91,2208,94,4.45,2128,2261
پخش,پخش البرز,1340,5485249,308744468650,53750,56000,56400,2650,4.93,56300,2550,4.74,54050,56400
حبندر,دريايي و کشتيراني خط دريابندر,1339,2928302,41911205950,14470,14680,14220,-250,-1.73,14310,-160,-1.11,14040,14680
فنورد,نوردوقطعات‌ فولادي‌,1339,11257389,187732513610,15910,16200,16700,790,4.97,16680,770,4.84,16100,16700
وبهمن,سرمايه‌گذاري‌بهمن‌,1337,20202927,76970981860,3949,4067,3724,-225,-5.7,3810,-139,-3.52,3673,4067
ونوين,بانك‌اقتصادنوين‌,1336,29791967,108803782409,3660,3681,3621,-39,-1.07,3652,-8,-0.22,3530,3748
كهربا,صندوق س.پشتوانه سكه طلا كهربا,1323,4912507,97940061327,21003,20770,19191,-1812,-8.63,19937,-1066,-5.08,19170,20770
وصنعت,سرمايه گذاري توسعه صنعت وتجارت,1316,33738900,72741043193,2099,2150,2191,92,4.38,2156,57,2.72,2080,2240
خشرق,الكتريك‌ خودرو شرق‌,1312,6140843,105991210720,17850,18200,17070,-780,-4.37,17260,-590,-3.31,16960,18390
غاذر,كشت‌وصنعت‌پياذر,1312,6029367,297507198820,47070,49420,49420,2350,4.99,49340,2270,4.82,47300,49420
غپآذر,شير پگاه آذربايجان شرقي,1300,1527635,67310537100,45600,46000,45000,-600,-1.32,44050,-1550,-3.4,43100,46850
غشهداب,كشت و صنعت شهداب ناب خراسان,1287,28486330,62578409051,2178,2190,2146,-32,-1.47,2197,19,0.87,2130,2285
تاپيكو,س. نفت و گاز و پتروشيمي تأمين,1266,7710339,100069760870,13050,13190,12860,-190,-1.46,12990,-60,-0.46,12830,13240
سكرد,سيمان كردستان,1260,8824402,66923954450,7500,7570,7430,-70,-0.93,7580,80,1.07,7220,7840
بالبر,كابل‌ البرز,1248,1396384,87562097670,65050,62000,61800,-3250,-5,62710,-2340,-3.6,61800,67360
وگستر,گسترش سرمايه گذاري ايرانيان,1247,16991768,93545311830,5350,5420,5410,60,1.12,5510,160,2.99,5200,5700
چكارن,كارتن‌ ايران‌,1241,32395285,121267333145,3838,3990,3779,-59,-1.54,3743,-95,-2.48,3647,3990
قجام,فرآوردههاي غذايي وقندتربت‌جام‌,1227,11576776,92323501470,8130,8230,7890,-240,-2.95,7970,-160,-1.97,7890,8350
خفولا,خدمات فني فولاد يزد,1219,3780108,195229759550,50250,51750,51400,1150,2.29,51650,1400,2.79,50500,51750
بپاس,بيمه پاسارگاد,1207,8096497,158336319650,19600,19500,19400,-200,-1.02,19550,-50,-0.26,19150,19650
واحصا,احياء صنايع خراسان,1207,1079072,71137939850,66950,68700,64950,-2000,-2.99,65950,-1000,-1.49,64950,68900
كاذر,فرآورده‌هاي‌نسوزآذر,1203,22621783,112942328140,5190,5250,4990,-200,-3.85,4990,-200,-3.85,4940,5290
كچاد,معدني‌وصنعتي‌چادرملو,1203,6591945,78022687120,11830,11990,11760,-70,-0.59,11830,0,0,11700,12090
واحيا,م .صنايع و معادن احياء سپاهان,1201,12366030,195232234000,16220,16000,15740,-480,-2.96,15790,-430,-2.65,15740,16200
غمينو,شركت صنايع غذايي مينو شرق,1185,7498535,61968556990,8390,8500,8190,-200,-2.38,8260,-130,-1.55,8070,8550
خريخت,صنايع‌ريخته‌گري‌ايران‌,1173,13656644,55548521384,4113,4160,4020,-93,-2.26,4068,-45,-1.09,3919,4266
ريشمك,توليد و صادرات ريشمك,1173,6269818,150295229000,22450,23850,23950,1500,6.68,23950,1500,6.68,22950,24000
كرماشا,صنايع پتروشيمي كرمانشاه,1170,3667018,238135980610,65140,65940,64600,-540,-0.83,64940,-200,-0.31,63800,65940
لبخند,صندوق س. لبخند فارابي-د,1158,77841604,849280975727,10902,10910,10910,8,0.07,10910,8,0.07,10910,10911
خلنت,لنت‌ ترمزايران‌,1157,1684321,57941053920,34790,35500,34150,-640,-1.84,34400,-390,-1.12,33060,36200
غصينو,صنعتي مينو,1157,5030118,64273192480,13030,13030,12700,-330,-2.53,12780,-250,-1.92,12380,13260
حآفرين,ريل پرداز نو آفرين,1156,19284620,81636156807,4184,4270,4320,136,3.25,4233,49,1.17,4094,4381
شيران,س. صنايع‌شيميايي‌ايران,1152,7176386,78693098400,10730,11180,10860,130,1.21,10950,220,2.05,10680,11220
حريل,ريل پردازسير,1149,16002448,58431625046,3700,3790,3572,-128,-3.46,3651,-49,-1.32,3471,3848
فايرا,آلومينيوم‌ايران‌,1147,24790320,157342964190,6100,6330,6400,300,4.92,6350,250,4.1,6140,6400
تكمبا,كمباين‌ سازي‌ ايران‌,1143,11115026,70878963230,6070,6200,6280,210,3.46,6380,310,5.11,6020,6490
كبافق,معادن‌ بافق‌,1143,3210801,100477447780,32220,31330,30960,-1260,-3.91,31290,-930,-2.89,30610,32950
فسوژ,سوژميران,1143,3499715,69397497450,19880,21100,19480,-400,-2.01,19830,-50,-0.25,18800,21100
خمحور,توليدمحورخودرو,1140,17886238,76251486576,4210,4201,4312,102,2.42,4263,53,1.26,4061,4370
اميد,تامين سرمايه اميد,1135,9836855,56027944610,5560,5700,5610,50,0.9,5700,140,2.52,5400,5830
شاراك,پتروشيمي شازند,1132,3717673,119439117250,32190,32240,31990,-200,-0.62,32130,-60,-0.19,31800,32980
شفارس,صنايع‌ شيميايي‌ فارس‌,1114,37543125,51403869899,1369,1398,1357,-12,-0.88,1369,0,0,1320,1426
زدشت,كشت و صنعت دشت خرم دره,1112,3414005,106195966550,30200,31200,30550,350,1.16,31100,900,2.98,29000,32300
كپارس,كاشي‌ پارس‌,1111,14660450,138131389640,9050,9240,9390,340,3.76,9420,370,4.09,9110,9500
شاوان,پالايش نفت لاوان,1109,4444933,93519438150,21100,21400,21050,-50,-0.24,21050,-50,-0.24,20750,21500
درازك,دارويي‌ رازك‌,1107,5380005,87880225920,16080,16500,16320,240,1.49,16330,250,1.55,15930,16800
شگل,گلتاش‌,1102,26786320,160053688670,5590,5700,5980,390,6.98,5980,390,6.98,5650,5980
ثرود,سرمايه‌گذاري مسكن زاينده رود,1099,5448452,58482207370,10800,10930,10780,-20,-0.19,10730,-70,-0.65,10200,11210
تجلي,تجلي توسعه معادن و فلزات,1095,31073569,45721218905,1473,1508,1475,2,0.14,1471,-2,-0.14,1420,1517
ولكار,ليزينگ كارآفرين,1086,1304192,11031480970,8550,8530,8420,-130,-1.52,8480,-70,-0.82,8400,8620
ساوه,سيمان ساوه,1083,1191998,101620231450,81650,82700,85000,3350,4.1,85250,3600,4.41,82700,85700
ضخود1211,اختيارخ خودرو-3250-1401/12/03,1082,211559,43817681000,309,395,190,-119,-38.51,207,-102,-33.01,138,395
كمينا,شيشه سازي مينا,1079,13200151,128270255510,9960,9850,9670,-290,-2.91,9720,-240,-2.41,9670,10080
چفيبر,فيبر ايران‌,1076,7824301,45705023330,5660,5810,5740,80,1.41,5840,180,3.18,5680,5930
سرود,سيمان‌شاهرود,1070,5270740,154809688790,27510,28800,29430,1920,6.98,29370,1860,6.76,27510,29430
شپاكسا,پاكسان‌,1065,31902959,69711414273,2087,2140,2232,145,6.95,2185,98,4.7,2100,2233
شغدير,پتروشيمي غدير,1063,2082984,146416027720,69530,70500,70800,1270,1.83,70290,760,1.09,69540,72700
كپشير,پشم‌شيشه‌ايران‌,1055,10350913,87846411000,8790,8850,8360,-430,-4.89,8490,-300,-3.41,8360,9210
ومدير,گ.مديريت ارزش سرمايه ص ب كشوري,1054,4105517,17489170819,4239,4250,4229,-10,-0.24,4260,21,0.5,4207,4350
زكوثر,سرمايه گذاري كشاورزي كوثر,1049,3460401,56363722650,16070,16030,16400,330,2.05,16290,220,1.37,15880,16750
حخزر,كشتيراني درياي خزر,1048,24548514,731090739650,28400,28050,29800,1400,4.93,29800,1400,4.93,28000,29800
زنگان,صنعت روي زنگان,1044,896081,57325991450,65000,68400,63950,-1050,-1.62,63950,-1050,-1.62,62800,68400
فوكا,فولاد كاويان,1035,5357536,70594387430,13160,13480,13200,40,0.3,13180,20,0.15,12770,13550
آ س پ,آ.س.پ,1035,16968419,116593320620,6430,6650,6880,450,7,6870,440,6.84,6650,6880
دفارا,داروسازي‌ فارابي‌,1035,5880843,129215496380,21790,22000,22090,300,1.38,21970,180,0.83,21350,22680
واميد,گروه مديريت سرمايه گذاري اميد,1033,16335146,214078094960,13220,13220,12960,-260,-1.97,13110,-110,-0.83,12960,13330
شسپا,نفت سپاهان,1031,19498849,80061477416,4107,4124,4104,-3,-0.07,4106,-1,-0.02,4077,4159
رتاپ,تجارت الكترونيك  پارسيان,1030,8483813,26105440803,3102,3110,3036,-66,-2.13,3077,-25,-0.81,3001,3169
سيمرغ,سيمرغ,1021,3331071,85412920710,25520,26000,25550,30,0.12,25640,120,0.47,25000,26520
آباد,توريستي ورفاهي آبادگران ايران,1020,2671843,74147830400,26840,26920,27730,890,3.32,27750,910,3.39,26460,28180
ولغدر,ليزينگ‌خودروغدير,1006,14394093,62026462295,4328,4480,4230,-98,-2.26,4309,-19,-0.44,4131,4480
رنيك,جنرال مكانيك,1002,4174274,67200902530,15470,15150,15820,350,2.26,16100,630,4.07,15150,16240
وملي,گروه‌ صنعتي‌ ملي‌ (هلدينگ‌,999,443795,63033663190,141950,143000,139850,-2100,-1.48,142030,80,0.06,138000,147200
قصفها,قنداصفهان‌,999,936150,89272721590,99780,100000,94800,-4980,-4.99,95360,-4420,-4.43,94800,100000
اطلس,صندوق س.توسعه اطلس مفيد-س,994,1391372,449248415016,319195,324800,320755,1560,0.49,322882,3687,1.16,317005,325500
شوينده,مديريت صنعت شوينده ت.ص.بهشهر,993,5012260,96497673310,18240,18490,19510,1270,6.96,19250,1010,5.54,18490,19510
مداران,داده‌پردازي‌ايران‌,978,6934089,47758641610,7130,6990,6790,-340,-4.77,6890,-240,-3.37,6780,7290
ولشرق,ليزينگ ايران و شرق,977,14454798,50410545216,3443,3530,3465,22,0.64,3487,44,1.28,3381,3588
توريل,توكاريل,970,14219927,152575211480,10250,10510,10760,510,4.98,10730,480,4.68,10330,10760
پارتا,مجتمع صنعتي آرتاويل تاير,969,4777178,42301053590,9150,9550,8700,-450,-4.92,8850,-300,-3.28,8700,9550
زكشت,كشاورزي مكانيزه اصفهان كشت,953,2296161,64496421400,28800,29400,27850,-950,-3.3,28100,-700,-2.43,26800,29750
شكام,صنايع شيميايي كيمياگران امروز,953,12047328,102230169620,8330,8540,8400,70,0.84,8490,160,1.92,8330,8740
خفناور,مهندسي صنعتي روان فن آور,948,3732959,92908549700,24550,25150,24750,200,0.81,24900,350,1.43,23850,25250
كارين,صندوق س نگين سامان-ثابت,945,36712236,367796737874,10013,10018,10019,6,0.06,10018,5,0.05,10018,10019
آوند,صندوق س. آوند مفيد-د,942,47525929,525037326049,11041,11048,11048,7,0.06,11047,6,0.05,11047,11048
كروي,توسعه‌ معادن‌ روي‌ ايران‌,942,3132837,93674004280,29380,30960,29820,440,1.5,29900,520,1.77,29500,30960
بكهنوج,توليد برق ماهتاب كهنوج,940,25475605,37649191789,1428,1450,1460,32,2.24,1478,50,3.5,1432,1499
خعمرا,توسعه و عمران شهرستان نائين,934,5436640,31277404650,5860,5760,5690,-170,-2.9,5750,-110,-1.88,5690,5980
چدن,توليدي چدن سازان,926,19657358,48415170288,2508,2512,2405,-103,-4.11,2463,-45,-1.79,2383,2578
سشمال,سيمان‌ شمال‌,924,11720617,156642034380,12530,13220,13400,870,6.94,13360,830,6.62,12840,13400
هامرز,صندوق س اعتماد هامرز-ثابت,924,53490374,540984017155,10107,10113,10114,7,0.07,10114,7,0.07,10113,10114
كاريس,صندوق س.سپند كاريزما-س,917,1748432,30529082054,17439,17460,17379,-60,-0.34,17461,22,0.13,17251,17620
شراز,پالايش نفت شيراز,917,3926643,58693515240,15010,15190,14830,-180,-1.2,14950,-60,-0.4,14780,15290
وآوا,سرمايه گذاري آوا نوين,915,11125781,34703725805,3151,3160,3114,-37,-1.17,3119,-32,-1.02,2980,3300
سدور,سيمان‌ دورود,915,5802085,52918581620,8870,8930,9050,180,2.03,9120,250,2.82,8900,9240
قاسم,قاسم ايران,915,13351845,97788240220,7260,7280,7120,-140,-1.93,7320,60,0.83,7080,7560
غشاذر,پگاه‌آذربايجان‌غربي‌,905,6387382,44083494740,6840,6940,6900,60,0.88,6900,60,0.88,6700,7120
سمايه,بانك سرمايه,903,8903328,48068356490,5520,5610,5370,-150,-2.72,5400,-120,-2.17,5360,5610
ساروم,سيمان‌اروميه‌,902,3631470,111707107100,29900,30570,30640,740,2.47,30760,860,2.88,30020,31520
اتكام,بيمه اتكايي امين,896,94087195,427683027492,4330,4403,4546,216,4.99,4546,216,4.99,4403,4546
پرسپوليس,پرسپوليس,893,2720258,6810485884,2538,2558,2488,-50,-1.97,2516,-22,-0.87,2488,2558
شپاس,نفت پاسارگاد,890,5100561,104511087670,19960,20950,20350,390,1.95,20490,530,2.66,19270,20950
ملت,بيمه ملت,885,30567209,50480723648,1687,1720,1615,-72,-4.27,1651,-36,-2.13,1590,1728
وپسا,س. پتروشيمي ساختمان  خليج فارس,884,20199988,35501795629,1804,1810,1768,-36,-2,1758,-46,-2.55,1750,1830
غپاك,لبنيات‌ پاك‌,879,4918931,63007166980,13230,13150,12780,-450,-3.4,12810,-420,-3.17,12570,13470
وسرمد,بيمه  سرمد,878,23506292,39624729681,1730,1696,1679,-51,-2.95,1686,-44,-2.54,1679,1750
والبر,سرمايه‌ گذاري‌ البرز(هلدينگ‌,873,13196540,83579228580,6250,6270,6400,150,2.4,6330,80,1.28,6240,6430
كگاز,شيشه‌ و گاز,868,3685607,57582534360,15450,15200,15210,-240,-1.55,15620,170,1.1,14960,16200
قنيشا,قند  نيشابور,867,15543093,43704232450,2832,2910,2798,-34,-1.2,2812,-20,-0.71,2744,2910
غنيلي,مجتمع توليدي نيلي صنعت كرمان,860,20171773,109897130520,5194,5450,5450,256,4.93,5450,256,4.93,5230,5450
كتوكا,توليدي و خدمات صنايع نسوز توكا,856,12790727,141153375940,10330,11040,11050,720,6.97,11040,710,6.87,10680,11050
وايران,ليزينگ ايرانيان,855,10461243,43354179346,4207,4299,4080,-127,-3.02,4144,-63,-1.5,3921,4299
خكمك,كمك‌فنرايندامين‌,854,3734343,84227718710,23380,23550,22480,-900,-3.85,22550,-830,-3.55,22220,24540
ونيرو,سرمايه‌گذاري‌نيرو,853,15094906,39684251854,2631,2635,2588,-43,-1.63,2629,-2,-0.08,2501,2748
فنوال,نورد آلومينيوم‌,847,6532463,44856604760,6940,7010,6920,-20,-0.29,6870,-70,-1.01,6550,7200
كيميا,معدني كيمياي زنجان گستران,842,15363692,125412649230,8050,8250,8200,150,1.86,8160,110,1.37,7950,8450
ارفع,شركت آهن و فولاد ارفع,835,2592631,47642140090,18050,18500,18490,440,2.44,18230,180,1,18000,18740
شبصير,توليدات پتروشيمي قائد بصير,831,498590,61111549850,120800,124000,122000,1200,0.99,122550,1750,1.45,120900,124200
درهآور,دارويي ره آورد تامين,829,1670776,117687382550,67700,68450,70500,2800,4.14,70450,2750,4.06,68450,71850
غبهار,كشت وصنعت بهاران گلبهار خراسان,826,3108274,49936065800,16370,16480,15920,-450,-2.75,16070,-300,-1.83,15880,16480
وتوصا,گروه س توسعه صنعتي ايران,825,4962225,41006509380,8190,8250,8230,40,0.49,8260,70,0.85,8050,8450
وهور,مديريت انرژي اميد  تابان هور,823,37082100,55571290651,1541,1501,1510,-31,-2.01,1499,-42,-2.73,1466,1589
قشكر,شكرشاهرود,822,13459507,31700138443,2376,2492,2300,-76,-3.2,2355,-21,-0.88,2258,2492
غشان,شيرپاستوريزه‌پگاه‌خراسان‌,819,8214732,56280673000,7150,7140,6690,-460,-6.43,6850,-300,-4.2,6650,7290
وآرين,شركت توسعه اقتصادي آرين,817,16440269,23191479489,1440,1441,1397,-43,-2.99,1411,-29,-2.01,1397,1472
زفكا,كشت و دامداري فكا,816,5103465,67160317340,13460,13590,12900,-560,-4.16,13160,-300,-2.23,12540,13890
رمپنا,گروه مپنا (سهامي عام),816,5916974,69449601170,11960,12290,11610,-350,-2.93,11830,-130,-1.09,11550,12290
كفپارس,فرآورده‌هاي‌ نسوز پارس‌,811,16581802,73689729687,4340,4330,4400,60,1.38,4444,104,2.4,4330,4570
سرو,صندوق س سروسودمند مدبران-سهام,811,1152185,108426255240,93450,94020,93280,-170,-0.18,94100,650,0.7,92100,95750
اعتلا,شركت سرمايه گذاري اعتلاء البرز,809,21129108,110494205490,5220,5430,5160,-60,-1.15,5230,10,0.19,4960,5470
ومهان,گروه توسعه مالي مهر آيندگان,808,4469393,25058069980,5620,5660,5570,-50,-0.89,5620,0,0,5530,5720
بخاور,بيمه زندگي خاورميانه,805,7926597,21864638734,2843,2824,2736,-107,-3.76,2758,-85,-2.99,2710,2848
تكشا,گسترش‌صنايع‌وخدمات‌كشاورزي‌,805,1919362,51506837790,27480,27500,26110,-1370,-4.99,26840,-640,-2.33,26110,28200
غپونه,نوش پونه مشهد,803,2567206,43125402580,17340,18000,16530,-810,-4.67,16800,-540,-3.11,16480,18000
سپاها,سيمان‌سپاهان‌,803,6912412,85486829220,12080,12250,12360,280,2.32,12370,290,2.4,11960,12630
ودي,بيمه  دي,800,16813321,80667392954,4695,4720,4743,48,1.02,4798,103,2.19,4551,4990
سخاش,سيمان‌خاش‌,800,760949,57399941860,72480,71700,75540,3060,4.22,75430,2950,4.07,71700,76100
پلاسك,پلاسكوكار,790,12941902,53809189099,4180,4260,4201,21,0.5,4158,-22,-0.53,4012,4316
كطبس,ذغال‌سنگ‌ نگين‌ ط‌بس‌,787,3119507,51251858270,16420,16920,16630,210,1.28,16430,10,0.06,16010,16920
چكاوه,صنايع‌كاغذسازي‌كاوه‌,786,4223231,52279429960,12600,12990,12590,-10,-0.08,12380,-220,-1.75,12000,12990
خرينگ,رينگ‌سازي‌مشهد,783,2953664,86664216930,28660,28600,29180,520,1.81,29340,680,2.37,28200,30090
حتايد,تايدواترخاورميانه,782,8525234,45981713210,5410,5550,5400,-10,-0.18,5390,-20,-0.37,5290,5590
شبهرن,نفت‌ بهران‌,780,3651676,72712756250,19930,20060,19850,-80,-0.4,19920,-10,-0.05,19820,20180
سفار,سيمان‌فارس‌,772,600243,58595442940,97040,101000,96600,-440,-0.45,97620,580,0.6,93000,101000
ضسپا1206,اختيارخ خساپا-2200-1401/12/10,770,180173,63792188000,321,331,333,12,3.74,354,33,10.28,256,435
وثوق,سرمايه گذاري وثوق امين,763,2795638,64302440250,23000,23450,23000,0,0,23000,0,0,22600,23500
ثپرديس,سرمايه گذاري مسكن پرديس,762,5784532,32073401050,5550,5610,5500,-50,-0.9,5540,-10,-0.18,5270,5840
غشصفا,شيرپاستوريزه‌پگاه‌اصفهان‌,751,1374728,30088909670,21730,20750,21890,160,0.74,21890,160,0.74,20750,22340
وسكاب,س.ص.بازنشستگي كاركنان بانكها,749,10408104,32544835938,3126,3188,3110,-16,-0.51,3127,1,0.03,3092,3188
شصدف,صنعتي دوده فام,743,1050695,35997412250,34550,34750,34200,-350,-1.01,34250,-300,-0.87,32900,36000
بموتو,موتوژن‌,738,9089395,26423915004,2923,2974,2928,5,0.17,2907,-16,-0.55,2850,2999
ساينا,صنايع بهداشتي ساينا,738,1028557,31694217800,31200,31150,30200,-1000,-3.21,30800,-400,-1.28,29950,32200
دسبحان,سبحان دارو,737,8826191,63565428670,7160,7400,7230,70,0.98,7200,40,0.56,7000,7400
نطرين,عطرين نخ قم,733,3518096,26346243250,7550,7690,7330,-220,-2.91,7490,-60,-0.79,7290,7870
پارند,صندوق س. پارند پايدار سپهر,730,27398771,276795482794,10096,10102,10102,6,0.06,10102,6,0.06,10102,10103
بساما,بيمه سامان,729,3203217,36739033450,11330,11730,11520,190,1.68,11470,140,1.24,11300,11730
كامياب,صندوق س. كامياب آشنا-د,729,29248475,408505213209,13959,13966,13967,8,0.06,13967,8,0.06,13966,13967
حفاري,حفاري شمال,712,14159958,63199390468,4459,4473,4453,-6,-0.13,4463,4,0.09,4300,4600
پارسيان,بيمه پارسيان,705,8631273,30479160421,3579,3652,3470,-109,-3.05,3531,-48,-1.34,3380,3677
وصندوق,سرمايه‌گذاري‌صندوق‌بازنشستگي‌,700,3431253,50591614320,14780,14800,14540,-240,-1.62,14760,-20,-0.14,14540,15000
وخاور,بانك خاورميانه,699,21081465,90172723741,4277,4350,4285,8,0.19,4277,0,0,4200,4399
پكوير,كوير تاير,693,6444985,38377264460,5940,6070,6000,60,1.01,5950,10,0.17,5730,6170
وثنو,سرمايه گذاري ساختماني نوين,691,17838145,39905782492,2176,2241,2240,64,2.94,2237,61,2.8,2145,2241
وسين,بيمه سينا,689,22215471,47795825710,2109,2172,2172,63,2.99,2151,42,1.99,2062,2172
زماهان,مجتمع توليد گوشت مرغ ماهان,685,3776616,30247003080,7970,8240,7950,-20,-0.25,8010,40,0.5,7600,8260
فولاژ,فولاد آلياژي ايران,676,7515678,82982847470,10760,11000,11200,440,4.09,10980,220,2.04,10780,11410
ضسپا1205,اختيارخ خساپا-2000-1401/12/10,675,154528,79475511000,484,557,487,3,0.62,514,30,6.2,400,609
تپسي,پيشگامان فن آوري و دانش آراميس,671,12737385,62593343830,4950,4960,4970,20,0.4,4910,-40,-0.81,4760,5070
وتعاون,بيمه تعاون,670,16026258,28757692291,1799,1850,1750,-49,-2.72,1794,-5,-0.28,1731,1859
دبالك,مواد اوليه دارويي البرز بالك,667,3744869,32651744010,8560,8900,8750,190,2.22,8720,160,1.87,8400,9030
شپترو,پتروشيمي آبادان,664,17531649,32040367522,1837,1843,1800,-37,-2.01,1828,-9,-0.49,1786,1889
شنفت,نفت‌ پارس‌,662,5167983,40747673220,7880,7890,7780,-100,-1.27,7880,0,0,7660,8040
دزهراوي,داروسازي‌زهراوي‌,662,4843473,24780883198,5121,5277,5100,-21,-0.41,5116,-5,-0.1,4989,5277
ساربيل,سيمان آرتا اردبيل,659,1003576,47422995920,46840,47500,46150,-690,-1.47,47250,410,0.88,45900,49150
طخود1205,اختيارف خودرو-2000-1401/12/03,653,281513,3935809000,17,10,15,-2,-11.76,14,-3,-17.65,5,23
وپست,پست بانك ايران,652,9889147,58831852980,5840,6050,5880,40,0.68,5950,110,1.88,5800,6110
دروز,داروسازي‌ روزدارو,652,2101992,47561668680,21740,22750,22400,660,3.04,22630,890,4.09,21300,22820
سخوز,سيمان خوزستان,649,3090803,109045465730,33340,33000,35110,1770,5.31,35280,1940,5.82,33000,35670
شكربن,كربن‌ ايران‌,648,20232500,75447836035,3717,3719,3731,14,0.38,3729,12,0.32,3700,3826
البرز,بيمه البرز,647,18422298,38130258261,2097,2100,2033,-64,-3.05,2070,-27,-1.29,2010,2147
نفيس,صندوق س.پشتوانه طلاي صبا,646,2978581,37087301736,13292,12401,12232,-1060,-7.97,12451,-841,-6.33,12001,12854
وصنا,گروه‌صنايع‌بهشهرايران‌,643,9591162,26295603604,2782,2766,2710,-72,-2.59,2742,-40,-1.44,2651,2889
ساذري,آذريت‌,643,3019019,23920565200,8080,8000,7840,-240,-2.97,7920,-160,-1.98,7840,8320
غمهرا,توليدي‌مهرام‌,643,11247681,92733186580,7860,8140,8250,390,4.96,8240,380,4.83,8100,8250
آسيا,بيمه آسيا,633,16722278,31686865148,1927,1902,1895,-32,-1.66,1895,-32,-1.66,1851,1969
كاوه,فولاد كاوه جنوب كيش,630,5749078,44983537810,7720,7900,7900,180,2.33,7770,50,0.65,7710,7960
جهرم,پتروشيمي جهرم,630,20954063,19554770614,928,911,915,-13,-1.4,933,5,0.54,911,955
دكپسول,توليد ژلاتين كپسول ايران,623,410462,27420163800,64800,66000,66550,1750,2.7,66800,2000,3.09,65300,68500
غشوكو,شوكو پارس,610,6271774,57576833940,9420,9490,9140,-280,-2.97,9180,-240,-2.55,9140,9680
وپترو,سرمايه‌گذاري صنايع پتروشيمي‌,608,4688722,78629229110,16250,16500,16650,400,2.46,16770,520,3.2,15910,17200
وهنر,گروه توسعه هنر ايران,605,19325388,56901590994,2958,2902,2929,-29,-0.98,2944,-14,-0.47,2870,3013
رانفور,خدمات‌انفورماتيك‌,602,8748041,39292671233,4508,4550,4549,41,0.91,4498,-10,-0.22,4400,4600
سفانو,سيمان فارس نو,597,781071,49051155200,65150,69490,62580,-2570,-3.94,62800,-2350,-3.61,61060,69490
فنفت,صنايع تجهيزات نفت,593,3777464,141088280400,36300,37350,37350,1050,2.89,37350,1050,2.89,37350,37350
هم وزن,صندوق س. شاخصي كيان-س,593,7698065,94427143997,12255,12383,12194,-61,-0.5,12266,11,0.09,12061,12477
وزمين,بانك ايران زمين,592,5421830,39859716340,7280,7420,7420,140,1.92,7350,70,0.96,7140,7420
سكارون,سيمان كارون,592,562121,34306958600,59450,60500,61200,1750,2.94,61050,1600,2.69,60000,61200
تفارس,تامين سرمايه خليج فارس,591,9896250,55836894240,5630,5700,5690,60,1.07,5640,10,0.18,5520,5730
غفارس,شير پاستوريزه پگاه فارس,589,3826820,33074117740,8750,8710,8510,-240,-2.74,8640,-110,-1.26,8360,9000
خراسان,پتروشيمي خراسان,587,405958,47423351890,116180,116820,116770,590,0.51,116540,360,0.31,115850,118000
كحافظ,كاشي‌ وسراميك‌ حافظ‌,586,7475439,48248037800,6470,6500,6400,-70,-1.08,6450,-20,-0.31,6300,6640
ونفت,سرمايه‌گذاري‌ صنعت‌ نفت‌,585,6032436,26037699239,4382,4450,4296,-86,-1.96,4316,-66,-1.51,4229,4500
فرآور,فرآوري‌موادمعدني‌ايران‌,584,2466388,68302915970,27490,28180,27490,0,0,27690,200,0.73,26800,28650
كسرام,پارس‌ سرام‌,584,4041492,24799372890,6320,6390,6010,-310,-4.91,6140,-180,-2.85,6010,6390
واتي,سرمايه‌ گذاري‌ آتيه‌ دماوند,579,4338583,46437928000,10570,10890,10580,10,0.09,10700,130,1.23,10430,11090
كقزوي,شيشه‌ قزوين‌,577,3727523,72206173850,19280,19700,19390,110,0.57,19370,90,0.47,18860,19800
پاسا,ايران‌ياساتايرورابر,576,3617050,38500477510,10190,10630,10690,500,4.91,10640,450,4.42,10340,10690
وبوعلي,سرمايه‌گذاري‌بوعلي‌,575,8842520,23791616875,2698,2690,2641,-57,-2.11,2691,-7,-0.26,2632,2769
جوين,كشت و صنعت جوين,572,10719560,59713102650,5740,5720,5650,-90,-1.57,5570,-170,-2.96,5550,5720
گشان,توسعه بين المللي پديده شانديز,572,1757875,81741187500,45150,46500,46500,1350,2.99,46500,1350,2.99,46500,46500
فجام,جام‌دارو,565,5209897,28833676630,5520,5450,5550,30,0.54,5530,10,0.18,5450,5660
اپرداز,آتيه داده پرداز,564,7433636,38497719290,5080,5100,5220,140,2.76,5180,100,1.97,5060,5310
فزرين,زرين معدن آسيا,563,5289189,37536814930,7120,7500,7110,-10,-0.14,7100,-20,-0.28,6900,7500
غگرجي,بيسكويت‌  گرجي‌,560,8858757,15904139589,1828,1850,1762,-66,-3.61,1795,-33,-1.81,1753,1885
تاصيكو,سرمايه گذاري صدرتامين,556,4795486,58770665670,12260,12290,12240,-20,-0.16,12260,0,0,12220,12350
سلار,شركت سيمان لارستان,556,2353677,62824804700,26500,26000,27250,750,2.83,26700,200,0.75,25750,27250
پاكشو,گروه صنعتي پاكشو,553,3891967,24307037910,6400,6250,6230,-170,-2.66,6370,-30,-0.47,6200,6360
دتماد,توليدمواداوليه‌داروپخش‌,550,1436988,55791949480,38880,38240,38840,-40,-0.1,38830,-50,-0.13,38200,39790
پلوله,گازلوله‌,549,1679154,52073799500,30500,31300,31400,900,2.95,31000,500,1.64,30200,31400
آرام,صندوق س شاخصي آرام مفيد,548,2309229,27152816630,11790,11830,11690,-100,-0.85,11760,-30,-0.25,11600,12050
غشهد,شهد ايران ‌,543,6180453,40175743180,6730,6720,6400,-330,-4.9,6500,-230,-3.42,6400,6890
ثعتما,س. ساختماني اعتماد گستر,541,3119158,44165396670,13790,14200,14190,400,2.9,14160,370,2.68,14000,14200
سبهان,سيمان‌ بهبهان‌,541,562245,31614568400,55460,56340,56500,1040,1.88,56230,770,1.39,55050,57190
غناب,روغن‌ نباتي‌ ناب,540,57170,37496988150,664400,684300,644500,-19900,-3,655900,-8500,-1.28,644500,684300
كگهر,سنگ آهن گهرزمين,538,459537,20607267550,45150,45000,44200,-950,-2.1,45100,-50,-0.11,44000,45500
سفاسي,شركت فارسيت اهواز,536,5774209,22740883333,4025,3905,3905,-120,-2.98,3938,-87,-2.16,3905,4018
سپر,صندوق س سپر سرمايه بيدار- ثابت,532,14747977,245138751128,16611,16622,16621,10,0.06,16622,11,0.07,16621,16624
غبهنوش,بهنوش‌ ايران‌,527,932101,55647864180,57350,59320,59190,1840,3.21,59700,2350,4.1,57500,60210
فروس,فروسيليس‌ ايران‌,523,7041126,47592715040,6710,6750,6610,-100,-1.49,6760,50,0.75,6550,6930
ضستا6004,اختيارخ شستا-865-1402/06/08,522,128058,44041394000,354,378,340,-14,-3.95,344,-10,-2.82,312,378
تبرك,گروه كارخانجات صنعتي تبرك,521,3521036,35359412910,10210,10420,9950,-260,-2.55,10040,-170,-1.67,9700,10460
زرفام,صندوق س.پشتوانه طلا زرفام آشنا,521,1708932,28791676101,17600,18382,16333,-1267,-7.2,16848,-752,-4.27,16002,18382
ثبات,صندوق س. ثبات ويستا -د,519,95219758,1273714840946,13368,13375,13377,9,0.07,13377,9,0.07,13375,13377
وسپه,سرمايه‌گذاري‌ سپه‌,510,8845957,43055985353,4845,4940,4900,55,1.14,4866,21,0.43,4833,4967
فراز,صندوق س.سهام فراز داريك-س,510,6266405,114429391942,18200,18212,18372,172,0.95,18261,61,0.34,18200,18400
سصوفي,سيمان‌ صوفيان‌,509,4295899,107461109090,24230,24980,25100,870,3.59,25010,780,3.22,23940,25710
وتوكا,سرمايه‌گذاري‌توكافولاد(هلدينگ,500,4132171,37373065780,9020,9200,8990,-30,-0.33,9040,20,0.22,8930,9330
چافست,افست‌,498,17851915,106209075870,5670,5950,5950,280,4.94,5950,280,4.94,5900,5950
فافزا,فولاد افزا سپاهان,497,940377,37843167600,41050,41650,40100,-950,-2.31,40250,-800,-1.95,39850,41650
ضسپا1207,اختيارخ خساپا-2400-1401/12/10,497,106005,23154845000,223,281,226,3,1.35,218,-5,-2.24,150,282
دجابر,داروسازي‌ جابرابن‌حيان‌,496,2290620,30614745710,13400,13800,13170,-230,-1.72,13370,-30,-0.22,12960,13800
شفارا,پتروشيمي فارابي,496,9743232,56173727910,5610,5770,5760,150,2.67,5770,160,2.85,5700,5770
دتوزيع,توزيع دارو پخش,494,892369,31577494600,34000,34750,35000,1000,2.94,35400,1400,4.12,34750,35700
ثتوسا,س.توسعه و عمران استان اردبيل,493,948003,18275675380,19530,19600,18950,-580,-2.97,19280,-250,-1.28,18950,20110
وتوسم,سرمايه‌گذاري‌توسعه‌ملي‌,493,6231299,32040028780,5150,5200,5090,-60,-1.17,5140,-10,-0.19,5050,5300
وسبحان,سرمايه گذاري سبحان,490,15569185,34146300166,2213,2290,2176,-37,-1.67,2193,-20,-0.9,2165,2290
جم پيلن,پتروشيمي جم پيلن,486,788288,111892783510,141370,141700,143900,2530,1.79,141940,570,0.4,140610,144960
بزاگرس,نيروگاه زاگرس كوثر,484,4067061,18812753517,4694,4595,4560,-134,-2.85,4626,-68,-1.45,4470,4878
كمنگنز,معادن‌منگنزايران‌,481,1797486,20852437410,11490,11840,11500,10,0.09,11600,110,0.96,11250,11900
لسرما,سرما آفرين‌,481,992129,26355465680,27050,27730,25840,-1210,-4.47,26560,-490,-1.81,25710,27770
قمرو,قند مرودشت‌,480,2166575,25248834520,11720,11830,11590,-130,-1.11,11650,-70,-0.6,11330,12080
شكلر,نيروكلر,479,1378948,41761802370,29650,29700,29800,150,0.51,30290,640,2.16,29520,30930
شرنگي,شيميايي رنگين,478,425055,18197423400,42800,43900,42150,-650,-1.52,42800,0,0,41900,44000
زگلدشت,كشت و دام گلدشت نمونه اصفهان,478,3289667,60074098750,18010,18200,18180,170,0.94,18260,250,1.39,17770,18900
اوان,مبين وان كيش,477,3130530,49039007680,14760,15280,15790,1030,6.98,15660,900,6.1,15210,15790
ونيكي,سرمايه‌گذاري‌ ملي‌ايران‌,477,2691879,18351589340,6940,7070,6770,-170,-2.45,6920,-20,-0.29,6650,7070
فيروزا,صندوق ارمغان فيروزه آسيا-ثابت,474,13553173,439222754295,32386,32407,32408,22,0.07,32407,21,0.06,32407,32408
شخارك,پتروشيمي‌ خارك‌,474,593839,23780224410,40470,40010,39800,-670,-1.66,40360,-110,-0.27,39540,40540
وفتخار,سرمايه گذاري افتخار سهام,473,7767522,27398997875,3543,3592,3545,2,0.06,3527,-16,-0.45,3500,3594
حآساح,ح.آسيا سير ارس,471,2378182,15189821750,6620,6750,6320,-300,-4.53,6390,-230,-3.47,6180,6750
كساوه,صنايع‌ كاشي‌ و سراميك‌ سينا,465,2212276,117628467390,52640,54030,52250,-390,-0.74,53170,530,1.01,51400,54250
قزوين,كارخانجات‌ قند قزوين‌,462,4975404,32143324910,6610,6610,6410,-200,-3.03,6460,-150,-2.27,6290,6790
وامير,گروه صنعتي و معدني امير,459,373398,120223389350,312750,322100,322100,9350,2.99,321950,9200,2.94,318000,322100
دابور,داروسازي‌ ابوريحان‌,454,2166308,41576333410,19450,19430,18910,-540,-2.78,19190,-260,-1.34,18510,19650
ضستا1106,اختيارخ شستا-1100-1401/11/05,452,237367,1252867000,13,22,3,-10,-76.92,5,-8,-61.54,2,22
كسعدي,كاشي‌ سعدي‌,451,2177309,23311599340,10650,10910,10700,50,0.47,10710,60,0.56,10500,10910
ضستا1206,اختيارخ شستا-1100-1401/12/03,449,114697,6839183000,80,90,58,-22,-27.5,60,-20,-25,45,90
بمپنا,توليد برق عسلويه  مپنا,448,4892648,31062931880,6470,6370,6280,-190,-2.94,6350,-120,-1.85,6150,6780
پكرمان,گروه‌ صنعتي‌ بارز,445,1521736,31238610970,20010,20600,20490,480,2.4,20530,520,2.6,20110,20990
ساراب,سيمان‌ داراب‌,442,1540281,38488059060,23820,24500,25190,1370,5.75,24990,1170,4.91,24000,25390
وحكمت,بيمه حكمت صبا,441,13101035,23753247049,1834,1781,1817,-17,-0.93,1813,-21,-1.15,1781,1880
زيتون,صندوق س زيتون نماد پايا- مختلط,436,3435024,49255363310,14350,14480,14330,-20,-0.14,14340,-10,-0.07,14220,14500
پرديس,سرمايه گذاري پرديس,436,9950144,37049750472,3770,3770,3722,-48,-1.27,3724,-46,-1.22,3661,3830
دالبر,البرزدارو,432,4949676,38452164590,7640,7820,7740,100,1.31,7770,130,1.7,7600,8000
شجم,صنايع پتروشيمي تخت جمشيد,431,2503832,21310445090,8630,8790,8350,-280,-3.24,8510,-120,-1.39,8250,8790
هرمز,فولاد هرمزگان جنوب,426,1334331,17557631740,13210,13150,13070,-140,-1.06,13200,-10,-0.08,12890,13450
بهپاك,صنعتي بهپاك,422,5481644,38394530840,7010,6900,6900,-110,-1.57,7000,-10,-0.14,6890,7200
ولراز,ليزينگ رازي,422,1382083,36083416950,26500,26400,25750,-750,-2.83,26100,-400,-1.51,25750,27100
كايتا,ايتالران‌,420,328439,11521228150,34350,35050,35350,1000,2.91,35100,750,2.18,33450,35350
دسبحا,گروه دارويي سبحان,416,2443187,26060312910,10700,10750,10660,-40,-0.37,10670,-30,-0.28,10220,10910
فخاس,فولاد خراسان,416,1400842,15952767970,11350,11820,11250,-100,-0.88,11360,10,0.09,11050,11820
شفا,سرمايه گذاري شفادارو,416,1952055,35434675600,18480,18500,18270,-210,-1.14,18150,-330,-1.79,17650,18590
زعف0210پ10,زعفران0210نگين طلاي سرخ(پ),413,1215125,398930026349,320352,335205,332999,12647,3.95,328304,7952,2.48,325490,335206
تشتاد,صنايع توليدي اشتاد ايران‌,409,5172147,31066891950,5840,6010,6010,170,2.91,6010,170,2.91,5850,6010
تابا,تابان نيرو سپاهان,408,998288,25854550150,25450,26000,25400,-50,-0.2,25900,450,1.77,24850,26200
سباقر,سيمان باقران,402,2500465,37870689430,14790,15230,14800,10,0.07,15150,360,2.43,14790,15230
داوه,داروسازي آوه سينا,398,1810078,15462843590,8400,8530,8430,30,0.36,8540,140,1.67,8360,8810
لخانه,لوازم‌ خانگي‌ پارس‌,395,6816507,139021014720,19810,20400,20400,590,2.98,20390,580,2.93,19830,20400
ولتجار,واسپاري تجار ايرانيان,392,11187667,29061134994,2663,2659,2584,-79,-2.97,2598,-65,-2.44,2584,2716
تپمپي,پمپ‌ سازي‌ ايران‌,389,1807280,41036883070,23110,23900,22590,-520,-2.25,22710,-400,-1.73,22270,23900
تيپيكو,سرمايه گذاري دارويي تامين,388,1836365,48428511500,25770,26600,26350,580,2.25,26060,290,1.13,25830,26700
خليبل,ماليبل سايپا,388,669700,17812892950,27000,27800,26200,-800,-2.96,26600,-400,-1.48,26200,27800
ولملت,واسپاري ملت,388,4006394,20555806820,5090,5300,5080,-10,-0.2,5130,40,0.79,5000,5300
ثامان,سامان‌ گستراصفهان‌,388,1657311,26982363950,15920,16500,16420,500,3.14,16280,360,2.26,15950,16640
غگلستا,شير پاستوريزه پگاه گلستان,387,1839683,29341451850,15980,16020,16080,100,0.63,15950,-30,-0.19,15620,16590
تكنار,مجتمع معادن مس تكنار,386,411732,26520545800,62750,63350,63850,1100,1.75,64400,1650,2.63,63350,64600
دارو,كارخانجات‌داروپخش‌,386,2557894,54657350550,21030,21020,21450,420,2,21370,340,1.62,21000,21730
ركيش,كارت اعتباري ايران كيش,382,5226172,16308391328,3142,3150,3060,-82,-2.61,3121,-21,-0.67,3040,3210
كيا,كيا الكترود شرق,380,8065294,73795440100,8721,9150,9150,429,4.92,9150,429,4.92,9000,9150
ضدي203,اختيارخ دي-600-14020217,378,50961,17474040000,344,351,342,-2,-0.58,343,-1,-0.29,315,394
كپرور,فرآوري زغال سنگ پروده طبس,374,3015515,29104672210,9680,9800,9590,-90,-0.93,9650,-30,-0.31,9370,9900
بميلا,توسعه سرمايه گذاري ميلاد پارس,370,4866607,47561693440,9500,9450,9780,280,2.95,9770,270,2.84,9450,9780
ضستا1205,اختيارخ شستا-1000-1401/12/03,363,56768,5770878000,115,129,97,-18,-15.65,102,-13,-11.3,70,134
دلر,داروسازي‌ اكسير,363,868399,20657103930,23390,23210,23500,110,0.47,23770,380,1.62,22930,24250
دسانكوح,ح . داروسازي سبحان انكولوژي,363,2960783,14068739895,4896,4715,4715,-181,-3.7,4752,-144,-2.94,4596,5049
ثشرق,سرمايه گذاري مسكن شمال شرق,359,2618639,12665495695,4786,4948,4900,114,2.38,4829,43,0.9,4710,4948
هجرت,پخش هجرت,355,2176980,67114126100,30300,29750,30450,150,0.5,30850,550,1.82,29750,31400
ثباغ,شهر سازي و خانه سازي باغميشه,355,2987153,28760461850,9620,10120,9700,80,0.83,9630,10,0.1,9230,10120
كترام,توليدي‌ كاشي‌ تكسرام‌,354,11726550,105244780170,8560,8860,8980,420,4.91,8970,410,4.79,8860,8980
قپيرا,فرآورده‌هاي‌غدايي‌وقندپيرانشهر,354,1694695,14868205690,9090,9080,8700,-390,-4.29,8770,-320,-3.52,8570,9300
آتيمس,صندوق س.آرمان آتيه درخشان مس-س,354,242948,51311952925,223499,225000,216001,-7498,-3.35,211205,-12294,-5.5,201150,226490
ومعلم,بيمه معلم,350,8862430,16611674415,1842,1853,1880,38,2.06,1874,32,1.74,1832,1904
باران,بيمه زندگي باران,349,5310424,20059573591,3864,3790,3749,-115,-2.98,3777,-87,-2.25,3749,3949
هامرز2,صندوق س اعتماد هامرز-ثابت,348,34800000,34800000,10107,1,1,-10106,-99.99,1,-10106,-99.99,1,1
كلوند,كاشي‌ الوند,347,1102692,37536605700,34120,34150,33890,-230,-0.67,34040,-80,-0.23,33350,35100
داسوه,داروسازي‌ اسوه‌,347,1072787,52112730730,46930,45700,47540,610,1.3,48580,1650,3.52,45700,49270
سدشت,صنايع سيمان دشتستان,343,740286,25002464640,32180,33750,33780,1600,4.97,33770,1590,4.94,33100,33780
سيلام,سيمان‌ ايلام‌,341,1847822,22458898800,12160,11870,12060,-100,-0.82,12150,-10,-0.08,11870,12480
حاريا,كشتيراني آريا,336,3626198,20792652000,5840,5730,5730,-110,-1.88,5730,-110,-1.88,5730,5880
ضستا1107,اختيارخ شستا-1200-1401/11/05,334,169215,169216000,2,1,1,-1,-50,1,-1,-50,1,2
كفرا,فراورده‌ هاي‌ نسوزايران‌,333,1683596,14973942450,8810,9000,8730,-80,-0.91,8890,80,0.91,8600,9150
قشرين,قند شيرين خراسان,332,3884116,35692731270,9420,9420,9140,-280,-2.97,9190,-230,-2.44,9140,9550
شدوص,دوده‌ صنعتي‌ پارس‌,331,2217148,28802375720,12880,12860,12970,90,0.7,12990,110,0.85,12740,13190
ضسپا1204,اختيارخ خساپا-1900-1401/12/10,330,57698,36267702000,552,657,570,18,3.26,629,77,13.95,481,684
رفاه,فروشگاه هاي زنجيره اي رفاه,327,239040,75284242500,305800,314950,314950,9150,2.99,314950,9150,2.99,313000,314950
زمگسا,كشاورزي‌ ودامپروي‌ مگسال‌,326,477340,15732957020,32720,34000,32800,80,0.24,32960,240,0.73,32300,34000
داراب,پتروشيمي داراب,324,5390119,5505231136,1038,1016,1015,-23,-2.22,1028,-10,-0.96,1008,1051
شاملا,معدني‌ املاح‌  ايران‌,323,1773384,21035133790,11700,11850,11780,80,0.68,11860,160,1.37,11430,12170
سخزر,سيمان‌ خزر,322,597658,17550176470,29720,29500,28620,-1100,-3.7,29360,-360,-1.21,28410,30390
ما,بيمه  ما,321,2786847,9054559558,3338,3350,3210,-128,-3.83,3283,-55,-1.65,3210,3427
وسنا,سرمايه گذاري نيروگاهي ايران,321,2647078,23741366910,9220,9150,8950,-270,-2.93,8970,-250,-2.71,8950,9150
كوثر,بيمه كوثر,318,5035383,23845032141,4759,4895,4612,-147,-3.09,4735,-24,-0.5,4601,4900
دعبيد,لابراتوارداروسازي‌  دكترعبيدي‌,316,1091541,15152494070,14140,14360,13680,-460,-3.25,14090,-50,-0.35,13540,14360
قتربت,قند تربت حيدريه,316,977291,18976386070,19680,19330,19090,-590,-3,19420,-260,-1.32,19090,19950
غگلپا,شير پاستوريزه پگاه گلپايگان,313,408038,25229636650,62550,63750,61150,-1400,-2.24,61850,-700,-1.12,60700,64300
بفجر,فجر انرژي خليج فارس,311,1425234,29951553820,21040,21060,21050,10,0.05,21030,-10,-0.05,20910,21440
تايرا,تراكتورسازي‌ايران‌,310,2058065,57681987800,28190,28210,28310,120,0.43,28030,-160,-0.57,27770,28760
سغدير,توسعه سرمايه و صنعت غدير,310,2143550,14990302530,7120,7290,6990,-130,-1.83,7020,-100,-1.4,6830,7290
تصميم,صندوق س با درآمد ثابت تصميم,307,5160493,117960839637,22845,22858,22858,13,0.06,22858,13,0.06,22858,22859
سهرمز,سيمان‌هرمزگان‌,307,699899,19981369490,27760,27210,28840,1080,3.89,28550,790,2.85,27210,29120
بايكا,كارخانجات كابلسازي ‌ايران‌,307,591939,10425005730,17740,18260,17370,-370,-2.09,17610,-130,-0.73,17210,18270
فبيرا,بسته‌ بندي‌ ايران‌,307,5961930,11934889433,2039,2077,2000,-39,-1.91,2002,-37,-1.81,1978,2089
وسديد,گروه ‌صنعتي‌سديد,306,11326679,31272960719,2681,2761,2761,80,2.98,2761,80,2.98,2761,2761
فغدير,آهن و فولاد غدير ايرانيان,305,1503048,24184757370,16090,16050,15940,-150,-0.93,16090,0,0,15610,16500
پشاهن,توليدي پلاستيك‌ شاهين,304,260179,17539862400,68450,66400,66750,-1700,-2.48,67400,-1050,-1.53,66400,69900
زعف0210پ20,زعفران0210نگين وحدت جام(پ),303,169114,55864680761,318241,328999,325256,7015,2.2,330337,12096,3.8,320000,335206
فماك,ماداكتو استيل كرد,302,5402784,83851611100,16037,16780,16000,-37,-0.23,15520,-517,-3.22,15240,16780
شليا,شركت مواد ويژه ليا,302,1236136,54501941350,42900,44000,44150,1250,2.91,44100,1200,2.8,42750,44150
ثجوان,تامين مسكن جوانان,301,3821575,18986730720,5060,5100,4950,-110,-2.17,4970,-90,-1.78,4910,5150
امين يكم2,صندوق درآمد ثابت امين يكم فردا,300,299930021,299930021,9798,1,1,-9797,-99.99,1,-9797,-99.99,1,1
حپارسا,توسعه حمل و نقل ريلي پارسيان,294,1296124,66357091700,49750,50250,51600,1850,3.72,51200,1450,2.91,49050,52900
فلامي,لاميران‌,292,1617088,37881904280,22410,23300,23530,1120,5,23430,1020,4.55,22600,23530
ضسپا1209,اختيارخ خساپا-2800-1401/12/10,288,116073,12001185000,106,180,105,-1,-0.94,103,-3,-2.83,85,180
سقاين,سيمان‌ قائن‌,288,292361,15261028710,52510,53170,51600,-910,-1.73,52200,-310,-0.59,51200,53830
آساس,صندوق س.آسمان آرماني سهام-س,285,110840,28224317686,252773,255849,253500,727,0.29,254640,1867,0.74,252000,257956
سبجنو,سيمان‌ بجنورد,285,451150,19772434760,43580,45350,43350,-230,-0.53,43830,250,0.57,41650,45350
اتكاي,بيمه اتكايي ايرانيان,282,2802870,17286457640,6170,6110,6180,10,0.16,6170,0,0,6090,6310
نيرو,نيرو سرمايه,279,1451894,47829800100,32000,32200,32950,950,2.97,32950,950,2.97,32200,32950
شرانل,نفت ايرانول,274,434435,26903019950,61650,61800,62150,500,0.81,61800,150,0.24,61750,62200
وآفر,سرمايه گذاري ارزش آفرينان,274,1423227,36991298650,26500,26950,25750,-750,-2.83,26000,-500,-1.89,25750,27000
كاج,صندوق س. نوع دوم نو ويرا -د,273,108218685,1146573398800,10587,10594,10595,8,0.08,10595,8,0.08,10594,10595
وكادو,تكادو,272,1407157,26365608350,18860,18550,18400,-460,-2.44,18740,-120,-0.64,18400,19350
غالبر,لبنيات‌ كالبر,271,1275829,36463192820,27220,28580,28580,1360,5,28580,1360,5,28580,28580
فافق,صنايع مس افق كرمان,269,4041444,20473065370,5190,5040,5040,-150,-2.89,5070,-120,-2.31,5040,5250
ثتران,سرمايه گذاري مسكن تهران,268,14808146,74677480278,4803,5043,5043,240,5,5043,240,5,5043,5043
فروسيل,فروسيليسيم خمين,264,842739,15476488830,18270,18830,18400,130,0.71,18360,90,0.49,18150,18830
ضشنا1106,اختيارخ شپنا-7000-1401/11/19,263,29513,24598088000,921,996,700,-221,-24,833,-88,-9.55,700,999
ضجار2022,اختيارخ وتجارت-1500-1402/02/20,262,25176,13678891000,573,550,515,-58,-10.12,543,-30,-5.24,481,610
مدير,ص.س.مديريت ثروت ص.بازنشستگي-س,260,2020132,24474450015,12144,12210,12072,-72,-0.59,12115,-29,-0.24,11910,12319
كشرق,صنعتي و معدني شمال شرق شاهرود,259,123688,13934601150,112500,115900,110050,-2450,-2.18,112650,150,0.13,107200,115900
وتوشه,سرمايه‌ گذاري‌ پارس‌ توشه‌,259,2028082,11678010460,5810,6030,5650,-160,-2.75,5770,-40,-0.69,5580,6030
ويسا,سرمايه گذاري ايساتيس پويا,259,2449708,15020280290,6230,6160,6090,-140,-2.25,6130,-100,-1.61,6060,6330
مبين,مبين انرژي خليج فارس,259,1894688,60996304850,32190,32480,32050,-140,-0.43,32190,0,0,31860,33490
وبشهر,توسعه‌ صنايع‌ بهشهر(هلدينگ,251,2296017,16565864410,7340,7370,7200,-140,-1.91,7290,-50,-0.68,7020,7430
كنور,توسعه معدني و صنعتي صبانور,251,696496,12009809940,17250,17890,17000,-250,-1.45,17250,0,0,16830,17890
كاسپين,داروسازي كاسپين تامين,249,1019390,16001617660,15790,15900,15550,-240,-1.52,15700,-90,-0.57,15410,16300
حگهر,حمل و نقل گهرترابر سيرجان,249,1693525,19527700940,11210,11340,11610,400,3.57,11530,320,2.85,11220,11700
ضسپا1210,اختيارخ خساپا-3000-1401/12/10,249,73852,7407405000,87,149,99,12,13.79,100,13,14.94,65,149
تپولا,مهندسي مرآت پولاد,248,796071,15441941070,19760,20300,19190,-570,-2.88,19400,-360,-1.82,19170,20300
زعف0210پ05,زعفران0210نگين زرين(پ),247,160347,52520154604,317340,324000,328950,11610,3.66,327541,10201,3.21,322050,331999
مارون,پتروشيمي مارون,245,174961,32590841850,178800,183050,185000,6200,3.47,181100,2300,1.29,181300,187700
فردا,صندوق س آواي فرداي زاگرس-ثابت,244,9884199,149123472457,15079,15087,15089,10,0.07,15087,8,0.05,15087,15089
وارس,سرمايه گذاري ارس صبا,244,1259654,22716853280,17700,18200,17600,-100,-0.56,18030,330,1.86,17500,18230
دفرا,فرآورده‌هاي‌ تزريقي‌ ايران‌,244,1591126,43027120380,27490,27330,26440,-1050,-3.82,27040,-450,-1.64,26280,27990
پرداخت,به پرداخت ملت,243,1099872,13201823120,11770,11860,11850,80,0.68,11850,80,0.68,11800,12250
سفارود,كارخانه فارسيت درود,242,456690,5991204470,13350,13570,13090,-260,-1.95,13120,-230,-1.72,13090,13570
كصدف,كاشي صدف سرام استقلال آباده,240,367804,9668111100,26250,25600,25800,-450,-1.71,26300,50,0.19,25500,26950
ارزش,صندوق س ارزش آفرين بيدار-سهام,240,2109246,29530153260,13890,13990,13970,80,0.58,14000,110,0.79,13840,14150
پسهند,صنايع‌ لاستيكي‌  سهند,238,340852,13317158330,38840,39600,39280,440,1.13,39040,200,0.51,38120,39600
فولاي,صنايع فولاد آلياژي يزد,238,11761315,70273857125,5585,5975,5975,390,6.98,5975,390,6.98,5975,5975
بالاس,مهندسي ساختمان تاسيسات راه آهن,233,807839,26860646750,35000,33250,33250,-1750,-5,33250,-1750,-5,33250,33250
بنيرو,نيروترانس‌,231,2056773,6321122047,3187,3190,3018,-169,-5.3,3137,-50,-1.57,3000,3190
گوهرانح,ح . س. توسعه گوهران اميد,229,2947628,8031733621,2693,2790,2639,-54,-2.01,2725,32,1.19,2616,2799
آساميد,صندوق س.مشترك آسمان اميد -د,229,12946424,221120426870,17071,17080,17081,10,0.06,17080,9,0.05,17079,17081
انار,صندوق س.انارنماد ارزش-درسهام,227,753057,10231164510,13370,13490,13600,230,1.72,13590,220,1.65,13460,13690
ضخود1208,اختيارخ خودرو-2600-1401/12/03,224,32359,17182059000,650,949,522,-128,-19.69,531,-119,-18.31,441,949
بسويچ,پارس‌سويچ‌,222,2130864,9786083560,4660,4550,4520,-140,-3,4610,-50,-1.07,4450,4770
تسه1400,امتيازتسهيلات مسكن سال1400,222,2669,3254513481,1210246,1180009,1215000,4754,0.39,1219376,9130,0.75,1180009,1240000
حبندرح,ح.دريايي وكشتيراني خط دريابندر,221,511643,5268147760,10500,10600,10190,-310,-2.95,10300,-200,-1.9,10190,10600
فاهواز,نورد و لوله اهواز,221,1970208,8713157733,4473,4473,4384,-89,-1.99,4429,-44,-0.98,4384,4473
گوهران,سرمايه گذاري توسعه گوهران اميد,219,1250013,6189195482,4903,4900,4926,23,0.47,4923,20,0.41,4862,5018
ضخاو1207,اختيارخ وخاور-5000-1401/12/01,216,38674,2883689000,76,125,80,4,5.26,75,-1,-1.32,60,125
گنگين,اقتصادي نگين گردشگري ايرانيان,213,3923430,143374800200,37450,36350,37000,-450,-1.2,36550,-900,-2.4,36350,37500
فن آوا,گروه فن آوا,211,1797435,11506074160,6550,6600,6360,-190,-2.9,6400,-150,-2.29,6360,6600
تسه0011,امتيازتسهيلات مسكن بهمن 1400,210,2379,2913686104,1208379,1185008,1220000,11621,0.96,1224752,16373,1.35,1185008,1267990
دپارس,پارس‌ دارو,209,895219,36263547680,40100,39850,41400,1300,3.24,40510,410,1.02,39850,41400
شكبير,پتروشيمي اميركبير,209,344351,28049887950,83300,80850,80850,-2450,-2.94,82750,-550,-0.66,80850,83300
كهرام,توليدي گرانيت بهسرام,208,154593,8871259750,56800,55700,57700,900,1.58,57400,600,1.06,55700,57900
وآفري,بيمه كارآفرين,208,3859085,10834088314,2869,2811,2783,-86,-3,2819,-50,-1.74,2783,2867
سمازن,سيمان‌مازندران‌,207,1495280,25252221780,16480,16480,16600,120,0.73,16890,410,2.49,16440,17100
سپ,پرداخت الكترونيك سامان كيش,200,305777,5056938800,16960,16370,16620,-340,-2,16930,-30,-0.18,16370,16900
ولقمان,سرمايه گذاري لقمان,195,5134454,23955810453,4660,4550,4699,39,0.84,4666,6,0.13,4521,4710
جم,پتروشيمي جم,195,980239,36801090220,37460,37550,37610,150,0.4,37490,30,0.08,37300,38080
تسه9911,امتياز تسهيلات مسكن بهمن99,192,2233,2765307093,1235801,1269000,1235008,-793,-0.06,1238382,2581,0.21,1201222,1269000
ضخود1206,اختيارخ خودرو-2200-1401/12/03,190,15247,15143116000,1020,1214,840,-180,-17.65,993,-27,-2.65,820,1214
گنج,صندوق س. طلا كيميا زرين كاردان,187,626060,11757916397,19893,19501,18300,-1593,-8.01,18781,-1112,-5.59,18002,19501
سيدكو,سرمايه گذاري توسعه صنايع سيمان,187,1221941,12278081920,10080,9950,10160,80,0.79,10060,-20,-0.2,9950,10350
دهدشت,صنايع پتروشيمي دهدشت,185,2004485,22964861390,11440,11500,11490,50,0.44,11460,20,0.17,11120,11780
درازي,پخش رازي,176,721995,18048067850,25100,26200,24750,-350,-1.39,25000,-100,-0.4,24150,26200
حسينا,توسعه خدمات دريايي وبندري سينا,176,687127,7577525830,10860,11050,10800,-60,-0.55,11030,170,1.57,10760,11390
واعتبار,سرمايه گذاري اعتبار ايران,173,2997818,8811416435,2944,2950,2919,-25,-0.85,2941,-3,-0.1,2830,3045
ضسپا1208,اختيارخ خساپا-2600-1401/12/10,173,42953,6351703000,155,187,138,-17,-10.97,148,-7,-4.52,87,197
رايكا,صندوق س نوع دوم رايكا- ثابت	,171,6995500,74311550927,10615,10623,10623,8,0.08,10623,8,0.08,10622,10623
تسه0009,امتيازتسهيلات مسكن آذر 1400,170,1686,2052076117,1219072,1190000,1210100,-8972,-0.74,1217127,-1945,-0.16,1190000,1230000
سپيدما,صندوق س. سپيد دماوند-د,169,44061133,634262119708,14388,14396,14395,7,0.05,14395,7,0.05,14395,14396
كفرآور,فرآورده هاي سيمان شرق,168,2105858,32472330360,14980,15420,15420,440,2.94,15420,440,2.94,15420,15420
ضهرم1205,اختيارخ اهرم-11000-1401/12/22,168,3822,14578995000,3553,4100,3500,-53,-1.49,3814,261,7.35,3100,4250
ضستا1108,اختيارخ شستا-1300-1401/11/05,164,79374,79374000,1,1,1,0,0,1,0,0,1,1
ضستا0105,اختيارخ شستا-1100-1402/01/09,162,80391,7320434000,91,104,84,-7,-7.69,91,0,0,82,104
ضستا6003,اختيارخ شستا-765-1402/06/08,161,64475,25657200000,406,429,398,-8,-1.97,398,-8,-1.97,375,433
سنوين,سرمايه گذاري اقتصاد نوين,161,2380498,14267697500,5830,6000,6000,170,2.92,5990,160,2.74,5900,6000
لوتوس,تامين سرمايه لوتوس پارسيان,160,938962,4705391493,4987,5078,5000,13,0.26,4989,2,0.04,4973,5078
كيان2,صندوق س. با درآمد ثابت كيان,160,16000000,16000000,39958,1,1,-39957,-100,1,-39957,-100,1,1
قشهد,شهد,160,255030,4095794650,16300,16310,16000,-300,-1.84,16230,-70,-0.43,15710,16510
ماني,صندوق س. با درآمد ثابت ماني,159,6042419,80926855529,13386,13393,13394,8,0.06,13393,7,0.05,13393,13394
سجام,مجتمع سيمان غرب آسيا,159,3106602,7167248326,2303,2350,2295,-8,-0.35,2306,3,0.13,2270,2360
آوا,صندوق س.سهام آواي معيار-س,159,1261732,12463806165,9629,9850,9820,191,1.98,9878,249,2.59,9620,10000
وفتخارح,ح . سرمايه گذاري افتخار سهام,159,2872747,5070865497,1806,1806,1752,-54,-2.99,1765,-41,-2.27,1752,1806
حگردش,ريل گردش ايرانيان,158,5233116,30247410480,5620,5780,5780,160,2.85,5780,160,2.85,5780,5780
ضخود1212,اختيارخ خودرو-3500-1401/12/03,156,25529,3332460000,225,221,118,-107,-47.56,131,-94,-41.78,90,230
كخاك,صنايع‌خاك‌چيني‌ايران‌,154,498669,7527007880,14900,15360,15080,180,1.21,14970,70,0.47,14900,15500
وپخش,داروپخش‌ (هلدينگ‌,153,241063,9888942860,40100,42130,39360,-740,-1.85,40260,160,0.4,39320,42130
ضخود3072,اختيارخ خودرو-3500-1402/03/03,153,23240,10772656000,504,460,420,-84,-16.67,464,-40,-7.94,300,650
صنم,ص.س.صندوق در صندوق صنم,150,1495510,20099985230,13349,13453,13381,32,0.24,13440,91,0.68,13281,13720
ثاژن,سخت آژند,149,1688291,8296927450,5000,5000,4900,-100,-2,4910,-90,-1.8,4900,5080
تاتمس,كارخانجات صنعتي وتوليدي اتمسفر,147,66716,7669456150,113250,111300,114950,1700,1.5,114950,1700,1.5,111300,115500
نخل,صندوق س.خليج فارس-د,145,11468293,114905428795,10013,10020,10020,7,0.07,10019,6,0.06,10018,10050
ضجار2026,اختيارخ وتجارت-1900-1402/02/20,141,28582,7009677000,305,350,230,-75,-24.59,245,-60,-19.67,205,350
ضهاي3000,اختيارخ هاي وب-1845-1402/03/03,139,8245,10658722680,1131,1195,1144,13,1.15,1193,62,5.48,1091,1270
وسالت,بانك قرض الحسنه رسالت,138,146967,9765957150,68500,66450,66450,-2050,-2.99,66450,-2050,-2.99,66450,66450
سكرما,سيمان‌ كرمان‌,137,641668,11549087400,17730,18200,18050,320,1.8,17930,200,1.13,17710,18200
فخاسح,ح . فولاد خراسان,135,2161180,20814745670,9750,10100,9400,-350,-3.59,9630,-120,-1.23,9330,10100
ثنظام,س. ساختماني نظام مهندسي ايران,132,387796,20454336900,51350,52400,52850,1500,2.92,52750,1400,2.73,51700,52850
سغرب,سيمان‌غرب‌,131,335958,8468875820,24840,25090,24530,-310,-1.25,25050,210,0.85,24510,25730
سهگمت,سيمان‌هگمتان‌,131,185139,8028405640,41750,42360,42610,860,2.06,42540,790,1.89,42360,43950
شساخت,مهندسي و ساختمان صنايع نفت,131,210630,8024738400,38250,38000,37400,-850,-2.22,38200,-50,-0.13,37400,38950
تسه0010,امتيازتسهيلات مسكن دي1400,128,1663,2035519438,1208648,1170000,1219000,10352,0.86,1224004,15356,1.27,1170000,1240000
وكار,بانك‌ كارآفرين‌,125,1695223,5557165255,3250,3275,3250,0,0,3253,3,0.09,3249,3337
تسه0006,امتيازتسهيلات مسكن شهريور1400,125,2104,2550802362,1204044,1161005,1201501,-2543,-0.21,1212358,8314,0.69,1161005,1230000
ثزاگرس,سرمايه گذاري توسعه عمران زاگرس,124,856880,26648783200,30200,31100,31100,900,2.98,31100,900,2.98,31000,31100
خاتم,صندوق س خاتم ايساتيس پويا-ثابت,124,2172315,33474921114,15400,15411,15410,10,0.06,15410,10,0.06,15409,15411
ضستا1105,اختيارخ شستا-1000-1401/11/05,124,33443,950989000,61,70,20,-41,-67.21,28,-33,-54.1,15,70
آفاق,صندوق س نوع دوم افق آتي-ثابت,122,4920035,49301165805,10013,10020,10021,8,0.08,10020,7,0.07,10020,10021
اوصتا,صندوق انديشه ورزان صباتامين -د,121,13710089,358809487160,26156,26171,26172,16,0.06,26171,15,0.06,26171,26172
ضستا0106,اختيارخ شستا-1200-1402/01/09,120,17014,1357415000,88,108,84,-4,-4.55,80,-8,-9.09,65,108
وحافظ,بيمه حافظ,118,2918805,9856804485,3279,3377,3377,98,2.99,3377,98,2.99,3377,3377
پاداش,صندوق س. ارزش پاداش-د,118,2548835,26155829006,10255,10261,10262,7,0.07,10262,7,0.07,10261,10262
پيزد,مجتمع صنايع لاستيك يزد,115,74280,1148185170,15090,15200,15670,580,3.84,15460,370,2.45,15190,15680
ضخود1210,اختيارخ خودرو-3000-1401/12/03,115,28341,8704240000,409,420,280,-129,-31.54,307,-102,-24.94,166,420
ساروج,بين المللي ساروج بوشهر,114,268569,7035568150,26150,25750,26300,150,0.57,26200,50,0.19,25750,26900
دريا,صندوق س درياي آبي فيروزه-سهام,113,1085726,12345606040,11470,11460,11150,-320,-2.79,11370,-100,-0.87,11140,11750
وايرا,سرمايه گذاري صنايع ايران,113,2535716,5487847972,2164,2228,2132,-32,-1.48,2164,0,0,2112,2228
رشد,صندوق س.رشد پايدار آبان-د,112,5763758,57768755157,10020,10034,10026,6,0.06,10023,3,0.03,10022,10034
ممسني,پتروشيمي ممسني,111,1339599,16832598240,12550,12200,12710,160,1.27,12570,20,0.16,12200,12790
ضصاد1124,اختيارخ وبصادر-1400-1401/11/19,108,12818,5992556000,488,540,450,-38,-7.79,468,-20,-4.1,400,540
كاردان,صندوق س تجارت شاخصي كاردان,108,129088,32549330940,250570,255020,250820,250,0.1,252150,1580,0.63,249570,256500
وامين,س. امين توان آفرين ساز,108,274945,3148659480,11350,11680,11280,-70,-0.62,11360,10,0.09,11230,11690
گپارس,امور رفاهي كارگزاران پارس,106,71993,10032041050,136700,140800,133150,-3550,-2.6,139200,2500,1.83,133100,140800
غدانه,پنبه و دانه هاي روغني خراسان,105,108000000,1610258200000,1000,20000,12400,11400,1140,14910,13910,1391,12400,20000
سخند,صندوق س.سپهرخبرگان نفت-د,105,768762,7033693721,9010,9090,9196,186,2.06,9149,139,1.54,9050,9197
شكف,كف,105,72482,2941306700,41000,40200,40200,-800,-1.95,40750,-250,-0.61,40200,41750
فيروزه,صندوق شاخص30 شركت فيروزه- سهام,102,801842,16938976360,20910,21350,20870,-40,-0.19,21130,220,1.05,20680,21430
رافزا,رايان هم افزا,101,38495,2572653050,63700,64950,66350,2650,4.16,66850,3150,4.95,64750,67550
ضملت3020,اختيارخ وبملت-2227-1402/03/28,100,4717,5552677000,1200,1256,1160,-40,-3.33,1177,-23,-1.92,1110,1256
فجوش,جوش‌ و اكسيژن‌ ايران‌,100,2522424,5846978832,2389,2318,2318,-71,-2.97,2381,-8,-0.33,2318,2318
حرهشا,رهشاد سپاهان (سهامي عام,100,64153,6913059750,104700,107700,107800,3100,2.96,107300,2600,2.48,107500,107800
وشهر,بانك شهر,99,2471515,15891841450,6250,6430,6430,180,2.88,6320,70,1.12,6430,6430
تسه0008,امتيازتسهيلات مسكن آبان1400,98,575,702907965,1208901,1183250,1205200,-3701,-0.31,1222449,13548,1.12,1183250,1269340
تسه0001,امتيازتسهيلات مسكن فروردين1400,98,1065,1346077645,1275265,1245111,1255010,-20255,-1.59,1263923,-11342,-0.89,1230000,1284400
سلام,صندوق س سلام فارابي-سهام,97,533379,5931989970,11150,11150,11090,-60,-0.54,11120,-30,-0.27,11020,11350
دشيري,شيرين دارو,96,74195,8328388750,109000,112250,112250,3250,2.98,111550,2550,2.34,112250,112250
اخزا101,اسناد خزانه-م1بودجه01-040326,96,298000,165273843000,553590,549580,555100,1510,0.27,554610,1020,0.18,549580,555100
ضستا1203,اختيارخ شستا-800-1401/12/03,96,17482,4602250000,249,283,250,1,0.4,263,14,5.62,200,289
سيستم,همكاران سيستم,94,391709,2943601310,7620,7600,7550,-70,-0.92,7610,-10,-0.13,7350,7820
ضخود1204,اختيارخ خودرو-1900-1401/12/03,94,15681,18719717000,1262,1320,1075,-187,-14.82,1194,-68,-5.39,1030,1320
كازرو,پتروشيمي كازرون,93,2172609,27026103370,12090,12380,12450,360,2.98,12440,350,2.89,12280,12450
زرين,صندوق س. سهام زرين كوروش-س,93,511669,7616731091,14886,14313,14890,4,0.03,14886,0,0,14313,15040
قيستو,شركت قند بيستون,92,146173,3594671100,25300,25100,24650,-650,-2.57,25050,-250,-0.99,24550,25100
ضخود3070,اختيارخ خودرو-3000-1402/03/03,92,9849,7206025000,827,853,680,-147,-17.78,732,-95,-11.49,619,853
ضخود1209,اختيارخ خودرو-2800-1401/12/03,90,16715,6583241000,523,540,477,-46,-8.8,394,-129,-24.67,310,557
فسا,پتروشيمي فسا,88,3472555,3375323460,944,972,972,28,2.97,953,9,0.95,972,972
كاج2,صندوق س. نوع دوم نو ويرا -د,87,87000000,87000000,10587,1,1,-10586,-99.99,1,-10586,-99.99,1,1
كماسه,تامين‌ ماسه‌ ريخته‌گري‌,87,2059724,10904178856,4948,5294,5294,346,6.99,5174,226,4.57,5294,5294
تسه9912,امتياز تسهيلات مسكن اسفند99,87,1364,1730972063,1264798,1250000,1256257,-8541,-0.68,1269041,4243,0.34,1216000,1293500
زعف0210پ11,زعفران0210نگين سحرخيز(پ),86,88333,29609751398,320352,335206,335206,14854,4.64,335206,14854,4.64,335205,335206
دسينا,داروسازي‌ سينا,81,2878439,29878196820,9890,10380,10380,490,4.95,10380,490,4.95,10380,10380
ضستا1207,اختيارخ شستا-1200-1401/12/03,81,8878,356086000,47,57,30,-17,-36.17,40,-7,-14.89,3,57
يارا,صندوق س. آريا-د,79,18875450,241460498976,12784,12792,12793,9,0.07,12792,8,0.06,12791,12793
ضسپا1203,اختيارخ خساپا-1800-1401/12/10,79,34443,25732469000,713,780,695,-18,-2.52,747,34,4.77,550,780
داريك,صندوق س.اعتماد داريك-د,78,5445279,78843239617,14458,14478,14480,22,0.15,14479,21,0.15,14478,14480
وشمال,س. چشم انداز توسعه شمال,78,214915,4620672500,21100,21500,21500,400,1.9,21450,350,1.66,21500,21500
ضخود1207,اختيارخ خودرو-2400-1401/12/03,77,4737,3485345000,820,851,625,-195,-23.78,736,-84,-10.24,600,998
اخزا002,اسنادخزانه-م2بودجه00-031024,76,136100,84132777000,617900,618100,618410,510,0.08,618170,270,0.04,613100,619000
زعف0210پ16,زعفران0210نگين بيرجند(پ),76,40331,13106266227,316812,325000,324000,7188,2.27,324968,8156,2.57,320000,327999
تسه0002,امتيازتسهيلاتمسكن ارديبهشت1400,75,556,704136483,1274640,1245229,1260001,-14639,-1.15,1266432,-8208,-0.64,1240014,1282310
تسه0007,امتيازتسهيلات مسكن مهر1400,74,659,808223398,1207544,1207544,1211000,3456,0.29,1226439,18895,1.56,1207544,1250000
زعف0210پ08,زعفران0210نگين روستا(پ),74,54042,17571898258,318346,319500,324300,5954,1.87,325153,6807,2.14,319500,329993
اهرم2,صندوق س سهامي كاريزما- اهرمي,74,7400000,7400000,14540,1,1,-14539,-99.99,1,-14539,-99.99,1,1
زعف0210پ09,زعفران0210نگين نوين(پ)	,73,36158,11721395988,316883,323000,325000,8117,2.56,324172,7289,2.3,320000,328799
ضجار2027,اختيارخ وتجارت-2000-1402/02/20,73,8107,1688550000,255,364,200,-55,-21.57,208,-47,-18.43,200,364
تسه0003,امتيازتسهيلات مسكن خرداد1400,72,485,607905516,1257318,1240011,1252012,-5306,-0.42,1253413,-3905,-0.31,1240011,1270000
تسه0004,امتيازتسهيلات مسكن تير1400,72,710,866135703,1217587,1240100,1210000,-7587,-0.62,1219909,2322,0.19,1157086,1250025
ددام,داروسازي زاگرس فارمد پارس,71,435622,4787485780,10470,10990,10990,520,4.97,10620,150,1.43,10990,10990
نمرينو,ايران‌ مرينوس‌,69,80831,9580898430,112890,118530,118530,5640,5,116080,3190,2.83,118530,118530
ضخاور106,اختيارخ خاور-2700-14020116,69,12180,16522521000,1363,1400,1300,-63,-4.62,1357,-6,-0.44,1270,1400
آرمان,بيمه آرمان,67,1083634,5766016360,5220,5250,5260,40,0.77,5280,60,1.15,5200,5370
طخود1207,اختيارف خودرو-2400-1401/12/03,65,20886,661513000,31,10,30,-1,-3.23,32,1,3.23,10,50
ضستا6006,اختيارخ شستا-1065-1402/06/08,63,11996,2810226000,240,300,230,-10,-4.17,234,-6,-2.5,186,300
ترمه,صندوق سرمايه گذاري ترمه-سهام	,60,329868,3530975640,10700,10980,10670,-30,-0.28,10700,0,0,10640,10990
ثروتم,صندوق س. ثروت آفرين پارسيان-س,59,426756,46941361463,109090,110105,109197,107,0.1,109996,906,0.83,109197,111114
تسه0005,امتيازتسهيلات مسكن مرداد 1400,59,387,470931266,1208270,1180102,1220000,11730,0.97,1216877,8607,0.71,1180102,1220009
وبازار,صندوق س شاخصي بازارآشنا,58,163932,2283589700,13730,14080,13760,30,0.22,13930,200,1.46,13650,14090
قاروم,قند اروميه,55,8007,1052583650,133550,134000,133300,-250,-0.19,133300,-250,-0.19,131050,134000
زعف0210پ18,زعفران0210نگين بهرامن(پ),54,28315,9264831388,319401,332000,326000,6599,2.07,327206,7805,2.44,322500,332000
ضخود1213,اختيارخ خودرو-3750-1401/12/03,54,2743,202797000,120,110,87,-33,-27.5,74,-46,-38.33,20,199
ثاصفا,شركت‌ ساختمان‌ اصفهان‌,53,256127,4174870100,15830,16300,16300,470,2.97,16020,190,1.2,16300,16300
شزنگ,تجهيزنيروي‌زنگان‌,53,38853,2857638150,72150,73550,73550,1400,1.94,72900,750,1.04,73550,73550
فاما,صنعتي‌ آما,51,513506,3948861140,7190,7690,7690,500,6.95,7310,120,1.67,7690,7690
ضسپا3027,اختيارخ خساپا-2600-1402/03/24,51,6406,2851695000,406,510,396,-10,-2.46,445,39,9.61,370,524
طسپا1203,اختيارف خساپا-1800-1401/12/10,51,15410,326272000,19,18,18,-1,-5.26,21,2,10.53,17,24
ضهرم1207,اختيارخ اهرم-13000-1401/12/22,51,1852,3965931000,2178,2300,2099,-79,-3.63,2141,-37,-1.7,1885,2345
دقاضي,داروسازي شهيد قاضي,51,508627,9689344350,18500,19050,19050,550,2.97,18910,410,2.22,19050,19050
ضهرم1204,اختيارخ اهرم-10000-1401/12/22,50,731,3519449000,4707,5100,4700,-7,-0.15,4815,108,2.29,4300,5240
ولانا,شركت ليزينگ آريا دانا,50,248911,6110765050,23850,24550,24550,700,2.94,24250,400,1.68,24550,24550
آوند2,صندوق س. آوند مفيد-د,50,4888001,4888001,11041,1,1,-11040,-99.99,1,-11040,-99.99,1,1
فبستم,صنايع ‌بسته‌بندي‌ مشهد,49,189812,2496027800,13550,13150,13150,-400,-2.95,13440,-110,-0.81,13150,13150
فلات,گروه صنايع معادن فلات ايرانيان,49,202544,5620596000,26950,27750,27750,800,2.97,27350,400,1.48,27750,27750
ضستا1204,اختيارخ شستا-900-1401/12/03,48,6049,1077066000,172,190,167,-5,-2.91,178,6,3.49,142,190
ضدي207,اختيارخ دي-800-14020217,48,3872,822796000,222,265,181,-41,-18.47,212,-10,-4.5,181,265
خبنيان,بنيان ديزل,48,156633,1646212830,10830,10510,10510,-320,-2.95,10830,0,0,10510,10510
وتوس,توسعه‌شهري‌توس‌گستر,48,1289217,14980701540,10860,11620,11620,760,7,11500,640,5.89,11620,11620
اخزا004,اسنادخزانه-م4بودجه00-030522,47,123800,84778585000,684810,685110,684810,0,0,684800,-10,0,684000,685120
درسا,صندوق سرمايه گذاري درسا - سهام,47,1853809,23267349130,12440,12620,12390,-50,-0.4,12550,110,0.88,12390,12650
اخزا910,اسنادخزانه-م10بودجه99-020807,46,23300,19376894000,830490,829900,830600,110,0.01,831630,1140,0.14,829900,839900
ضخاور110,اختيارخ خاور-3500-14020116,45,9575,8230315000,805,1041,820,15,1.86,860,55,6.83,820,1041
ضدي202,اختيارخ دي-550-14020217,44,2037,750538000,364,420,356,-8,-2.2,368,4,1.1,352,438
ضخاور1104,اختيارخ خاور-2400-14011109,44,4094,5375166000,1204,1349,1300,96,7.97,1313,109,9.05,1220,1350
صايند,صندوق س. گنجينه آينده روشن-د,44,2166620,21972173285,10124,10110,10140,16,0.16,10141,17,0.17,10106,10146
برليان,صندوق سرمايه گذاري برليان-سهام,43,177868,1936937750,10790,10720,10890,100,0.93,10890,100,0.93,10720,11000
ضستا6005,اختيارخ شستا-965-1402/06/08,43,5627,1565775000,299,317,280,-19,-6.35,278,-21,-7.02,250,320
دارا,صندوق س. دارا الگوريتم-د,43,566829,5677709937,10011,10017,10016,5,0.05,10017,6,0.06,10016,10017
ضهاي3006,اختيارخ هاي وب-2998-1402/03/03,43,1183,540815188,366,540,400,34,9.29,422,56,15.3,370,648
زعف0210پ19,زعفران0210نگين تروند قاينات(پ),42,9651,3143714444,314255,324548,324601,10346,3.29,325740,11485,3.65,324548,328000
اخزا005,اسنادخزانه-م5بودجه00-030626,41,61500,41193331000,669210,669250,670000,790,0.12,669810,600,0.09,669230,670500
ساحل,صندوق س.اوراق دولت خليج فارس-د,41,4276064,46985710842,10982,10988,10989,7,0.06,10988,6,0.05,10988,10989
ضستا6010,اختيارخ شستا-1465-1402/06/08,41,7126,975216000,145,140,140,-5,-3.45,137,-8,-5.52,125,180
ضجار2025,اختيارخ وتجارت-1800-1402/02/20,40,8960,2617939000,366,350,281,-85,-23.22,292,-74,-20.22,270,350
شيشه74ن,گواهي شيشه فلوت4بيرنگAكاويان,40,54900,49342033800,988638,898762,898762,-89876,-9.09,898762,-89876,-9.09,898762,898762
سمتاز,سيمان ممتازان كرمان,40,831850,31360745000,36650,37700,37700,1050,2.86,37700,1050,2.86,37700,37700
تداوم,صندوق تداوم اطمينان تمدن-ثابت,40,1291765,13044945773,10093,10099,10100,7,0.07,10099,6,0.06,10098,10100
شگامرن,مجتمع پترو صنعت گامرون,40,19834,7605333350,365220,383450,383450,18230,4.99,383450,18230,4.99,383350,383450
فكمند,گسترش قطعه سازي كمند,39,366719,16539026900,43800,45100,45100,1300,2.97,44100,300,0.68,45100,45100
دحاوي,الحاوي,39,370263,4202485050,11020,11350,11350,330,2.99,11150,130,1.18,11350,11350
ضملي7030,اختيارخ فملي-4853-1402/07/05,39,10255,21868555000,1900,2150,2000,100,5.26,2132,232,12.21,2000,2151
ضدي215,اختيارخ دي-1400-14020217,38,2941,264895000,95,189,81,-14,-14.74,90,-5,-5.26,81,100
شيشه123ن,گواهي شيشه فلوت4بيرنگBسهند,38,70000,65007810000,928683,928683,928683,0,0,928683,0,0,928683,928683
ضسپا3025,اختيارخ خساپا-2200-1402/03/24,38,3226,2272382000,675,750,664,-11,-1.63,704,29,4.3,601,751
فسديد,لوله‌وتجهيزات‌ سديد - ورشكسته,38,32949,2105441100,63300,63900,63900,600,0.95,63800,500,0.79,63900,63900
اخزا0022,اسنادخزانه-م2بودجه00-031024,38,1577,973307980,617900,601190,617050,-850,-0.14,617190,-710,-0.11,601190,619000
ارمغان,ص سرمايه گذاري ارمغان ايرانيان,38,164448,1657673074,10074,10079,10085,11,0.11,10080,6,0.06,10079,10085
طخود1206,اختيارف خودرو-2200-1401/12/03,37,9584,211093000,22,27,20,-2,-9.09,22,0,0,17,28
اخزا001,اسنادخزانه-م1بودجه00-030821,37,74300,47992129000,644630,645000,646490,1860,0.29,645920,1290,0.2,644830,650000
شيشه75ن,گواهي شيشه فلوت4بيرنگBكاويان,37,49900,46019626300,968348,922237,922237,-46111,-4.76,922237,-46111,-4.76,922237,922237
فالوم,آلومتك‌,37,517452,5008935360,9400,9680,9680,280,2.98,9530,130,1.38,9680,9680
ضصاد1123,اختيارخ وبصادر-1300-1401/11/19,37,2779,1670980000,609,633,565,-44,-7.22,601,-8,-1.31,565,633
افق ملت,صندوق س در سهام افق ملت,37,6691,1169256910,174290,176000,173990,-300,-0.17,174750,460,0.26,173520,176500
ضجار2020,اختيارخ وتجارت-1300-1402/02/20,36,4157,2709010000,665,710,630,-35,-5.26,652,-13,-1.95,610,710
شيشه62ن,گواهي شيشه فلوت4بيرنگAكاوه,35,60000,62201100000,1036685,1036685,1036685,0,0,1036685,0,0,1036685,1036685
ضخود3068,اختيارخ خودرو-2600-1402/03/03,35,1016,919440000,345,1414,801,456,132.17,905,560,162.32,800,1414
سي تيپ2ن34,گواهي سيمان تيپ2ممتازان(ن),35,1089000,8530137000,8497,7833,7833,-664,-7.81,7833,-664,-7.81,7833,7833
ضخاور113,اختيارخ خاور-4100-14020116,34,16630,7042060000,1,1050,400,399,39900,423,422,42200,400,1050
شيشه56ن,گواهي شيشه فلوت4بيرنگAاردكان,33,63600,70002230400,1210730,1100664,1100664,-110066,-9.09,1100664,-110066,-9.09,1100664,1100664
ضستا0107,اختيارخ شستا-1300-1402/01/09,33,2890,180907000,74,81,60,-14,-18.92,63,-11,-14.86,50,81
اخزا903,اسنادخزانه-م3بودجه99-011110,32,13700,13600909000,993150,992040,993270,120,0.01,992770,-380,-0.04,992040,993490
تكنو,تكنوتار,32,468383,5283360240,10750,11280,11280,530,4.93,10920,170,1.58,11280,11280
شيشه12ن,گواهي شيشه شيت4بيرنگAساوه,31,50000,34616600000,692332,692332,692332,0,0,692332,0,0,692332,692332
شيشه100ن,گواهي شيشه فلوت4بيرنگBدماوند,31,45000,46074240000,1023872,1023872,1023872,0,0,1023872,0,0,1023872,1023872
ضشنا1108,اختيارخ شپنا-8000-1401/11/19,31,1358,312214000,332,301,200,-132,-39.76,230,-102,-30.72,150,330
ضهرم1208,اختيارخ اهرم-14000-1401/12/22,30,2032,3033815000,1480,1600,1300,-180,-12.16,1493,13,0.88,1232,1675
شيشه99ن,گواهي شيشه فلوت4بيرنگAدماوند,30,60000,62114820000,1035247,1035247,1035247,0,0,1035247,0,0,1035247,1035247
اخزا006,اسنادخزانه-م6بودجه00-030723,30,56000,36819370000,656560,656500,657410,850,0.13,657490,930,0.14,656500,658990
اخزا909,اسنادخزانه-م9بودجه99-020316,29,34900,31968040000,914180,913690,913910,-270,-0.03,915990,1810,0.2,913610,917000
اخزا010,اسناد خزانه-م10بودجه00-031115,29,29400,17908694600,608990,608000,608801,-189,-0.03,609139,149,0.02,608000,613899
نگين,ص.س. زمين و ساختمان نگين شهرري,29,8679,686926900,78920,78550,77500,-1420,-1.8,79150,230,0.29,77500,80000
ضشنا1105,اختيارخ شپنا-6500-1401/11/19,29,591,746114000,1400,1440,1340,-60,-4.29,1262,-138,-9.86,1200,1440
شيشه60ن,گواهي شيشه فلوت10بيرنگAاردكان,28,25000,81075725000,3243029,3243029,3243029,0,0,3243029,0,0,3243029,3243029
وملت,سرمايه گذاري ملت,28,383601,853895826,2183,2226,2226,43,1.97,2190,7,0.32,2226,2226
بتك,كارخانجات كابل سازي‌ تك‌,28,670,247833000,377400,369900,369900,-7500,-1.99,377000,-400,-0.11,369900,369900
الماس,صندوق س.امين تدبيرگران فردا-س,27,5167,718766621,140645,142968,140490,-155,-0.11,139107,-1538,-1.09,138630,142968
شيشه86ن,گواهي شيشه فلوت10بيرنگAكاوه,27,20000,46229540000,2542623,2311477,2311477,-231146,-9.09,2311477,-231146,-9.09,2311477,2311477
ضخود1200,اختيارخ خودرو-1500-1401/12/03,27,2437,4205417000,1703,1849,1408,-295,-17.32,1726,23,1.35,1408,1850
ضهاي3010,اختيارخ هاي وب-4152-1402/03/03,26,1236,248983960,180,220,200,20,11.11,186,6,3.33,150,330
برن0204پ01,برنج طارم0204تجارت مازندران(پ),26,1389,1149503471,823709,830000,825000,1291,0.16,827576,3867,0.47,825000,830000
ضسپا1202,اختيارخ خساپا-1700-1401/12/10,26,2463,1874640000,824,950,790,-34,-4.13,761,-63,-7.65,700,950
سيناد,صندوق س.سپهرسودمند سينا-د,25,2582707,25890493083,10015,10025,10024,9,0.09,10025,10,0.1,10024,10025
اخزا003,اسنادخزانه-م3بودجه00-030418,25,131600,92307736000,701430,698010,701850,420,0.06,701430,0,0,695400,704000
اخزا009,اسناد خزانه-م9بودجه00-031101,24,23000,14128276000,612510,609810,612000,-510,-0.08,614270,1760,0.29,609800,617400
اخزا103,اسناد خزانه-م3بودجه01-040520,24,53400,28487423000,532050,532400,535390,3340,0.63,533470,1420,0.27,532400,535390
ضسپا3020,اختيارخ خساپا-1600-1402/03/24,24,122,114727000,1118,1207,807,-311,-27.82,940,-178,-15.92,807,1208
آسام,صندوق س.آرمان سپهر آشنا-م,23,19531,327522468,16632,16600,16779,147,0.88,16769,137,0.82,16600,16779
رماس,صندوق س.راهبرد ممتازابن سينا-س,23,152062,2009179856,13291,13463,13337,46,0.35,13213,-78,-0.59,13152,13463
كورز,ورزيران‌,23,1561,815076150,506950,522150,522150,15200,3,522150,15200,3,522150,522150
شيشه17ن,گواهي شيشه فلوت10بيرنگAكاويان,23,14720,34024926720,2542623,2311476,2311476,-231147,-9.09,2311476,-231147,-9.09,2311476,2311476
اخزا0052,اسنادخزانه-م5بودجه00-030626,22,1051,702616570,669210,668210,669000,-210,-0.03,668520,-690,-0.1,668210,669010
ضستا1104,اختيارخ شستا-900-1401/11/05,22,2033,265206000,136,149,136,0,0,130,-6,-4.41,100,149
طلا2,صندوق س.پشتوانه طلاي لوتوس,22,2200000,2200000,168722,1,1,-168721,-100,1,-168721,-100,1,1
ضخود1113,اختيارخ خودرو-3500-1401/11/12,22,4115,83265000,116,70,71,-45,-38.79,20,-96,-82.76,13,80
ضترا3023,اختيارخ شتران-3750-1402/03/28,22,1226,1629874000,1161,1350,1310,149,12.83,1329,168,14.47,1300,1352
ضستا1103,اختيارخ شستا-800-1401/11/05,22,2153,480059000,221,246,201,-20,-9.05,223,2,0.9,201,249
شتولي,تولي‌پرس‌,21,86040,1431705600,16320,16640,16640,320,1.96,16410,90,0.55,16640,16640
هپارس029,اختيارف ت­ وپارس-2000-02/09/08,21,942656,942656,1,1,1,0,0,1,0,0,1,1
ضسپا3026,اختيارخ خساپا-2400-1402/03/24,21,1803,1066477000,486,550,500,14,2.88,592,106,21.81,500,620
طهاي3006,اختيارف هاي وب-2998-1402/03/03,20,2065,718417748,285,300,350,65,22.81,321,36,12.63,300,350
شيشه21ن,گواهي شيشه فلوت4بيرنگAآسا,20,35000,35108185000,1003091,1003091,1003091,0,0,1003091,0,0,1003091,1003091
پادا,صندوق س.پاداش سرمايه پارس-س,20,53350,6932471727,131252,131347,129598,-1654,-1.26,129943,-1309,-1,128000,132800
گوهر2,صندوق سكه طلاي كيان,20,200000,200000,112499,1,1,-112498,-100,1,-112498,-100,1,1
ضخود1108,اختيارخ خودرو-2400-1401/11/12,20,2099,1283699000,838,791,640,-198,-23.63,612,-226,-26.97,550,791
اگ020555,گام بانك اقتصاد نوين0205,20,147240,125691957940,854203,854700,853010,-1193,-0.14,853654,-549,-0.06,853010,854700
ضستا6002,اختيارخ شستا-665-1402/06/08,19,6851,3155520000,481,480,430,-51,-10.6,461,-20,-4.16,421,480
ضستا6001,اختيارخ شستا-565-1402/06/08,19,324,175941000,562,579,538,-24,-4.27,543,-19,-3.38,537,579
ضملت1143,اختيارخ وبملت-2400-1401/11/24,19,355,436012000,1190,1329,1200,10,0.84,1228,38,3.19,1100,1330
ضهرم1209,اختيارخ اهرم-15000-1401/12/22,18,1249,1145767000,1032,1480,1000,-32,-3.1,917,-115,-11.14,800,1480
زعف0210پ23,زعفران0210نگين مدبرتوس(پ)	,18,5183,1681731314,314233,317990,323713,9480,3.02,324471,10238,3.26,317990,326091
اخزا1012,اسناد خزانه-م1بودجه01-040326,18,844,465564150,553590,550010,552030,-1560,-0.28,551620,-1970,-0.36,550000,552990
ضخاور1107,اختيارخ خاور-3000-14011109,18,1626,1156316000,632,760,630,-2,-0.32,711,79,12.5,609,760
ضخود1214,اختيارخ خودرو-4000-1401/12/03,18,1456,74556000,109,77,50,-59,-54.13,51,-58,-53.21,50,100
ضچكا1208,اختيارخ چكاپا-3250-1401/12/07,18,2375,355513000,164,113,199,35,21.34,150,-14,-8.54,113,199
شيشه127ن,گواهي شيشه فلوت6بيرنگBسهند,18,18942,20675761260,1200676,1091530,1091530,-109146,-9.09,1091530,-109146,-9.09,1091530,1091530
شسم,توليد سموم‌ علف‌ كش,17,1427,451645500,310300,316500,316500,6200,2,310850,550,0.18,316500,316500
ضترا3024,اختيارخ شتران-4000-1402/03/28,17,284,321421000,1197,1270,1245,48,4.01,1132,-65,-5.43,950,1270
ضشنا2025,اختيارخ شپنا-5859-1402/02/24,17,337,531726000,1541,1509,1700,159,10.32,1578,37,2.4,1509,1700
ضخاور1103,اختيارخ خاور-2200-14011109,17,2265,3438581000,1435,1550,1420,-15,-1.05,1518,83,5.78,1420,1550
دقاضيح,ح . داروسازي شهيد قاضي,17,24681,450015010,17400,18050,18400,1000,5.75,18230,830,4.77,18050,18590
ثبات2,صندوق س. ثبات ويستا -د,17,164000000,164000000,13368,1,1,-13367,-99.99,1,-13367,-99.99,1,1
اخزا007,اسنادخزانه-م7بودجه00-030912,17,41000,26090206000,635900,636800,636370,470,0.07,636350,450,0.07,636000,637000
داريوش,صندوق س. ثروت داريوش -س,17,31039,390314000,12621,12770,12412,-209,-1.66,12575,-46,-0.36,12400,12770
گنجينه,صندوق س. گنجينه داريوش-د,16,1712923,17189466668,10028,10040,10036,8,0.08,10035,7,0.07,10034,10040
طستا1104,اختيارف شستا-900-1401/11/05,16,5702,5702000,1,1,1,0,0,1,0,0,1,1
ضخود3073,اختيارخ خودرو-3750-1402/03/03,16,958,367935000,451,420,350,-101,-22.39,384,-67,-14.86,350,420
اخزا0012,اسنادخزانه-م1بودجه00-030821,16,700,450940350,644630,643600,644860,230,0.04,644200,-430,-0.07,643600,644860
زعف0210پ22,زعفران0210نگين گليران(پ),16,20552,6860489295,320352,329999,335204,14852,4.64,333811,13459,4.2,329999,335206
قنقش,قند نقش جهان,16,2816,671475200,245800,238450,238450,-7350,-2.99,245450,-350,-0.14,238450,238450
ثمين,صندوق س. ثروت افزون ثمين-س,16,43677,608524250,13641,13850,13870,229,1.68,13932,291,2.13,13850,14100
ضسپا1201,اختيارخ خساپا-1600-1401/12/10,16,2548,2154621000,886,761,860,-26,-2.93,846,-40,-4.51,700,980
ضخاور1100,اختيارخ خاور-1600-14011109,15,1592,3378700000,2010,2200,2010,0,0,2122,112,5.57,2010,2200
شيشه125ن,گواهي شيشه فلوت5بيرنگBسهند,15,19920,16121415360,890238,809308,809308,-80930,-9.09,809308,-80930,-9.09,809308,809308
ضخود3069,اختيارخ خودرو-2800-1402/03/03,15,1171,940693000,846,1110,664,-182,-21.51,803,-43,-5.08,664,1110
ضخود2036,اختيارخ خودرو-4000-1402/02/13,15,150,45000000,370,300,300,-70,-18.92,300,-70,-18.92,300,300
اخزا0042,اسنادخزانه-م4بودجه00-030522,15,817,556802330,684810,684000,681220,-3590,-0.52,681520,-3290,-0.48,680810,684000
شيشه59ن,گواهي شيشه فلوت8بيرنگAاردكان,14,15000,38138025000,2542535,2542535,2542535,0,0,2542535,0,0,2542535,2542535
ضكاريس205,اختيارخ كاريس-16000-14020205,14,696,1987741000,2472,3019,2700,228,9.22,2856,384,15.53,1310,3019
اخزا820,اسنادخزانه-م20بودجه98-020806,14,4400,3652798000,830870,830450,830150,-720,-0.09,830180,-690,-0.08,830150,830450
شيشه80ن,گواهي شيشه فلوت4بيرنگBآذر,14,20000,18758380000,937919,937919,937919,0,0,937919,0,0,937919,937919
اراد864,مرابحه عام دولت86-ش.خ020404,14,118432986,114263730377349,965540,964193,965400,-140,-0.01,964796,-744,-0.08,964193,965400
آرمانح,ح.بيمه آرمان,14,55036,209587976,3888,3775,4000,112,2.88,3808,-80,-2.06,3774,4000
طهرم7000,اختيارف اهرم-6500-1402/07/23,14,2323,519325000,236,103,299,63,26.69,224,-12,-5.08,103,299
ثنا,صندوق س.زرين نهال ثنا-س,14,30096,351428591,11667,11900,11501,-166,-1.42,11677,10,0.09,11500,11998
اخزا911,اسنادخزانه-م11بودجه99-020906,13,12200,9941855000,815080,814520,814700,-380,-0.05,814910,-170,-0.02,814520,819000
ضسپا3029,اختيارخ خساپا-3000-1402/03/24,13,1831,574930000,305,500,320,15,4.92,314,9,2.95,294,500
شيشه122ن,گواهي شيشه فلوت4بيرنگAسهند,13,24000,22523640000,938485,938485,938485,0,0,938485,0,0,938485,938485
ضدي206,اختيارخ دي-750-14020217,13,1880,353846000,253,258,190,-63,-24.9,188,-65,-25.69,160,258
اخزا907,اسنادخزانه-م7بودجه99-020704,13,2300,1945938000,849000,846060,846060,-2940,-0.35,846060,-2940,-0.35,846060,846060
زعف0210پ24,زعفران0210نگين پارسيلون(پ),12,2310,752553168,315600,321002,326000,10400,3.3,325781,10181,3.23,321000,327002
وثخوز,سرمايه گذاري و توسعه خوزستان,12,27161,858287600,30700,31600,31600,900,2.93,30750,50,0.16,31600,31600
ومشان,س. فني و مهندسي مشانير,12,28476,2858990400,103500,100400,100400,-3100,-3,100400,-3100,-3,100400,100400
هيوا,صندوق س. ثروت هيوا-س,12,92882,1077292868,11494,11600,11564,70,0.61,11599,105,0.91,11560,11798
ضخود1109,اختيارخ خودرو-2600-1401/11/12,12,839,527762000,674,671,514,-160,-23.74,629,-45,-6.68,514,690
ضستا1200,اختيارخ شستا-500-1401/12/03,12,2021,1172015000,600,581,568,-32,-5.33,580,-20,-3.33,568,581
شيشه18ن,گواهي شيشه فلوت10بيرنگBكاويان,12,7000,16484391000,2354913,2354913,2354913,0,0,2354913,0,0,2354913,2354913
بذر,صندوق س بذر اميد آفرين-سهام,12,541,69141460,126940,129000,126940,0,0,127800,860,0.68,126940,130000
شيشه63ن,گواهي شيشه فلوت4بيرنگBكاوه,11,20000,20327180000,1016359,1016359,1016359,0,0,1016359,0,0,1016359,1016359
شيشه58ن,گواهي شيشه فلوت6بيرنگAاردكان,11,14916,29023806372,1945817,1945817,1945817,0,0,1945817,0,0,1945817,1945817
شيشه88ن,گواهي شيشه فلوت5بيرنگAكاوه,11,14880,16703335680,1234789,1122536,1122536,-112253,-9.09,1122536,-112253,-9.09,1122536,1122536
سكه0211پ02,تمام سكه طرح جديد0211ملت,11,1600,3306041600,2065175,2066276,2066276,1101,0.05,2066276,1101,0.05,2066276,2066276
ضترا1143,اختيارخ شتران-3090-1401/11/19,11,54,106857574,1212,1300,1151,-61,-5.03,1223,11,0.91,1151,1300
شيشه01ن,گواهي شيشه فلوت6بيرنگAكاوه,11,9966,15298248504,1535044,1535044,1535044,0,0,1535044,0,0,1535044,1535044
ضترا1145,اختيارخ شتران-3710-1401/11/19,11,212,224704604,658,658,700,42,6.38,655,-3,-0.46,600,700
صنوين,صندوق سرمايه‌گذاري صنوين-مختلط,11,1128,155464880,137140,139320,137550,410,0.3,137820,680,0.5,137550,139320
شيشه22ن,گواهي شيشه فلوت4بيرنگBآسا,11,20000,19054320000,952716,952716,952716,0,0,952716,0,0,952716,952716
ضجار2021,اختيارخ وتجارت-1400-1402/02/20,11,768,460405000,588,600,555,-33,-5.61,599,11,1.87,555,610
ومللح,ح . اعتباري ملل,11,51313,151373350,1001,2950,2950,1949,194.71,2950,1949,194.71,2950,2950
شيشه107ن,گواهي شيشه فلوت10بيرنگAدماوند,11,9840,23828730960,2663780,2421619,2421619,-242161,-9.09,2421619,-242161,-9.09,2421619,2421619
ضستا6007,اختيارخ شستا-1165-1402/06/08,11,1774,362151000,208,206,204,-4,-1.92,204,-4,-1.92,183,206
سي تيپ2ن32,گواهي سيمان تيپ2هرمزگان(ن),11,500000,5231500000,11613,10463,10463,-1150,-9.9,10463,-1150,-9.9,10463,10463
ضخود0109,اختيارخ خودرو-3000-1402/01/09,11,2901,830150000,600,750,400,-200,-33.33,286,-314,-52.33,200,750
ضخاور1102,اختيارخ خاور-2000-14011109,11,944,1622870000,1771,1730,1700,-71,-4.01,1719,-52,-2.94,1600,1730
بازده,صندوق س. بازده ثابت-د,11,404171,4199437103,10383,10393,10393,10,0.1,10390,7,0.07,10390,10393
سكه0312پ01,تمام سكه طرح جديد0312 رفاه,11,1800,3719296800,2065175,2066276,2066276,1101,0.05,2066276,1101,0.05,2066276,2066276
زعف0210پ25,زعفران0210نگين زرپران (پ),10,1974,660828036,318581,335000,333500,14919,4.68,334766,16185,5.08,333500,335206
ضكاريس206,اختيارخ كاريس-17000-14020205,10,1304,2831980000,1835,2190,1850,15,0.82,2172,337,18.37,1850,2500
ضشنا1107,اختيارخ شپنا-7500-1401/11/19,10,146,44820000,587,450,170,-417,-71.04,307,-280,-47.7,170,450
ضخاور1105,اختيارخ خاور-2600-14011109,10,931,1038301000,1009,991,955,-54,-5.35,1115,106,10.51,955,1150
شيشه126ن,گواهي شيشه فلوت6بيرنگAسهند,10,9966,12719356650,1276275,1276275,1276275,0,0,1276275,0,0,1276275,1276275
سي تيپ2ن17,گواهي سيمان تيپ2ماهان كرمان(ن),10,321000,2442168000,8205,7608,7608,-597,-7.28,7608,-597,-7.28,7608,7608
اخزا0032,اسنادخزانه-م3بودجه00-030418,10,412,285474630,701430,666510,700830,-600,-0.09,692900,-8530,-1.22,666510,701000
اخزا0072,اسنادخزانه-م7بودجه00-030912,10,308,195265260,635900,610000,635510,-390,-0.06,633980,-1920,-0.3,610000,636000
گنجين,صندوق س. گنجينه يكم آويد-د,10,504173,8833134860,17514,17520,17520,6,0.03,17520,6,0.03,17520,17525
اخزا008,اسنادخزانه-م8بودجه00-030919,10,35700,22612536000,633000,633150,633310,310,0.05,633400,400,0.06,633050,633490
ضستا0104,اختيارخ شستا-1000-1402/01/09,10,7324,944200000,126,130,132,6,4.76,129,3,2.38,126,145
ضهاي3009,اختيارخ هاي وب-3690-1402/03/03,10,173,53626564,160,333,202,42,26.25,286,126,78.75,202,333
فردا2,صندوق س آواي فرداي زاگرس-ثابت,10,8992286,8992286,15079,1,1,-15078,-99.99,1,-15078,-99.99,1,1
شيشه90ن,گواهي شيشه فلوت6بيرنگAكاويان,10,10956,14810748084,1351839,1351839,1351839,0,0,1351839,0,0,1351839,1351839
ضملي7028,اختيارخ فملي-4187-1402/07/05,10,8950,21127900000,2300,2360,2362,62,2.7,2361,61,2.65,2360,2362
اراد314,مرابحه عام دولت3-ش.خ 0208,9,48218683,44802444001310,994300,929992,928310,-65990,-6.64,929151,-65149,-6.55,928310,929992
زعف0210پ21,زعفران0210نگين ملل(پ),9,1059,354975518,305000,335206,335188,30188,9.9,335199,30199,9.9,335188,335206
اراد1064,مرابحه عام دولت106-ش.خ020624,9,158440000,151739028660000,982350,958103,957300,-25050,-2.55,957707,-24643,-2.51,957300,958103
مرواريد,صندوق س. مرواريد بها بازار-س,9,37881,431225066,11232,11392,11238,6,0.05,11384,152,1.35,11238,11500
شيشه03ن,گواهي شيشه فلوت8بيرنگAكاوه,9,8000,13187328000,1648416,1648416,1648416,0,0,1648416,0,0,1648416,1648416
ضستا6000,اختيارخ شستا-465-1402/06/08,9,166,108008000,670,669,641,-29,-4.33,651,-19,-2.84,641,669
ضهرم1206,اختيارخ اهرم-12000-1401/12/22,9,313,390664000,2788,2600,280,-2508,-89.96,1248,-1540,-55.24,280,2600
ضسلا7005,اختيارخ سلام-11000-1402/07/19,8,493,1275618000,2583,2570,2790,207,8.01,2587,4,0.15,2570,2790
ضسپا3028,اختيارخ خساپا-2800-1402/03/24,8,443,177772000,349,550,350,1,0.29,401,52,14.9,202,550
ضشنا1109,اختيارخ شپنا-9000-1401/11/19,8,1062,129120000,162,120,120,-42,-25.93,122,-40,-24.69,120,150
شيشه103ن,گواهي شيشه فلوت6بيرنگAدماوند,8,10956,18747326532,1711147,1711147,1711147,0,0,1711147,0,0,1711147,1711147
نشان,صندوق س. نشان هامرز-د,8,190881,2213093542,11588,11594,11594,6,0.05,11594,6,0.05,11594,11595
اخزا0014,اسنادخزانه-م1بودجه00-030821,8,22649315,14550968254066,644630,642758,642020,-2610,-0.4,642446,-2184,-0.34,642020,642758
اراد344,مرابحه عام دولت3-ش.خ 0305,8,40260000,34921483740000,1000000,867598,867200,-132800,-13.28,867399,-132601,-13.26,867200,867598
اراد324,مرابحه عام دولت3-ش.خ0211,8,63095328,58149285238080,932560,910660,932560,0,0,921610,-10950,-1.17,910660,932560
اراد874,مرابحه عام دولت87-ش.خ030304,8,147009214,133321921130530,943200,907090,906700,-36500,-3.87,906895,-36305,-3.85,906700,907090
اخزا0062,اسنادخزانه-م6بودجه00-030723,8,208,136398660,656560,653380,656410,-150,-0.02,655760,-800,-0.12,653380,656410
اراد534,مرابحه عام دولت5-ش.خ 0207,8,31702800,29967658201800,944470,943602,946935,2465,0.26,945268,798,0.08,943602,946935
شيشه73ن,گواهي شيشه شيت6بيرنگAساوه,8,5280,4169045760,868551,789592,789592,-78959,-9.09,789592,-78959,-9.09,789592,789592
ضخود1203,اختيارخ خودرو-1800-1401/12/03,8,235,288096000,1428,1351,1211,-217,-15.2,1226,-202,-14.15,1211,1310
ضخود3067,اختيارخ خودرو-2400-1402/03/03,8,110,124266000,1228,1189,1099,-129,-10.5,1130,-98,-7.98,1099,1189
اراد1084,مرابحه عام دولت108-ش.خ060218,8,25900000,20647609500000,1000000,799730,794680,-205320,-20.53,797205,-202795,-20.28,794680,799730
اخزا0064,اسنادخزانه-م6بودجه00-030723,8,60821809,39845800073945,656560,656393,653480,-3080,-0.47,655124,-1436,-0.22,653480,656393
شيشه124ن,گواهي شيشه فلوت5بيرنگAسهند,7,10000,9223290000,1014561,922329,922329,-92232,-9.09,922329,-92232,-9.09,922329,922329
تاراز,صندوق س آواي تاراز زاگرس-سهام,7,31870,430338950,13400,13500,13340,-60,-0.45,13500,100,0.75,13340,13600
ضجار2028,اختيارخ وتجارت-2200-1402/02/20,7,1175,241962000,214,272,200,-14,-6.54,206,-8,-3.74,200,272
ضسپا1200,اختيارخ خساپا-1500-1401/12/10,7,1181,1111226000,1038,1249,990,-48,-4.62,941,-97,-9.34,900,1249
ضسرو1018,اختيارخ سرو-90000-1402/10/06,7,51,14410000,33000,31000,28000,-5000,-15.15,28255,-4745,-14.38,28000,31000
ضجار2024,اختيارخ وتجارت-1700-1402/02/20,7,33,10875000,447,500,370,-77,-17.23,330,-117,-26.17,321,370
سكه0112پ03,تمام سكه طرح جديد0112سامان,7,900,1859648400,2065175,2066276,2066276,1101,0.05,2066276,1101,0.05,2066276,2066276
اخزا0044,اسنادخزانه-م4بودجه00-030522,7,15882890,10846096038500,684810,683160,682550,-2260,-0.33,682879,-1931,-0.28,682550,683160
شيشه144ن,گواهي شيشه فلوت4بيرنگAآذر,7,10000,9441670000,944167,944167,944167,0,0,944167,0,0,944167,944167
اراد604,مرابحه عام دولتي6-ش.خ0210,7,25814600,24043189777200,933220,931414,931350,-1870,-0.2,931379,-1841,-0.2,931350,931414
آگاس2,صندوق س.هستي بخش آگاه-س,7,3500000,3500000,100069,1,1,-100068,-100,1,-100068,-100,1,1
هماي2,صندوق س هماي آگاه-ثابت,7,117200000,117200000,10013,1,1,-10012,-99.99,1,-10012,-99.99,1,1
اراد334,مرابحه عام دولت3-ش.خ 0303,7,17703050,15582980652250,990000,880771,879500,-110500,-11.16,880243,-109757,-11.09,879500,880771
اراد50,مرابحه عام دولت5-ش.خ0302,7,480000,480000000000,1000000,1000000,1000000,0,0,1000000,0,0,1000000,1000000
اراد1054,مرابحه عام دولت105-ش.خ030503,7,26300290,25045865934500,986000,940550,986000,0,0,952304,-33696,-3.42,940550,986000
اراد1074,مرابحه عام دولت107-ش.خ030724,7,48642000,44203489506000,932000,896706,927000,-5000,-0.54,908751,-23249,-2.49,896706,927000
ضفلا7023,اختيارخ فولاد-2150-1402/07/26,7,33,105700000,3300,3300,3100,-200,-6.06,3203,-97,-2.94,3100,3300
اخزا908,اسنادخزانه-م8بودجه99-020606,7,6100,5279484000,865560,865440,865450,-110,-0.01,865490,-70,-0.01,865410,865500
ضستا1201,اختيارخ شستا-600-1401/12/03,6,999,479520000,522,480,480,-42,-8.05,480,-42,-8.05,480,480
ضچكا1207,اختيارخ چكاپا-3000-1401/12/07,6,851,233520000,285,300,280,-5,-1.75,274,-11,-3.86,237,300
ضجار2017,اختيارخ وتجارت-1000-1402/02/20,6,95,77250000,1195,800,800,-395,-33.05,813,-382,-31.97,800,1050
ضهرم7008,اختيارخ اهرم-13000-1402/07/23,6,56,289961000,4700,5361,5162,462,9.83,5178,478,10.17,5162,5361
طخود1208,اختيارف خودرو-2600-1401/12/03,6,190,14770000,65,63,130,65,100,78,13,20,60,130
ضبساما305,اختيارخ بساما-12000-14020310,6,32,28825000,919,910,820,-99,-10.77,901,-18,-1.96,820,910
طخود1204,اختيارف خودرو-1900-1401/12/03,6,1744,21972000,10,12,12,2,20,13,3,30,12,14
افاد744,منفعت دولت7-ش.خاص ساير0204,6,10006000,9705749958000,1000000,969356,970630,-29370,-2.94,969993,-30007,-3,969356,970630
شيشه57ن,گواهي شيشه فلوت5بيرنگAاردكان,6,10000,14413460000,1441346,1441346,1441346,0,0,1441346,0,0,1441346,1441346
گام020661,گواهي اعتبار مولد شهر0206,6,75000,62625000000,835000,835000,835000,0,0,835000,0,0,835000,835000
ضفلا1173,اختيارخ فولاد-5000-1401/11/26,6,440,542490000,1320,1231,1350,30,2.27,1233,-87,-6.59,1229,1350
پاداش2,صندوق س. ارزش پاداش-د,6,30000000,30000000,10255,1,1,-10254,-99.99,1,-10254,-99.99,1,1
سپيدما2,صندوق س. سپيد دماوند-د,6,55500000,55500000,14388,1,1,-14387,-99.99,1,-14387,-99.99,1,1
اخزا0024,اسنادخزانه-م2بودجه00-031024,6,24677274,15180607755400,617900,615288,615100,-2800,-0.45,615165,-2735,-0.44,615100,615288
اراد644,مرابحه عام دولتي64-ش.خ0111,6,52745063,52611946576750,995860,997250,998000,2140,0.21,997476,1616,0.16,997250,998000
اخزا8204,اسنادخزانه-م20بودجه98-020806,6,17923514,14884519923351,830870,825903,834990,4120,0.5,830446,-424,-0.05,825903,834990
اراد904,مرابحه عام دولت90-ش.خ050217,6,36000000,29804832000000,953350,830074,825750,-127600,-13.38,827912,-125438,-13.16,825750,830074
اراد924,مرابحه عام دولت92-ش.خ020825,6,16726610,15605600961105,957720,933861,932100,-25620,-2.68,932980,-24740,-2.58,932100,933861
اراد1044,مرابحه عام دولت104-ش.خ020303,6,74118200,72392876540400,980000,976544,976900,-3100,-0.32,976722,-3278,-0.33,976544,976900
كارا2,صندوق س. كارا -د,6,202000000,202000000,13175,1,1,-13174,-99.99,1,-13174,-99.99,1,1
ضخود3071,اختيارخ خودرو-3250-1402/03/03,6,1413,875300000,657,625,600,-57,-8.68,619,-38,-5.78,600,625
ضخود3074,اختيارخ خودرو-4000-1402/03/03,6,555,174750000,410,380,300,-110,-26.83,315,-95,-23.17,300,380
اراد1024,مرابحه عام دولت102-ش.خ031211,6,43281470,39452496832676,975930,862913,975930,0,0,911533,-64397,-6.6,862913,975930
برن0203پ02,برنج فجر0203 تجارت مازندران(پ),6,650,372450000,571167,573000,573000,1833,0.32,573000,1833,0.32,573000,573000
شيشه131ن,گواهي شيشه فلوت10بيرنگBسهند,6,2280,5253633000,2304225,2304225,2304225,0,0,2304225,0,0,2304225,2304225
سي تيپ2ن04,گواهي سيمان تيپ2فارس نو(ن),6,125000,1015500000,8570,8124,8124,-446,-5.2,8124,-446,-5.2,8124,8124
شيشه31ن,گواهي شيشه فلوت6بيرنگBآذر,6,5940,7124115240,1199346,1199346,1199346,0,0,1199346,0,0,1199346,1199346
اراد964,مرابحه عام دولت96-ش.خ030414,6,21427600,19881395097800,956900,899281,956400,-500,-0.05,927840,-29060,-3.04,899281,956400
طسپا1210,اختيارف خساپا-3000-1401/12/10,5,50,25000000,400,500,500,100,25,500,100,25,500,500
شيشه92ن,گواهي شيشه فلوت8بيرنگBكاويان,5,2450,3305270500,1349090,1349090,1349090,0,0,1349090,0,0,1349090,1349090
شيشه97ن,گواهي شيشه فلوت3بيرنگAدماوند,5,7315,5647180000,843748,772000,772000,-71748,-8.5,772000,-71748,-8.5,772000,772000
ضملت1145,اختيارخ وبملت-2800-1401/11/24,5,168,122160000,800,800,800,0,0,727,-73,-9.13,690,800
ضسرو1019,اختيارخ سرو-100000-1402/10/06,5,14,3240000,25000,25000,23000,-2000,-8,23143,-1857,-7.43,23000,25000
اراد554,مرابحه عام دولت5-ش.خ 0209,5,25171168,23559933162064,962030,937131,935090,-26940,-2.8,935989,-26041,-2.71,935090,937131
اخزا9084,اسنادخزانه-م8بودجه99-020606,5,7601982,6557375111673,865560,863343,861810,-3750,-0.43,862588,-2972,-0.34,861810,863343
شيشه105ن,گواهي شيشه فلوت8بيرنگAدماوند,5,2850,5109035400,1971908,1792644,1792644,-179264,-9.09,1792644,-179264,-9.09,1792644,1792644
شيشه91ن,گواهي شيشه فلوت6بيرنگBكاويان,5,4950,5953092750,1202645,1202645,1202645,0,0,1202645,0,0,1202645,1202645
اراد1144,مرابحه عام دولت114-ش.خ021229	,5,35000000,32508792000000,1000000,929108,928200,-71800,-7.18,928823,-71177,-7.12,928200,929108
اخزا9104,اسنادخزانه-م10بودجه99-020807,5,6707456,5568635580000,830490,827720,831510,1020,0.12,830216,-274,-0.03,827720,831520
اراد944,مرابحه عام دولت94-ش.خ030816,5,36729000,32300484727500,948400,879695,879200,-69200,-7.3,879427,-68973,-7.27,879200,879695
اخزا0092,اسناد خزانه-م9بودجه00-031101,5,189,110305660,612510,582170,597770,-14740,-2.41,583630,-28880,-4.72,582170,597770
اخزا9102,اسنادخزانه-م10بودجه99-020807,5,215,170082100,830490,800000,788990,-41500,-5,791080,-39410,-4.75,788970,800000
اخزا0094,اسناد خزانه-م9بودجه00-031101,5,11611200,7125422980400,612510,616262,610900,-1610,-0.26,613668,1158,0.19,610900,616262
اخزا9032,اسنادخزانه-م3بودجه99-011110,5,138,137044600,993150,999990,993000,-150,-0.02,993080,-70,-0.01,991030,999990
سي تيپ2ن35,گواهي سيمان تيپ2دشتستان(ن)	,5,312000,2988336000,9274,9578,9578,304,3.28,9578,304,3.28,9578,9578
اراد1034,مرابحه عام دولت103-ش.خ050821,5,26553700,21488565598300,1020000,813634,808875,-211125,-20.7,809249,-210751,-20.66,808713,813634
اراد107,مرابحه عام دولت107-ش.خ030724,5,235000,216879000000,932000,902800,929000,-3000,-0.32,922890,-9110,-0.98,902800,930000
عقيق,صندوق سرمايه گذاري عقيق-سهام,5,4903,257587800,52880,54000,52510,-370,-0.7,52540,-340,-0.64,52500,54000
اراد494,مرابحه عام دولت4-ش.خ 0206,5,25187000,24269738628000,976920,977694,952260,-24660,-2.52,963582,-13338,-1.37,952260,977694
شيشه140ن,گواهي شيشه فلوت3بيرنگAكاوه,5,3990,3060505560,843748,767044,767044,-76704,-9.09,767044,-76704,-9.09,767044,767044
ضهاي3008,اختيارخ هاي وب-3460-1402/03/03,5,112,36878764,303,305,310,7,2.31,304,1,0.33,211,310
فنرژي,گسترش صنايع انرژي آذرآب,5,9072,157762080,17740,17390,17390,-350,-1.97,17730,-10,-0.06,17390,17390
رايكا2,صندوق س نوع دوم رايكا- ثابت	,5,5000000,5000000,10615,1,1,-10614,-99.99,1,-10614,-99.99,1,1
ضسپا3030,اختيارخ خساپا-3250-1402/03/24,5,1700,531000000,325,350,250,-75,-23.08,312,-13,-4,250,350
ضهرم1203,اختيارخ اهرم-9000-1401/12/22,5,185,598025000,5551,5900,5900,349,6.29,3233,-2318,-41.76,1000,5900
ضخود1202,اختيارخ خودرو-1700-1401/12/03,5,500,663500000,1400,1327,1327,-73,-5.21,1327,-73,-5.21,1327,1327
ضستا1102,اختيارخ شستا-700-1401/11/05,5,322,103408000,337,310,330,-7,-2.08,321,-16,-4.75,310,330
شيشه101ن,گواهي شيشه فلوت5بيرنگAدماوند,5,8000,9398864000,1174858,1174858,1174858,0,0,1174858,0,0,1174858,1174858
شيشه108ن,گواهي شيشه فلوت10بيرنگBدماوند,4,2000,4713780000,2592579,2356890,2356890,-235689,-9.09,2356890,-235689,-9.09,2356890,2356890
شيشه61ن,گواهي شيشه فلوت12بيرنگAاردكان,4,2970,11326994910,3813803,3813803,3813803,0,0,3813803,0,0,3813803,3813803
ضهرم7010,اختيارخ اهرم-15000-1402/07/23,4,595,3070290000,4077,5604,5209,1132,27.77,5160,1083,26.56,5100,5604
ضترا3025,اختيارخ شتران-4500-1402/03/28,4,126,155356000,1001,1250,1233,232,23.18,1233,232,23.18,789,1250
ضهرم7000,اختيارخ اهرم-6500-1402/07/23,4,12,120189000,12000,12000,9000,-3000,-25,10016,-1984,-16.53,9000,12000
اگ020318,گام بانك تجارت0203,4,26,23270700,895000,895700,895000,0,0,895027,27,0,895000,895700
اگ020618,گام بانك تجارت0206,4,1040,868400000,840996,835000,835000,-5996,-0.71,835000,-5996,-0.71,835000,835000
اخزا0074,اسنادخزانه-م7بودجه00-030912,4,7460510,4724887053520,635900,633752,633000,-2900,-0.46,633320,-2580,-0.41,633000,633752
اراد764,مرابحه عام دولت76-ش.خ030406,4,8478000,7737938424000,983000,912861,912555,-70445,-7.17,912708,-70292,-7.15,912555,912861
سپرمي,پرميت‌,4,1505,49966000,33500,33200,33200,-300,-0.9,33500,0,0,33200,33200
شيشه04ن,گواهي شيشه فلوت8بيرنگBكاوه,4,4250,6321322500,1487370,1487370,1487370,0,0,1487370,0,0,1487370,1487370
ضستا1208,اختيارخ شستا-1300-1401/12/03,4,1300,44700000,37,39,20,-17,-45.95,34,-3,-8.11,20,41
ضدار1204,اختيارخ ص.دارا-90000-01/12/16,4,955,325150000,10241,35000,33000,22759,222.23,34047,23806,232.46,33000,35000
سي تيپ2ن31,گواهي سيمان تيپ2گيلان سبز(ن),4,132000,833184000,6174,6312,6312,138,2.24,6312,138,2.24,6312,6312
اراد1014,مرابحه عام دولت101-ش.خ020711,4,10672800,10040041706400,961840,940116,941310,-20530,-2.13,940713,-21127,-2.2,940116,941310
سي تيپ2ن11,گواهي سيمان تيپ2دورود(ن),4,69000,445533000,6457,6457,6457,0,0,6457,0,0,6457,6457
اراد1214,مرابحه عام دولت121-ش.خ030324,4,59960000,54824755780000,959000,915611,913100,-45900,-4.79,914355,-44645,-4.66,913100,915611
اراد1134,مرابحه عام دولت113-ش.خ060627,4,39960000,31475473020000,1000000,790349,785000,-215000,-21.5,787674,-212326,-21.23,785000,790349
اخزا1032,اسناد خزانه-م3بودجه01-040520,4,180,95412730,532050,531000,530030,-2020,-0.38,530070,-1980,-0.37,530010,531000
شيشه93ن,گواهي شيشه فلوت5بيرنگAكاويان,4,4000,4063464000,1015866,1015866,1015866,0,0,1015866,0,0,1015866,1015866
صايند2,صندوق س. گنجينه آينده روشن-د,4,3500000,3500000,10124,1,1,-10123,-99.99,1,-10123,-99.99,1,1
تسه14012,امتيازتسهيلات مسكن سال1401,4,493,4930,1207264,10,10,-1207254,-100,10,-1207254,-100,10,10
دريا2,صندوق س درياي آبي فيروزه-سهام,4,343357,343357,11470,1,1,-11469,-99.99,1,-11469,-99.99,1,1
آكورد2,صندوق س. آرمان آتي كوثر-د,4,17300000,17300000,44661,1,1,-44660,-100,1,-44660,-100,1,1
داريك2,صندوق س.اعتماد داريك-د,4,4000000,4000000,14458,1,1,-14457,-99.99,1,-14457,-99.99,1,1
اخزا8214,اسنادخزانه-م21بودجه98-020906,4,23887676,19414851995056,814720,813312,812200,-2520,-0.31,812756,-1964,-0.24,812200,813312
اراد1114,مرابحه عام دولت111-ش.خ 021008,4,19860000,18665172750000,985000,940675,939000,-46000,-4.67,939837,-45163,-4.59,939000,940675
اراد954,مرابحه عام دولت95-ش.خ020514,4,27030400,25812639934400,960300,954847,955050,-5250,-0.55,954948,-5352,-0.56,954847,955050
اخزا0034,اسنادخزانه-م3بودجه00-030418,4,7274774,5082571794794,701430,698231,699000,-2430,-0.35,698657,-2773,-0.4,698231,699000
اراد1174,مرابحه عام دولت117-ش.خ030406,4,68600000,62637013600000,990000,913252,912900,-77100,-7.79,913076,-76924,-7.77,912900,913252
اخزا0054,اسنادخزانه-م5بودجه00-030626,4,12284833,8209879887814,669210,667558,669000,-210,-0.03,668294,-916,-0.14,667558,669000
شيشه30ن,گواهي شيشه فلوت6بيرنگAآذر,4,3300,4522742400,1370528,1370528,1370528,0,0,1370528,0,0,1370528,1370528
ولملتح,ح . واسپاري ملت,4,6037,23908300,3900,4100,3900,0,0,3960,60,1.54,3900,4100
اراد704,مرابحه عام دولت70-ش.خ0112,4,40228000,39782253646000,993600,989185,988654,-4946,-0.5,988919,-4681,-0.47,988654,989185
اراد244,مرابحه عام دولت2-ش.خ ساير0212,4,12000000,11217930000000,955370,929655,940000,-15370,-1.61,934827,-20543,-2.15,929655,940000
ضهاي3001,اختيارخ هاي وب-2030-1402/03/03,4,105,119250840,1078,1060,1000,-78,-7.24,1048,-30,-2.78,1000,1060
ضپلا1208,اختيارخ پالايش-100000-01/12/16,4,1000,227397500,20417,23000,23499,3082,15.1,22740,2323,11.38,22000,23499
ضهاي3004,اختيارخ هاي وب-2583-1402/03/03,4,160,120324000,422,700,680,258,61.14,694,272,64.45,680,700
شيشه102ن,گواهي شيشه فلوت5بيرنگBدماوند,4,5440,5447909760,1001454,1001454,1001454,0,0,1001454,0,0,1001454,1001454
اراد1124,مرابحه عام دولت112-ش.خ 040408,4,24513114,21856296908781,912000,867733,915500,3500,0.38,891616,-20384,-2.24,867733,915500
ضملت1148,اختيارخ وبملت-3500-1401/11/24,4,351,61200000,230,200,155,-75,-32.61,174,-56,-24.35,155,200
ضپلا1210,اختيارخ پالايش-120000-01/12/16,4,140,7150000,10282,3450,15000,4718,45.89,5107,-5175,-50.33,2450,15000
سي تيپ2ن07,گواهي سيمان تيپ 2تهران(ن),4,98000,890820000,7648,9090,9090,1442,18.85,9090,1442,18.85,9090,9090
اخزا1014,اسناد خزانه-م1بودجه01-040326,4,6825295,3773037559105,553590,553119,552500,-1090,-0.2,552802,-788,-0.14,552500,553119
اوج,صندوق س.اوج دماوند-س,4,1528,17641416,11164,11483,11597,433,3.88,11545,381,3.41,11483,11597
شيشه104ن,گواهي شيشه فلوت6بيرنگBدماوند,4,3960,5504130720,1389932,1389932,1389932,0,0,1389932,0,0,1389932,1389932
شيشه76ن,گواهي شيشه فلوت8بيرنگAكاويان,4,2500,4550552500,1820221,1820221,1820221,0,0,1820221,0,0,1820221,1820221
سي تيپ2ن14,گواهي سيمان تيپ2ساوه(ن),3,145000,1098230000,7573,7574,7574,1,0.01,7574,1,0.01,7574,7574
سي تيپ2ن24,گواهي سيمان تيپ2هگمتان(ن),3,51000,306102000,6188,6002,6002,-186,-3.01,6002,-186,-3.01,6002,6002
شيشه136ن,گواهي شيشه فلوت3بيرنگAكاويان,3,3591,2754455004,843748,767044,767044,-76704,-9.09,767044,-76704,-9.09,767044,767044
تملي809,تسهيلات مسكن ب. ملي-آذر98,3,18,11500164,608475,638898,638898,30423,5,638898,30423,5,638898,638898
ضملت1144,اختيارخ وبملت-2600-1401/11/24,3,55,51850000,952,940,970,18,1.89,943,-9,-0.95,940,970
اخزا821,اسنادخزانه-م21بودجه98-020906,3,1200,994798000,814720,828990,829000,14280,1.75,829000,14280,1.75,828990,829000
ضصاد3022,اختيارخ وبصادر-1600-1402/03/17,3,50,39970000,845,797,800,-45,-5.33,799,-46,-5.44,797,800
ضستا1202,اختيارخ شستا-700-1401/12/03,3,999,384615000,355,385,385,30,8.45,385,30,8.45,385,385
ضپلا1211,اختيارخ پالايش-130000-01/12/16,3,1150,28000000,4172,2000,2500,-1672,-40.08,2435,-1737,-41.63,2000,2500
شيشه33ن,گواهي شيشه فلوت5بيرنگBآذر,3,3920,3437926240,877022,877022,877022,0,0,877022,0,0,877022,877022
اراد1184,مرابحه عام دولت118-ش.خ060725,3,11000000,8632237000000,1000000,788479,783350,-216650,-21.67,784749,-215251,-21.53,783350,788479
اخزا906,اسنادخزانه-م6بودجه99-020321,3,1300,1189300000,912700,913500,916000,3300,0.36,914850,2150,0.24,913500,916000
اخزا0104,اسناد خزانه-م10بودجه00-031115,3,3977300,2418532395300,608990,609111,607000,-1990,-0.33,608084,-906,-0.15,607000,609111
اطلس2,صندوق س.توسعه اطلس مفيد-س,3,15000,15000,319195,1,1,-319194,-100,1,-319194,-100,1,1
اراد1094,مرابحه عام دولت109-ش.خ020719,3,42152256,40170417961344,1000000,951123,954450,-45550,-4.56,952984,-47016,-4.7,951123,954450
اخزا0084,اسنادخزانه-م8بودجه00-030919,3,4637715,2925884065565,633000,630991,630750,-2250,-0.36,630889,-2111,-0.33,630750,630991
شيشه89ن,گواهي شيشه فلوت5بيرنگBكاوه,3,4800,5268441600,1097592,1097592,1097592,0,0,1097592,0,0,1097592,1097592
افران2,صندوق س افرا نماد پايدار-ثابت,3,56000000,56000000,18942,1,1,-18941,-99.99,1,-18941,-99.99,1,1
سي تيپ2ن02,گواهي سيمان تيپ2صوفيان(ن),3,60000,442800000,7380,7380,7380,0,0,7380,0,0,7380,7380
اراد61,مرابحه عام دولت61-ش.خ0309,3,160000,160000000000,1000000,1000000,1000000,0,0,1000000,0,0,1000000,1000000
تابان04,اجاره تابان سپهر14031126,3,20000,18382000000,1007850,919100,919100,-88750,-8.81,919100,-88750,-8.81,919100,919100
ضچكا1205,اختيارخ چكاپا-2600-1401/12/07,3,5,2298000,900,515,352,-548,-60.89,460,-440,-48.89,352,515
ضصاد1122,اختيارخ وبصادر-1200-1401/11/19,3,23,14972000,682,650,651,-31,-4.55,651,-31,-4.55,650,652
شيشه137ن,گواهي شيشه فلوت3بيرنگBكاويان,3,2926,1959837726,703290,669801,669801,-33489,-4.76,669801,-33489,-4.76,669801,669801
سي تيپ2ن01,گواهي سيمان تيپ 2 فارس(ن),3,85000,765340000,8641,9004,9004,363,4.2,9004,363,4.2,9004,9004
ضخود1111,اختيارخ خودرو-3000-1401/11/12,3,301,60481000,353,200,201,-152,-43.06,201,-152,-43.06,200,201
ضدي201,اختيارخ دي-500-14020217,3,107,49248000,467,460,464,-3,-0.64,460,-7,-1.5,460,464
اراد1194,مرابحه عام دولت119-ش.خ060811	,3,15000000,14134538000000,952250,787622,998550,46300,4.86,942303,-9947,-1.04,787622,998550
ضترا1142,اختيارخ شتران-2781-1401/11/19,3,753,1178554436,1467,643,1616,149,10.16,967,-500,-34.08,643,1616
طفلا1172,اختيارف فولاد-4500-1401/11/26,3,50,740000,31,13,15,-16,-51.61,15,-16,-51.61,13,15
ضخاور1106,اختيارخ خاور-2800-14011109,3,102,91701000,860,899,900,40,4.65,899,39,4.53,899,900
شيشه02ن,گواهي شيشه فلوت6بيرنگBكاوه,3,3564,4725557496,1325914,1325914,1325914,0,0,1325914,0,0,1325914,1325914
سكه0111پ05,تمام سكه طرح جديد0111آينده,3,300,619882800,2065175,2066276,2066276,1101,0.05,2066276,1101,0.05,2066276,2066276
طفلا1173,اختيارف فولاد-5000-1401/11/26,2,2,34000,58,33,1,-57,-98.28,17,-41,-70.69,1,33
ضخود0111,اختيارخ خودرو-3500-1402/01/09,2,381,117780000,371,290,380,9,2.43,309,-62,-16.71,290,380
ضملت3024,اختيارخ وبملت-2969-1402/03/28,2,2,884000,472,444,440,-32,-6.78,442,-30,-6.36,440,444
طهاي3009,اختيارف هاي وب-3690-1402/03/03,2,11,8270920,710,630,700,-10,-1.41,694,-16,-2.25,630,700
فولاد2,فولاد مباركه اصفهان,2,186467957,1174748129100,6180,6300,6300,120,1.94,6300,120,1.94,6300,6300
طهرم1205,اختيارف اهرم-11000-1401/12/22,2,190,80000000,488,400,480,-8,-1.64,421,-67,-13.73,400,480
اراد394,مرابحه عام دولت3-ش.خ 0204,2,60000000,57790800000000,978080,963060,963300,-14780,-1.51,963180,-14900,-1.52,963060,963300
اراد594,مرابحه عام دولتي5-ش.خ 0309,2,16000000,14223024000000,1048000,889223,888655,-159345,-15.2,888939,-159061,-15.18,888655,889223
طسپا1204,اختيارف خساپا-1900-1401/12/10,2,3,60000,25,35,32,7,28,20,-5,-20,14,32
كاوه2,فولاد كاوه جنوب كيش,2,10000000,78000000000,7720,7800,7800,80,1.04,7800,80,1.04,7800,7800
ضخود1201,اختيارخ خودرو-1600-1401/12/03,2,79,128772000,1711,1631,1630,-81,-4.73,1630,-81,-4.73,1630,1631
صند4122,صكوك اجاره صند412-بدون ضامن,2,4000000,4022005000000,1000000,1000000,1022005,22005,2.2,1005501,5501,0.55,1000000,1022005
شيشه129ن,گواهي شيشه فلوت8بيرنگBسهند,2,500,786189000,1572378,1572378,1572378,0,0,1572378,0,0,1572378,1572378
ضهرم7002,اختيارخ اهرم-7500-1402/07/23,2,4,34380000,7969,8690,8500,531,6.66,8595,626,7.86,8500,8690
ضهرم1211,اختيارخ اهرم-18000-1401/12/22,2,21,14700000,615,700,700,85,13.82,700,85,13.82,700,700
ضسپا3024,اختيارخ خساپا-2000-1402/03/24,2,5,4530000,843,1090,860,17,2.02,906,63,7.47,860,1090
ضفلا1172,اختيارخ فولاد-4500-1401/11/26,2,17,28250000,2000,1650,1700,-300,-15,1662,-338,-16.9,1650,1700
ضسرو1015,اختيارخ سرو-68000-1402/10/06,2,604,265732800,43962,43824,44820,858,1.95,43995,33,0.08,43824,44820
ضسلا1207,اختيارخ سلام-11000-1401/12/22,2,71,63900000,920,900,900,-20,-2.17,900,-20,-2.17,900,900
نخل4,صندوق س.خليج فارس-د,2,15900000,159302000000,10013,10018,10020,7,0.07,10019,6,0.06,10018,10020
ويستا,صندوق س. ويستا -س,2,105085,1420292410,13386,13515,13700,314,2.35,13516,130,0.97,13515,13700
اراد664,مرابحه عام دولت66-ش.خ0310,2,20000000,17684060000000,1000000,885006,883400,-116600,-11.66,884203,-115797,-11.58,883400,885006
صنم2,ص.س.صندوق در صندوق صنم,2,1000000,1000000,13349,1,1,-13348,-99.99,1,-13348,-99.99,1,1
شيشه109ن,گواهي شيشه فلوت2بيرنگAدماوند,2,5000,4258515000,851703,851703,851703,0,0,851703,0,0,851703,851703
شيشه94ن,گواهي شيشه فلوت5بيرنگBكاويان,2,2480,2468961520,995549,995549,995549,0,0,995549,0,0,995549,995549
اراد734,مرابحه عام دولت73-ش.خ0402,2,10000000,8688470000000,1025000,869861,867833,-157167,-15.33,868847,-156153,-15.23,867833,869861
افاد734,منفعت دولت7-ش.خاص نوين0204,2,8000000,7759944000000,1050000,969356,970630,-79370,-7.56,969993,-80007,-7.62,969356,970630
ضخاو1205,اختيارخ وخاور-4000-1401/12/01,2,2,700000,800,450,250,-550,-68.75,350,-450,-56.25,250,450
ويستا2,صندوق س. ويستا -س,2,200000,200000,13386,1,1,-13385,-99.99,1,-13385,-99.99,1,1
اراد974,مرابحه عام دولت97-ش.خ050723,2,49881000,40568342002500,985470,815605,811000,-174470,-17.7,813302,-172168,-17.47,811000,815605
ضهاي3007,اختيارخ هاي وب-3229-1402/03/03,2,30,10699080,329,329,329,0,0,329,0,0,329,329
سي تيپ2ن41,گواهي سيمان تيپ2بوكان(ن),2,20000,132260000,6613,6613,6613,0,0,6613,0,0,6613,6613
سپر4,صندوق س سپر سرمايه بيدار- ثابت,2,57196000,949029044000,16611,16589,16655,44,0.26,16593,-18,-0.11,16589,16655
اوصتا2,صندوق انديشه ورزان صباتامين -د,2,15276505,15276505,26156,1,1,-26155,-100,1,-26155,-100,1,1
انار2,صندوق س.انارنماد ارزش-درسهام,2,1000000,1000000,13370,1,1,-13369,-99.99,1,-13369,-99.99,1,1
سپر2,صندوق س سپر سرمايه بيدار- ثابت,2,57000000,57000000,16611,1,1,-16610,-99.99,1,-16610,-99.99,1,1
اراد884,مرابحه عام دولت88-ش.خ041120,2,56600000,47284319200000,1000000,837474,833350,-166650,-16.67,835412,-164588,-16.46,833350,837474
اراد434,مرابحه عام دولت4-ش.خ 0205,2,10236000,9829461906000,988810,960167,960400,-28410,-2.87,960283,-28527,-2.88,960167,960400
اخزا9074,اسنادخزانه-م7بودجه99-020704,2,2799926,2365427883468,849000,844126,845510,-3490,-0.41,844818,-4182,-0.49,844126,845510
اراد894,مرابحه عام دولت89-ش.خ041120,2,11398000,9526106460000,1038800,837840,833700,-205100,-19.74,835770,-203030,-19.54,833700,837840
اراد654,مرابحه عام دولتي65-ش.خ0210,2,46000000,42891481000000,959070,932447,932400,-26670,-2.78,932423,-26647,-2.78,932400,932447
ثبات4,صندوق س. ثبات ويستا -د,2,134590000,1800171160000,13368,13376,13374,6,0.04,13375,7,0.05,13374,13376
اراد674,مرابحه عام دولت67-ش.خ0310,2,8240000,7284699720000,1007000,884971,883160,-123840,-12.3,884065,-122935,-12.21,883160,884971
اراد504,مرابحه عام دولت5-ش.خ0302,2,6000000,5527254000000,1000000,921341,921077,-78923,-7.89,921209,-78791,-7.88,921077,921341
اراد624,مرابحه عام دولت62-ش.خ0309,2,14992000,13306044656000,900000,887838,887248,-12752,-1.42,887543,-12457,-1.38,887248,887838
اخزا905,اسنادخزانه-م5بودجه99-020218,2,300,280600000,932200,933000,940000,7800,0.84,935330,3130,0.34,933000,940000
اخزا0114,اسناد خزانه-م11بودجه00-030619,2,99979700,67351224925300,631890,672548,674750,42860,6.78,673649,41759,6.61,672548,674750
شيشه141ن,گواهي شيشه فلوت3بيرنگBكاوه,2,2660,1870751400,703290,703290,703290,0,0,703290,0,0,703290,703290
تملي804,تسهيلات مسكن ب. ملي-تير98,2,16,10925104,650304,682819,682819,32515,5,682819,32515,5,682819,682819
اراد404,مرابحه عام دولت4-ش.خ 0207,2,53234600,50276965475900,938000,942783,946100,8100,0.86,944441,6441,0.69,942783,946100
صبا51,اجاره صبا تامين دماوند14050809,2,110000,110000000000,1000000,1000000,1000000,0,0,1000000,0,0,1000000,1000000
مشير304,مشاركت ش شيراز304-3ماهه18%,2,6000,5685500000,935000,943000,948500,13500,1.44,947583,12583,1.35,943000,948500
اراد564,مرابحه عام دولت5-ش.خ 0308,2,2000000,1818216000000,1024960,909316,908900,-116060,-11.32,909108,-115852,-11.3,908900,909316
تملي709,تسهيلات مسكن ب. ملي-آذر97,2,72,44525088,650951,618404,618404,-32547,-5,618404,-32547,-5,618404,618404
اخزا9164,اسنادخزانه-م16بودجه99-020528,2,72986000,63530262277000,856600,870959,869930,13330,1.56,870444,13844,1.62,869930,870959
ضپلا1209,اختيارخ پالايش-110000-01/12/16,2,200,29000000,16000,15000,14000,-2000,-12.5,14500,-1500,-9.38,14000,15000
ضترا1146,اختيارخ شتران-4018-1401/11/19,2,103,74994300,443,450,450,7,1.58,450,7,1.58,450,450
اراد994,مرابحه عام دولت99-ش.خ050723,2,13000000,10574109000000,1000000,815736,811050,-188950,-18.9,813393,-186607,-18.66,811050,815736
اراد694,مرابحه عام دولت69-ش.خ0310,2,2502000,2204538471000,908600,884421,877800,-30800,-3.39,881110,-27490,-3.03,877800,884421
اراد1164,مرابحه عام دولت116-ش.خ060630	,2,4000000,3150602000000,940000,790301,785000,-155000,-16.49,787650,-152350,-16.21,785000,790301
ضخود0113,اختيارخ خودرو-4000-1402/01/09,2,2,226000,245,166,60,-185,-75.51,113,-132,-53.88,60,166
ضستا6009,اختيارخ شستا-1365-1402/06/08,2,1259,189109000,141,151,150,9,6.38,150,9,6.38,150,151
اراد114,مرابحه عام دولت1-ش.خ لوتوس0206,2,21800000,20848571700000,990570,956763,955950,-34620,-3.49,956356,-34214,-3.45,955950,956763
اراد984,مرابحه عام دولت98-ش.خ050723,2,24000000,19520100000000,1010000,815680,810995,-199005,-19.7,813337,-196663,-19.47,810995,815680
زيتون2,صندوق س زيتون نماد پايا- مختلط,2,200000,200000,14350,1,1,-14349,-99.99,1,-14349,-99.99,1,1
فيروزا2,صندوق ارمغان فيروزه آسيا-ثابت,2,63170000,63170000,32386,1,1,-32385,-100,1,-32385,-100,1,1
اخزا0102,اسناد خزانه-م10بودجه00-031115,2,121,71648810,608990,579770,595360,-13630,-2.24,592140,-16850,-2.77,579770,595360
نهال2,صندوق س. طلاي سرخ نوويرا,2,2000000,2000000,14889,1,1,-14888,-99.99,1,-14888,-99.99,1,1
پتروما,صندوق س.بخشي پتروشيمي دماوند-ب,2,10000,113930000,11467,11393,11393,-74,-0.65,11393,-74,-0.65,11393,11393
ضسلا1205,اختيارخ سلام-9000-1401/12/22,2,40,99200000,2600,2480,2480,-120,-4.62,2480,-120,-4.62,2480,2480
طشنا1107,اختيارف شپنا-7500-1401/11/19,2,12,3000000,569,250,250,-319,-56.06,250,-319,-56.06,250,250
ضفلا1168,اختيارخ فولاد-3250-1401/11/26,2,69,186300000,3200,2700,2700,-500,-15.63,2700,-500,-15.63,2700,2700
ضملت1147,اختيارخ وبملت-3250-1401/11/24,2,15,4950000,700,330,330,-370,-52.86,330,-370,-52.86,330,330
ومهان2,گروه توسعه مالي مهر آيندگان,2,24366818,137916189880,5620,5660,5660,40,0.71,5660,40,0.71,5660,5660
ضصاد1125,اختيارخ وبصادر-1500-1401/11/19,2,65,25250000,399,400,350,-49,-12.28,388,-11,-2.76,350,400
اراد124,مرابحه عام دولت1-ش.خ ملت0206,2,19998000,19140285780000,1000000,958270,955950,-44050,-4.41,957110,-42890,-4.29,955950,958270
اگ020719,گام بانك صادرات ايران0207,2,149,121439307,814955,815100,815001,46,0.01,815029,74,0.01,815001,815100
ضشنا1104,اختيارخ شپنا-6000-1401/11/19,2,400,660000000,1665,1650,1650,-15,-0.9,1650,-15,-0.9,1650,1650
شراز2,پالايش نفت شيراز,2,6000000,89700000000,15010,14950,14950,-60,-0.4,14950,-60,-0.4,14950,14950
ضفلا1174,اختيارخ فولاد-5500-1401/11/26,2,46,32200000,756,700,700,-56,-7.41,700,-56,-7.41,700,700
ضدي205,اختيارخ دي-700-14020217,2,75,16500000,200,220,220,20,10,220,20,10,220,220
ضهرم1202,اختيارخ اهرم-8000-1401/12/22,2,7,48170000,2645,6990,6800,4155,157.09,6881,4236,160.15,6800,6990
سي تيپ2ن25,گواهي سيمان تيپ2نهاوند(ن),2,95000,577220000,6076,6076,6076,0,0,6076,0,0,6076,6076
شيشه106ن,گواهي شيشه فلوت8بيرنگBدماوند,2,1500,2723506500,1815671,1815671,1815671,0,0,1815671,0,0,1815671,1815671
ضستر1110,اختيارخ خگستر-4000-1401/11/26,2,15,7530000,770,502,502,-268,-34.81,502,-268,-34.81,502,502
ضخاور111,اختيارخ خاور-3700-14020116,2,200,112000000,1,560,560,559,55900,560,559,55900,560,560
سي تيپ2ن33,گواهي سيمان تيپ2ساروج بوشهر(ن),2,55000,553410000,9962,10062,10062,100,1,10062,100,1,10062,10062
ضملت1141,اختيارخ وبملت-2000-1401/11/24,2,34,51000000,1599,1500,1500,-99,-6.19,1500,-99,-6.19,1500,1500
شيشه87ن,گواهي شيشه فلوت10بيرنگBكاوه,2,1600,3956382400,2472739,2472739,2472739,0,0,2472739,0,0,2472739,2472739
سي تيپ2ن03,گواهي سيمان تيپ2اروميه(ن),2,35000,215215000,6149,6149,6149,0,0,6149,0,0,6149,6149
شيشه11ن,گواهي شيشه شيت3بيرنگAساوه,2,1995,1191527715,597257,597257,597257,0,0,597257,0,0,597257,597257
سي تيپ2ن05,گواهي سيمان تيپ 2خاش(ن),2,125000,1012000000,7766,8096,8096,330,4.25,8096,330,4.25,8096,8096
ضخود1110,اختيارخ خودرو-2800-1401/11/12,2,430,197800000,207,460,460,253,122.22,460,253,122.22,460,460
اراد834,مرابحه عام دولت83-ش.خ041220,2,30000000,24983895000000,1000000,834903,830690,-169310,-16.93,832796,-167204,-16.72,830690,834903
سي تيپ2ن29,گواهي سيمان تيپ2فيروزكوه(ن),2,60000,412080000,6188,6868,6868,680,10.99,6868,680,10.99,6868,6868
اراد724,مرابحه عام دولت72-ش.خ0311,2,6942800,6122931690800,973000,882832,880990,-92010,-9.46,881911,-91089,-9.36,880990,882832
شغدير2,پتروشيمي غدير,1,1050000,74550000000,69530,71000,71000,1470,2.11,71000,1470,2.11,71000,71000
اخزا904,اسنادخزانه-م4بودجه99-011215,1,41100,39994410000,972510,973100,973100,590,0.06,973100,590,0.06,973100,973100
سي تيپ2ن38,گواهي سيمان تيپ2مازندران(ن),1,16000,121728000,7608,7608,7608,0,0,7608,0,0,7608,7608
سي تيپ2ن21,گواهي سيمان تيپ2زاوه تربت(ن),1,25000,146425000,5857,5857,5857,0,0,5857,0,0,5857,5857
ضبدر1174,اختيارخ شبندر-7000-1401/11/24,1,10,22000000,2900,2200,2200,-700,-24.14,2200,-700,-24.14,2200,2200
وغدير2,سرمايه‌گذاري‌غدير(هلدينگ‌,1,20000000,372800000000,18630,18640,18640,10,0.05,18640,10,0.05,18640,18640
اخزا9082,اسنادخزانه-م8بودجه99-020606,1,91,74828390,865560,822290,822290,-43270,-5,822290,-43270,-5,822290,822290
وسكاب4,س.ص.بازنشستگي كاركنان بانكها,1,68193523,213241146421,3126,3127,3127,1,0.03,3127,1,0.03,3127,3127
اخزا1024,اسناد خزانه-م2بودجه01-020920,1,74999990,37398745013500,530000,498650,498650,-31350,-5.92,498650,-31350,-5.92,498650,498650
شبصير2,توليدات پتروشيمي قائد بصير,1,1000000,122700000000,120800,122700,122700,1900,1.57,122700,1900,1.57,122700,122700
اخزا0082,اسنادخزانه-م8بودجه00-030919,1,27,17010270,633000,630010,630010,-2990,-0.47,630010,-2990,-0.47,630010,630010
اراد64,مرابحه عام دولتي64-ش.خ0111,1,135000,134821800000,995860,998680,998680,2820,0.28,998680,2820,0.28,998680,998680
اگ020418,گام بانك تجارت0204,1,3000,2628000000,892850,876000,876000,-16850,-1.89,876000,-16850,-1.89,876000,876000
متا0203,آتي متانول-1402/03/17,1,100,90980000,909500,909800,909800,300,0.03,909800,300,0.03,909800,909800
ضفلا7026,اختيارخ فولاد-3144-1402/07/26,1,1000,2600000000,2500,2600,2600,100,4,2600,100,4,2600,2600
شيشه32ن,گواهي شيشه فلوت5بيرنگAآذر,1,800,773000800,966251,966251,966251,0,0,966251,0,0,966251,966251
سمتا023,سلف موازي استاندارد سمتا023,1,100,104720300,1046716,1047203,1047203,487,0.05,1047203,487,0.05,1047203,1047203
ضبدر1179,اختيارخ شبندر-11000-1401/11/24,1,4,440000,350,110,110,-240,-68.57,110,-240,-68.57,110,110
ضهرم7009,اختيارخ اهرم-14000-1402/07/23,1,250,1562500000,6100,6250,6250,150,2.46,6250,150,2.46,6250,6250
ضستا0103,اختيارخ شستا-900-1402/01/09,1,1,270000,265,270,270,5,1.89,270,5,1.89,270,270
غمينو4,شركت صنايع غذايي مينو شرق,1,15000000,123900000000,8390,8260,8260,-130,-1.55,8260,-130,-1.55,8260,8260
ضهرم1200,اختيارخ اهرم-7000-1401/12/22,1,10,80000000,8000,8000,8000,0,0,8000,0,0,8000,8000
صايپا1122,صكوك مرابحه سايپا112-3ماهه 16%,1,1720000,1720000000000,1000290,1000000,1000000,-290,-0.03,1000000,-290,-0.03,1000000,1000000
ضصاد3021,اختيارخ وبصادر-1500-1402/03/17,1,50,40000000,800,800,800,0,0,800,0,0,800,800
ضهرم1210,اختيارخ اهرم-16000-1401/12/22,1,30,30000000,260,1000,1000,740,284.62,1000,740,284.62,1000,1000
ضخاو1201,اختيارخ وخاور-3000-1401/12/01,1,9,11547000,1573,1283,1283,-290,-18.44,1283,-290,-18.44,1283,1283
طدي200,اختيارف دي-450-14020217,1,4,80000,64,20,20,-44,-68.75,20,-44,-68.75,20,20
ضهرم7007,اختيارخ اهرم-12000-1402/07/23,1,2,9000000,8000,4500,4500,-3500,-43.75,4500,-3500,-43.75,4500,4500
ضملت1150,اختيارخ وبملت-4000-1401/11/24,1,15,1200000,95,80,80,-15,-15.79,80,-15,-15.79,80,80
ضصاد3025,اختيارخ وبصادر-1900-1402/03/17,1,5,1775000,350,355,355,5,1.43,355,5,1.43,355,355
طسپا1208,اختيارف خساپا-2600-1401/12/10,1,10,2500000,100,250,250,150,150,250,150,150,250,250
شيشه110ن,گواهي شيشه فلوت2بيرنگBدماوند,1,2600,1896187800,802233,729303,729303,-72930,-9.09,729303,-72930,-9.09,729303,729303
گام020556,گواهي اعتبار مولد سامان0205,1,5000,4425000000,870000,885000,885000,15000,1.72,885000,15000,1.72,885000,885000
هم وزن2,صندوق س. شاخصي كيان-س,1,1000000,1000000,12255,1,1,-12254,-99.99,1,-12254,-99.99,1,1
وسپه2,سرمايه‌گذاري‌ سپه‌,1,100000000,484500000000,4845,4845,4845,0,0,4845,0,0,4845,4845
وسرمد2,بيمه  سرمد,1,67600000,114176400000,1730,1689,1689,-41,-2.37,1689,-41,-2.37,1689,1689
پالايش2,صندوق پالايشي يكم-سهام,1,9600000,9600000,119180,1,1,-119179,-100,1,-119179,-100,1,1
پادا2,صندوق س.پاداش سرمايه پارس-س,1,20000,20000,131252,1,1,-131251,-100,1,-131251,-100,1,1
ضكاريس207,اختيارخ كاريس-18000-14020205,1,1000,1534000000,1369,1534,1534,165,12.05,1534,165,12.05,1534,1534
اخزا9034,اسنادخزانه-م3بودجه99-011110,1,583592,578940188168,993150,992029,992029,-1121,-0.11,992029,-1121,-0.11,992029,992029
سمتا021,سلف موازي استاندارد سمتا021,1,100,104084000,1040356,1040840,1040840,484,0.05,1040840,484,0.05,1040840,1040840
سي تيپ2ن15,گواهي سيمان تيپ2قاين(ن),1,25000,153725000,6149,6149,6149,0,0,6149,0,0,6149,6149
سمتا024,سلف موازي متانول بوشهر 024,1,100,102150600,1021031,1021506,1021506,475,0.05,1021506,475,0.05,1021506,1021506
شبهرن2,نفت‌ بهران‌,1,10000000,199300000000,19930,19930,19930,0,0,19930,0,0,19930,19930
سمتا025,سلف موازي متانول بوشهر 025,1,100,116159900,1161059,1161599,1161599,540,0.05,1161599,540,0.05,1161599,1161599
افران4,صندوق س افرا نماد پايدار-ثابت,1,37000000,701335000000,18942,18955,18955,13,0.07,18955,13,0.07,18955,18955
كارا4,صندوق س. كارا -د,1,75858000,1000036014000,13175,13183,13183,8,0.06,13183,8,0.06,13183,13183
ارزش4,صندوق س ارزش آفرين بيدار-سهام,1,4000000,55600000000,13890,13900,13900,10,0.07,13900,10,0.07,13900,13900
امين يكم4,صندوق درآمد ثابت امين يكم فردا,1,100000000,988500000000,9798,9885,9885,87,0.89,9885,87,0.89,9885,9885
شبندر2,پالايش نفت بندرعباس,1,31502702,292975128600,9390,9300,9300,-90,-0.96,9300,-90,-0.96,9300,9300
سنفت021,سلف موازي نفت.س صادر اروند 021,1,100,237444600,2373342,2374446,2374446,1104,0.05,2374446,1104,0.05,2374446,2374446
اخزا9054,اسنادخزانه-م5بودجه99-020218,1,1450000,1347195000000,932200,929100,929100,-3100,-0.33,929100,-3100,-0.33,929100,929100
اخزا9094,اسنادخزانه-م9بودجه99-020316,1,659600,601209569600,914180,911476,911476,-2704,-0.3,911476,-2704,-0.3,911476,911476
اخزا9142,اسنادخزانه-م14بودجه99-021025,1,68,53720000,788990,790000,790000,1010,0.13,790000,1010,0.13,790000,790000
وبملت2,بانك ملت,1,27000000,97038000000,3594,3594,3594,0,0,3594,0,0,3594,3594
اخزا9092,اسنادخزانه-م9بودجه99-020316,1,71,64894000,914180,914000,914000,-180,-0.02,914000,-180,-0.02,914000,914000
مرواريد2,صندوق س. مرواريد بها بازار-س,1,300000,300000,11232,1,1,-11231,-99.99,1,-11231,-99.99,1,1
خراسان2,پتروشيمي خراسان,1,856000,99450080000,116180,116180,116180,0,0,116180,0,0,116180,116180
وبشهر2,توسعه‌ صنايع‌ بهشهر(هلدينگ,1,8266336,60261589440,7340,7290,7290,-50,-0.68,7290,-50,-0.68,7290,7290
والبر2,سرمايه‌ گذاري‌ البرز(هلدينگ‌,1,112000000,700000000000,6250,6250,6250,0,0,6250,0,0,6250,6250
اراد714,مرابحه عام دولت71-ش.خ0311,1,700000,617085000000,1000000,881550,881550,-118450,-11.85,881550,-118450,-11.85,881550,881550
زملارد2,كشاورزي و دامپروري ملارد شير,1,6000000,77400000000,13190,12900,12900,-290,-2.2,12900,-290,-2.2,12900,12900
اخزا9062,اسنادخزانه-م6بودجه99-020321,1,8,6936560,912700,867070,867070,-45630,-5,867070,-45630,-5,867070,867070
بوعلي2,پتروشيمي بوعلي سينا,1,1500000,53790000000,34520,35860,35860,1340,3.88,35860,1340,3.88,35860,35860
ضحفا1208,اختيارخ حفارس-16000-1401/12/24,1,1,1800000,1300,1800,1800,500,38.46,1800,500,38.46,1800,1800
ضفلا7020,اختيارخ فولاد-1653-1402/07/26,1,70,280000000,4871,4000,4000,-871,-17.88,4000,-871,-17.88,4000,4000
تملي801,تسهيلات مسكن ب. ملي-فروردين98,1,19,11311878,595362,595362,595362,0,0,595362,0,0,595362,595362
فملي2,ملي‌ صنايع‌ مس‌ ايران‌,1,110344067,871718129300,7700,7900,7900,200,2.6,7900,200,2.6,7900,7900
سمتا022,سلف موازي استاندارد سمتا022,1,100,104321700,1042732,1043217,1043217,485,0.05,1043217,485,0.05,1043217,1043217
غگز,گز سكه,1,2321,5052817,2074,2177,2177,103,4.97,2177,103,4.97,2177,2177
تملي807,تسهيلات مسكن ب. ملي-مهر98,1,3,1920000,639667,640000,640000,333,0.05,640000,333,0.05,640000,640000
ضهرم7004,اختيارخ اهرم-9000-1402/07/23,1,3,25500000,8500,8500,8500,0,0,8500,0,0,8500,8500
كي بي سي2,شركت كي بي سي,1,1550000,20615000000,12840,13300,13300,460,3.58,13300,460,3.58,13300,13300
جم2,پتروشيمي جم,1,3047141,114176373270,37460,37470,37470,10,0.03,37470,10,0.03,37470,37470
صنفت03122,صكوك منفعت نفت0312-6ماهه 18/5%,1,1000000,1000000000000,1000000,1000000,1000000,0,0,1000000,0,0,1000000,1000000
سپنتا031,سلف موازي پنتان پتروكنگان031,1,100,198478800,1983736,1984788,1984788,1052,0.05,1984788,1052,0.05,1984788,1984788
غدانه4,پنبه و دانه هاي روغني خراسان,1,54000000,805140000000,1000,14910,14910,13910,1391,14910,13910,1391,14910,14910
اراد100,مرابحه عام دولت100-ش.خ021127,1,80000,76911200000,970000,961390,961390,-8610,-0.89,961390,-8610,-0.89,961390,961390
كرماشا2,صنايع پتروشيمي كرمانشاه,1,3000000,195420000000,65140,65140,65140,0,0,65140,0,0,65140,65140
كچاد2,معدني‌وصنعتي‌چادرملو,1,11663465,138095425600,11830,11840,11840,10,0.08,11840,10,0.08,11840,11840
عميلگرد2,سلف ميلگرد آتيه خاورميانه2,1,3,5761629,1881958,1920543,1920543,38585,2.05,1920543,38585,2.05,1920543,1920543
اراد502,مرابحه عام دولت5-ش.خ0302,1,2000,2000000000,1000000,1000000,1000000,0,0,1000000,0,0,1000000,1000000
اخزا8202,اسنادخزانه-م20بودجه98-020806,1,95,74986350,830870,789330,789330,-41540,-5,789330,-41540,-5,789330,789330
افاد814,منفعت دولت8-ش.خاص مهر0205,1,13500000,13025070000000,1000000,964820,964820,-35180,-3.52,964820,-35180,-3.52,964820,964820
صباايده01,مرابحه ايده پردازصبادانا050929,1,5000,4286900000,902500,857380,857380,-45120,-5,857380,-45120,-5,857380,857380
شيشه98ن,گواهي شيشه فلوت3بيرنگBدماوند,1,1995,1403063550,703290,703290,703290,0,0,703290,0,0,703290,703290
اخزا914,اسنادخزانه-م14بودجه99-021025,1,100,79999000,788990,799990,799990,11000,1.39,799990,11000,1.39,799990,799990
شيشه128ن,گواهي شيشه فلوت8بيرنگAسهند,1,500,854988500,1709977,1709977,1709977,0,0,1709977,0,0,1709977,1709977
شيشه10ن,گواهي شيشه شيت2بيرنگAساوه,1,1000,591285000,591285,591285,591285,0,0,591285,0,0,591285,591285
سي تيپ2ن23,گواهي سيمان تيپ2فراز(ن),1,17000,109990000,6188,6470,6470,282,4.56,6470,282,4.56,6470,6470
طشنا1105,اختيارف شپنا-6500-1401/11/19,1,10,1200000,22,120,120,98,445.45,120,98,445.45,120,120
ضهرم7005,اختيارخ اهرم-10000-1402/07/23,1,15,127500000,6502,8500,8500,1998,30.73,8500,1998,30.73,8500,8500
ضسرو1014,اختيارخ سرو-62000-1402/10/06,1,500,241760000,47100,48352,48352,1252,2.66,48352,1252,2.66,48352,48352
جستا0000,آتي شستا-1401/11/12,1,1,1112000,1096,1112,1112,16,1.46,1112,16,1.46,1112,1112
اراد115,مرابحه عام دولت115-ش.خ060630,1,10000,10000000000,1000000,1000000,1000000,0,0,1000000,0,0,1000000,1000000
وسين2,بيمه سينا,1,35000000,75250000000,2109,2150,2150,41,1.94,2150,41,1.94,2150,2150
صگل05092,صكوك اجاره كگل0509-بدون ضامن	,1,300000,300000000000,1000000,1000000,1000000,0,0,1000000,0,0,1000000,1000000
اخزا9114,اسنادخزانه-م11بودجه99-020906,1,647000,527262945000,815080,814935,814935,-145,-0.02,814935,-145,-0.02,814935,814935
طشنا1106,اختيارف شپنا-7000-1401/11/19,1,20,1980000,90,99,99,9,10,99,9,10,99,99
ضبساما306,اختيارخ بساما-13000-14020310,1,1,850000,600,850,850,250,41.67,850,250,41.67,850,850
نسب0203,آتي نفتاي سبك-1402/03/17,1,100,173080000,1730500,1730800,1730800,300,0.02,1730800,300,0.02,1730800,1730800
تكالا,توليدكنندگان بورس كالاي ايران,1,38,763420,20090,20090,20090,0,0,20090,0,0,20090,20090
ضصاد1127,اختيارخ وبصادر-1700-1401/11/19,1,15,3300000,205,220,220,15,7.32,220,15,7.32,220,220
ضترا1147,اختيارخ شتران-4327-1401/11/19,1,1,404500,200,250,250,50,25,250,50,25,250,250
ضهرم7001,اختيارخ اهرم-7000-1402/07/23,1,1,8000000,9500,8000,8000,-1500,-15.79,8000,-1500,-15.79,8000,8000
ضملي7020,اختيارخ فملي-1853-1402/07/05,1,10,50000000,5400,5000,5000,-400,-7.41,5000,-400,-7.41,5000,5000
ضخود2035,اختيارخ خودرو-3750-1402/02/13,1,1,100000,450,100,100,-350,-77.78,100,-350,-77.78,100,100
طشنا1104,اختيارف شپنا-6000-1401/11/19,1,20,600000,100,30,30,-70,-70,30,-70,-70,30,30
ضدي210,اختيارخ دي-950-14020217,1,2,300000,150,150,150,0,0,150,0,0,150,150
شيشه130ن,گواهي شيشه فلوت10بيرنگAسهند,1,880,2353219440,2674113,2674113,2674113,0,0,2674113,0,0,2674113,2674113
گام020756,گواهي اعتبار مولد سامان0207,1,5000,4125000000,817220,825000,825000,7780,0.95,825000,7780,0.95,825000,825000
سمتا031,سلف موازي متانول مرجان 031,1,100,96654400,966117,966544,966544,427,0.04,966544,427,0.04,966544,966544
نسب0201,آتي نفتاي سبك-1402/01/17,1,100,174090000,1740500,1740900,1740900,400,0.02,1740900,400,0.02,1740900,1740900
ضسلا7004,اختيارخ سلام-10000-1402/07/19,1,91,318500000,3424,3500,3500,76,2.22,3500,76,2.22,3500,3500
متا0201,آتي متانول-1402/01/17,1,100,90930000,909100,909300,909300,200,0.02,909300,200,0.02,909300,909300
سمتا011,سلف موازي استاندارد سمتا011,1,10,99268700,9923151,9926870,9926870,3719,0.04,9926870,3719,0.04,9926870,9926870
صمعاد407,صكوك اجاره معادن407-3ماهه18%,1,49,49245000,1000000,1005000,1005000,5000,0.5,1005000,5000,0.5,1005000,1005000
صگل059,صكوك اجاره كگل059-بدون ضامن	,1,5,5050000,1000000,1010000,1010000,10000,1,1010000,10000,1,1010000,1010000
