نماد,نام,تعداد,حجم,ارزش,دیروز,اولین,آخرین معامله - مقدار,آخرین معامله - تغییر,آخرین معامله - درصد,قیمت پایانی - مقدار,قیمت پایانی - تغییر,قیمت پایانی - درصد,کمترین,بیشترین
فروژ,صنايع فروآلياژ ايران,172102,30257634,1576386894250,51950,53250,51750,-200,-0.38,52100,150,0.29,50550,53300
گدنا,تهيه توزيع غذاي دنا آفرين فدك,26559,186802861,2241792855660,12490,12870,11690,-800,-6.41,12000,-490,-3.92,11620,13000
خودرو,ايران‌ خودرو,17441,583407169,1829098296673,3137,3171,3170,33,1.05,3135,-2,-0.06,3064,3190
دي,بانك دي,15259,681068992,576127858176,870,862,855,-15,-1.72,846,-24,-2.76,828,868
كرمان,س. توسعه و عمران استان كرمان,13773,690551637,828337880097,1156,1165,1236,80,6.92,1200,44,3.81,1114,1236
اردستان,سيمان اردستان,13732,4475368,52317051920,11140,11690,11690,550,4.94,11690,550,4.94,11690,11690
خگستر,گسترش‌سرمايه‌گذاري‌ايران‌خودرو,13498,304816434,1288088786304,4226,4250,4270,44,1.04,4226,0,0,4120,4323
پالايش,صندوق پالايشي يكم-سهام,12892,13821930,1618539434060,118680,119000,116440,-2240,-1.89,117100,-1580,-1.33,116180,119190
خساپا,سايپا,11856,470445698,1182481826110,2478,2511,2545,67,2.7,2514,36,1.45,2460,2559
شستا,سرمايه گذاري تامين اجتماعي,11695,490470234,499611546278,1036,1038,1020,-16,-1.54,1019,-17,-1.64,1013,1038
شتران,پالايش نفت تهران,10487,218372827,921078459256,4329,4289,4211,-118,-2.73,4218,-111,-2.56,4190,4310
دارا يكم,صندوق واسطه گري مالي يكم-سهام,9962,10639828,1241255527170,119660,117600,116090,-3570,-2.98,116660,-3000,-2.51,115200,118280
گشان,توسعه بين المللي پديده شانديز,9151,30672900,1458140461850,46500,47850,47850,1350,2.9,47550,1050,2.26,45400,47850
طلا,صندوق س.پشتوانه طلاي لوتوس,8170,8678753,1309007552964,159544,155860,149799,-9745,-6.11,150829,-8715,-5.46,148298,155860
خاور,ايران خودرو ديزل,8120,290286233,1046756461705,3700,3700,3591,-109,-2.95,3606,-94,-2.54,3589,3705
وتجارت,بانك تجارت,8102,296918899,519196624351,1799,1795,1748,-51,-2.83,1749,-50,-2.78,1720,1799
شبندر,پالايش نفت بندرعباس,8017,70530881,645485964170,9330,9210,9120,-210,-2.25,9150,-180,-1.93,9110,9330
وبملت,بانك ملت,7832,262599218,907584570262,3560,3545,3440,-120,-3.37,3456,-104,-2.92,3409,3545
شپنا,پالايش نفت اصفهان,7678,109693900,826173132460,7670,7600,7540,-130,-1.69,7530,-140,-1.83,7480,7680
دانا,بيمه دانا,7180,219880091,708517619019,3067,3061,3281,214,6.98,3222,155,5.05,3000,3281
عيار,صندوق طلاي عيار مفيد,7132,11110643,667916656605,65023,61200,59500,-5523,-8.49,60115,-4908,-7.55,58600,62500
تسه1401,امتيازتسهيلات مسكن سال1401,6850,236116,289911570057,1219097,1210000,1230036,10939,0.9,1227835,8738,0.72,1210000,1235000
اهرم,صندوق س سهامي كاريزما- اهرمي,6421,86509360,1218609045510,14480,14400,14000,-480,-3.31,14090,-390,-2.69,13810,14440
افران,صندوق س افرا نماد پايدار-ثابت,6090,152464738,2892199496809,18956,18970,18970,14,0.07,18970,14,0.07,18969,18970
غزر,صنعتي زر ماكارون,5525,52847224,216428483070,4243,4250,4089,-154,-3.63,4095,-148,-3.49,4035,4250
هماي,صندوق س هماي آگاه-ثابت,5509,143505578,1438614237637,10019,10025,10026,7,0.07,10025,6,0.06,10024,10026
كمند,صندوق س. با درآمد ثابت كمند,5246,237169365,2399731062855,10112,10118,10119,7,0.07,10118,6,0.06,10118,10119
فزر,پويا زركان آق دره,5090,16967064,558097894750,34550,34550,32450,-2100,-6.08,32900,-1650,-4.78,32200,34550
فولاد,فولاد مباركه اصفهان,5084,73351074,455517365500,6230,6220,6210,-20,-0.32,6210,-20,-0.32,6140,6270
كالا,بورس كالاي ايران,4866,21808827,435855889880,19930,20000,20000,70,0.35,19990,60,0.3,19650,20360
وپاسار,بانك  پاسارگاد,4836,59803869,314388043880,5400,5310,5320,-80,-1.48,5260,-140,-2.59,5160,5380
بوعلي,پتروشيمي بوعلي سينا,4776,7784538,289789050760,36030,37650,37110,1080,3,37230,1200,3.33,36310,37650
ثاميد,توسعه و عمران اميد,4212,31275626,59793126537,1886,1905,1916,30,1.59,1912,26,1.38,1888,1931
حفارس,حمل و نقل بين المللي خليج فارس,4202,58766689,879325530530,15710,15110,14950,-760,-4.84,14960,-750,-4.77,14930,15610
فملي,ملي‌ صنايع‌ مس‌ ايران‌,4171,51046290,397039594600,7810,7830,7740,-70,-0.9,7780,-30,-0.38,7730,7830
غنوش,نوش‌ مازندران‌,4123,24610072,238785380830,9600,9560,9790,190,1.98,9700,100,1.04,9260,9900
ماديرا,صنايع ماديران,4102,136629260,524582779083,4001,3880,3913,-88,-2.2,3839,-162,-4.05,3801,4074
تليسه,دامداري تليسه نمونه,4083,50184543,209478134495,4096,4130,4212,116,2.83,4174,78,1.9,4022,4260
وساپا,سرمايه‌گذاري‌ سايپا,3925,74505942,448207845440,5860,5950,6100,240,4.1,6020,160,2.73,5870,6150
خبهمن,گروه‌بهمن‌,3874,158999771,356367884479,2240,2230,2263,23,1.03,2241,1,0.04,2195,2300
كوير,توليدي فولاد سپيد فراب كوير,3860,83685466,277565282919,3434,3390,3299,-135,-3.93,3317,-117,-3.41,3263,3449
هاي وب,داده گسترعصرنوين-هاي وب,3736,82092055,222180654175,2707,2699,2685,-22,-0.81,2706,-1,-0.04,2656,2764
قچار,فراوردههاي غذايي وقند چهارمحال,3733,23234662,262825321590,11340,11280,11530,190,1.68,11310,-30,-0.26,10910,11650
اسياتك,انتقال داده هاي آسياتك,3685,8410371,137677361680,16600,16330,16180,-420,-2.53,16370,-230,-1.39,16170,16720
خنصير,مهندسي‌نصيرماشين‌,3603,16445696,262795078160,16740,16400,16030,-710,-4.24,15980,-760,-4.54,15630,16470
فرابورس,فرابورس ايران,3556,23576036,263295780030,11320,11390,11110,-210,-1.86,11170,-150,-1.33,11000,11470
اعتماد,صندوق س.اعتماد آفرين پارسيان-د,3532,71538707,3664605807645,51188,51225,51226,38,0.07,51225,37,0.07,51225,51227
مديريت,س. و خدمات مديريت صند. ب كشوري,3398,31342641,128272508529,4044,4090,4124,80,1.98,4093,49,1.21,3965,4180
انرژي,بورس انرژي ايران,3382,4876576,198924080130,41220,41520,40670,-550,-1.33,40790,-430,-1.04,39980,42100
ورنا,سرمايه‌گذاري‌ رنا(هلدينگ‌,3373,48598613,349011146250,6980,7100,7250,270,3.87,7180,200,2.87,6970,7360
وسپهر,سرمايه گذاري مالي سپهرصادرات,3350,10661977,91138423880,8870,8730,8400,-470,-5.3,8580,-290,-3.27,8300,8730
خكار,ايركا پارت صنعت,3339,77575602,271788563184,3340,3430,3573,233,6.98,3504,164,4.91,3377,3573
كارا,صندوق س. كارا -د,3339,201516189,2658519972893,13184,13193,13193,9,0.07,13193,9,0.07,13192,13194
بگيلان,توسعه مسير برق گيلان,3328,6119012,95394250540,15590,15800,15340,-250,-1.6,15590,0,0,14920,16200
شپديس,پتروشيمي پرديس,3321,1848345,289293409550,158130,157020,155810,-2320,-1.47,156510,-1620,-1.02,155780,158300
وساخت,سرمايه‌ گذاري‌ ساختمان‌ايران‌,3317,232301966,425394015985,1715,1799,1835,120,7,1831,116,6.76,1765,1835
زبينا,كشاورزي و دامپروري بينالود,3297,69841350,292141970180,3997,3997,4240,243,6.08,4183,186,4.65,3810,4276
فنفت,صنايع تجهيزات نفت,3292,8706349,327787556250,37350,38100,38200,850,2.28,37650,300,0.8,36250,38450
ارزش مسكن,ص.س.املاك ومستغلات ارزش مسكن,3271,1771546,20283472546,11484,11484,11434,-50,-0.44,11450,-34,-0.3,11365,11538
وكبهمن,مديريت سرمايه گذاري كوثربهمن,3250,20114536,70270238130,3585,3575,3446,-139,-3.88,3494,-91,-2.54,3430,3600
فتوسا,توليد و توسعه سرب روي ايرانيان,3224,17105344,137865185550,7930,8230,7990,60,0.76,8060,130,1.64,7560,8270
پترول,گ.س.وت.ص.پتروشيمي خليج فارس,3192,92276342,213966986418,2371,2340,2310,-61,-2.57,2319,-52,-2.19,2300,2388
حكشتي,كشتيراني جمهوري اسلامي ايران,3180,12380327,341184059220,27600,27500,27540,-60,-0.22,27560,-40,-0.14,27100,27900
نوري,پتروشيمي نوري,3160,2855473,290924760520,102970,102970,101800,-1170,-1.14,101880,-1090,-1.06,101520,103000
وآذر,سرمايه‌گذاري‌توسعه‌آذربايجان‌,3148,4469421,583810815150,129120,129900,131000,1880,1.46,130620,1500,1.16,128100,132400
كيان,صندوق س. با درآمد ثابت كيان,3002,33082559,1323732221527,39985,40014,40014,29,0.07,40013,28,0.07,40012,40015
سآبيك,سيمان آبيك,2921,4255012,61482864530,14730,14530,14480,-250,-1.7,14450,-280,-1.9,14230,14660
بورس,بورس اوراق بهادار تهران,2788,29649909,195010053380,6740,6710,6600,-140,-2.08,6580,-160,-2.37,6460,6870
ثمسكن,سرمايه‌گذاري‌ مسكن‌,2778,44531272,219595679149,4711,4950,4872,161,3.42,4931,220,4.67,4800,5029
بالاس,مهندسي ساختمان تاسيسات راه آهن,2734,10352575,342130286250,33250,31600,34000,750,2.26,33050,-200,-0.6,31600,34850
كگل,معدني و صنعتي گل گهر,2719,26364306,227846256020,8670,8680,8670,0,0,8640,-30,-0.35,8440,8790
آگاس,صندوق س.هستي بخش آگاه-س,2684,2401487,240136299910,101235,101443,99730,-1505,-1.49,99995,-1240,-1.22,99202,101443
بركت,گروه دارويي بركت,2653,10928413,137895984890,12940,12940,12610,-330,-2.55,12620,-320,-2.47,12450,12940
سكه مركزي,سلف تمام سكه 001 مركزي,2632,556900,1178618571200,2206382,2189999,2119230,-87152,-3.95,2116392,-89990,-4.08,2096063,2189999
كدما,معدني‌ دماوند,2578,2461220,139176883090,58220,57980,56970,-1250,-2.15,56550,-1670,-2.87,55700,58010
وخارزم,سرمايه گذاري خوارزمي,2547,44766906,200659869678,4484,4500,4509,25,0.56,4482,-2,-0.04,4444,4540
غاذر,كشت‌وصنعت‌پياذر,2539,9390575,485156093930,49340,51500,51800,2460,4.99,51660,2320,4.7,50000,51800
شيراز,پتروشيمي‌شيراز,2539,2985730,262111193680,87340,89040,86850,-490,-0.56,87790,450,0.52,84800,89880
ثاخت,بين‌المللي‌توسعه‌ساختمان,2530,85370546,263266023515,2961,3030,3059,98,3.31,3084,123,4.15,3000,3109
سپيد,سپيد ماكيان,2522,5159771,103381762610,20200,20000,19930,-270,-1.34,20040,-160,-0.79,19800,20500
غديس,پاكديس,2494,11519192,231010712800,20500,20600,20230,-270,-1.32,20050,-450,-2.2,19300,21050
ختوقا,قطعات‌ اتومبيل‌ ايران‌,2492,40897148,188546054410,4700,4660,4710,10,0.21,4610,-90,-1.91,4490,4750
ثبهساز,بهساز كاشانه تهران,2483,21137880,41914339609,1957,1928,1990,33,1.69,1983,26,1.33,1927,2030
مثقال,صندوق س.پشتوانه طلاي زرين آگاه,2482,8807743,162531821329,19776,19100,18287,-1489,-7.53,18453,-1323,-6.69,18061,19100
ددانا,داروسازي دانا,2452,2015920,71659837550,36400,36500,35700,-700,-1.92,35550,-850,-2.34,34950,36500
آبادا,توليد نيروي برق آبادان,2436,4255805,48952316110,11920,11680,11340,-580,-4.87,11500,-420,-3.52,11330,12250
ضسپا1211,اختيارخ خساپا-3250-1401/12/10,2433,861741,47037053000,67,57,58,-9,-13.43,55,-12,-17.91,48,64
كمرجان,بازرگاني و توليدي مرجان كار,2403,11288109,97337011710,8980,8810,8460,-520,-5.79,8620,-360,-4.01,8450,8900
غگل,گلوكوزان‌,2349,23621080,144192068700,6270,6210,6110,-160,-2.55,6100,-170,-2.71,5950,6210
كهمدا,شيشه‌ همدان‌,2317,26292545,328763840220,11970,12450,12250,280,2.34,12500,530,4.43,12200,12780
ولساپا,ليزينگ رايان‌ سايپا,2286,85308166,140740747253,1671,1650,1683,12,0.72,1650,-21,-1.26,1613,1699
ميدكو,توسعه معادن وص.معدني خاورميانه,2266,9973204,116930729260,11900,12000,11620,-280,-2.35,11720,-180,-1.51,11570,12050
ياقوت,صندوق س ياقوت آگاه-ثابت,2245,21164054,357042223638,16861,16864,16870,9,0.05,16870,9,0.05,16862,16871
خصدرا,صنعتي‌ دريايي‌ ايران‌,2234,73455240,166098432543,2301,2314,2270,-31,-1.35,2261,-40,-1.74,2232,2340
سبزوا,سيمان لار سبزوار,2226,23630843,122863629860,5460,5360,5220,-240,-4.4,5200,-260,-4.76,5100,5360
خمهر,مهركام‌پارس‌,2214,57743386,151455410991,2547,2580,2674,127,4.99,2623,76,2.98,2500,2674
ولبهمن,شركت بهمن ليزينگ,2204,25948751,77816039310,3046,3050,3023,-23,-0.76,2999,-47,-1.54,2951,3099
فاذر,صنايع‌ آذرآب‌,2163,144475033,258856362141,1714,1790,1799,85,4.96,1792,78,4.55,1720,1799
شسينا,صنايع‌شيميايي‌سينا,2139,55781574,124545058407,2353,2300,2230,-123,-5.23,2233,-120,-5.1,2189,2378
لطيف,محصولات كاغذي لطيف,2094,1646970,110981776450,63850,67800,68300,4450,6.97,67400,3550,5.56,64100,68300
قثابت,قند ثابت‌ خراسان‌,2091,43928761,112742035737,2657,2660,2585,-72,-2.71,2566,-91,-3.42,2525,2700
سرچشمه,سرمايه گذاري مس سرچشمه,2083,40947743,213005088641,4970,5160,5218,248,4.99,5202,232,4.67,5020,5218
ديران,ايران‌دارو,2078,9406606,140440747040,15330,15350,14890,-440,-2.87,14930,-400,-2.61,14650,15380
زشگزا,شير و گوشت زاگرس شهركرد,2072,17770044,135532318680,7400,7560,7460,60,0.81,7630,230,3.11,7380,7860
توان,صندوق س. اهرمي توان مفيد-س,2064,14101661,171761645207,12306,12242,12185,-121,-0.98,12180,-126,-1.02,12100,12327
شلرد,كود شيميايي اوره لردگان,2063,14309610,129256044280,9090,9010,9010,-80,-0.88,9030,-60,-0.66,8900,9240
چخزر,صنايع چوب خزر كاسپين,2050,1118924,37712913900,34700,34750,33550,-1150,-3.31,33700,-1000,-2.88,32950,34750
سامان,بانك سامان,2047,91716227,245628936357,2754,2683,2678,-76,-2.76,2678,-76,-2.76,2672,2715
كرازي,كارخانجات‌توليدي‌شيشه‌رازي‌,2047,206631256,331807785681,1505,1535,1610,105,6.98,1606,101,6.71,1501,1610
غگيلا,شيرپاستوريزه پگاه گيلان,2042,4157947,102084815550,24300,24300,24400,100,0.41,24550,250,1.03,23650,25500
كارين,صندوق س نگين سامان-ثابت,2041,91382376,916024212261,10018,10024,10024,6,0.06,10024,6,0.06,10024,10025
خمحركه,نيرو محركه‌,2040,24765986,149907633950,6080,6090,6100,20,0.33,6050,-30,-0.49,5870,6200
بكام,كارخانجات توليدي شهيد قندي,2028,35235550,84986757326,2554,2530,2450,-104,-4.07,2412,-142,-5.56,2376,2530
ثفارس,عمران‌وتوسعه‌فارس‌,1983,31594224,284260895150,8980,8990,9040,60,0.67,9000,20,0.22,8800,9170
سمگا,گروه سرمايه گذاري ميراث فرهنگي,1975,22278193,153248186550,6810,6680,6820,10,0.15,6880,70,1.03,6680,7020
فلوله,لوله‌وماشين‌سازي‌ايران‌,1961,84750434,211550944890,2379,2497,2497,118,4.96,2496,117,4.92,2450,2497
سنير,سيمان‌ سفيد ني‌ريز,1960,2814427,102921005350,38270,37200,36370,-1900,-4.96,36570,-1700,-4.44,36360,37900
توسن,توسعه سامانه ي نرم افزاري نگين,1956,5752479,90352362910,15340,15350,15700,360,2.35,15710,370,2.41,15120,15940
نهال,صندوق س. طلاي سرخ نوويرا,1931,7534375,115641136852,15645,15699,15247,-398,-2.54,15348,-297,-1.9,15180,15699
ثشاهد,سرمايه‌ گذاري‌ شاهد,1924,13316456,132240059150,9950,9960,9880,-70,-0.7,9930,-20,-0.2,9600,10290
شاروم,پتروشيمي اروميه,1924,1682142,33667704850,20400,19950,20000,-400,-1.96,20000,-400,-1.96,19750,20550
فسوژ,سوژميران,1916,6068552,113325133010,19830,20000,18680,-1150,-5.8,18670,-1160,-5.85,18450,20000
ثالوند,سرمايه گذاري مسكن الوند,1914,24683398,297725221130,11330,11330,12120,790,6.97,12060,730,6.44,11330,12120
چكارن,كارتن‌ ايران‌,1904,48887900,190474423071,3743,3817,3917,174,4.65,3896,153,4.09,3650,3930
بپيوند,برق و انرژي پيوندگستر پارس,1896,2235730,24718110280,11210,11000,11080,-130,-1.16,11060,-150,-1.34,10910,11260
دكوثر,داروسازي‌ كوثر,1892,27983821,186463905370,7030,7230,6540,-490,-6.97,6660,-370,-5.26,6540,7230
زقيام,كشت و دام قيام اصفهان,1890,36612766,100403917682,2684,2600,2797,113,4.21,2742,58,2.16,2600,2840
حآسا,آسيا سير ارس,1889,14278356,148848772670,11140,10750,10370,-770,-6.91,10420,-720,-6.46,10370,10920
حآفرين,ريل پرداز نو آفرين,1872,97008240,430555232634,4233,4354,4444,211,4.98,4438,205,4.84,4270,4444
ومعادن,توسعه‌معادن‌وفلزات‌,1822,15990588,81911213040,5160,5190,5100,-60,-1.16,5130,-30,-0.58,5060,5190
شفن,پتروشيمي فناوران,1820,16110468,93509150590,5930,5930,5790,-140,-2.36,5800,-130,-2.19,5740,5930
گوهر,صندوق سكه طلاي كيان,1796,3266077,342362576230,109228,107000,105499,-3729,-3.41,104824,-4404,-4.03,103501,107000
دتوليد,داروسازي توليد دارو,1788,8432241,94814935010,11370,11800,11260,-110,-0.97,11240,-130,-1.14,10880,11800
سيتا,سرمايه گذاري سيمان تامين,1770,2596850,29229026130,11490,11490,11280,-210,-1.83,11350,-140,-1.22,11070,11490
امين,تامين سرمايه امين,1743,1069436,9376919040,8540,8130,8750,210,2.46,8570,30,0.35,8130,8940
زفكا,كشت و دامداري فكا,1739,23109382,322972355000,13160,13120,14080,920,6.99,13980,820,6.23,13120,14080
زر,صندوق س.پشتوانه سكه طلاي زر,1737,835321,77838769141,100301,97500,92400,-7901,-7.88,93184,-7117,-7.1,91010,97500
لكما,كارخانجات‌مخابراتي‌ايران‌,1728,93265083,105872659803,1169,1137,1134,-35,-2.99,1135,-34,-2.91,1134,1157
حسير,ريل سير كوثر,1727,6578317,177763546050,25750,26800,27450,1700,6.6,27000,1250,4.85,25800,27550
وهامون,سرمايه گذاري هامون صبا,1726,18950538,40055120491,2177,2131,2115,-62,-2.85,2114,-63,-2.89,2093,2182
كلر,كلر پارس,1717,1099585,98694790250,88450,88000,89750,1300,1.47,89750,1300,1.47,87900,92900
غسالم,سالمين‌,1714,20263845,91842061019,4561,4499,4555,-6,-0.13,4532,-29,-0.64,4434,4689
وپويا,سرمايه گذاري پويا,1714,21716428,55144976863,2630,2596,2524,-106,-4.03,2539,-91,-3.46,2495,2596
زملارد,كشاورزي و دامپروري ملارد شير,1709,1091452,14053961490,13040,12610,12860,-180,-1.38,12880,-160,-1.23,12610,13290
ذوب,ذوب آهن اصفهان,1708,76540804,237494321344,3136,3080,3161,25,0.8,3103,-33,-1.05,3070,3169
غدشت,دشت‌ مرغاب‌,1700,2386534,87565044210,37890,37250,36900,-990,-2.61,36690,-1200,-3.17,36020,37480
خوساز,محورسازان‌ايران‌خودرو,1688,6635878,162832105010,24020,24800,24300,280,1.17,24540,520,2.16,23120,25220
غپينو,پارس‌ مينو,1687,30145706,105628482664,3445,3360,3450,5,0.15,3504,59,1.71,3330,3581
غبشهر,صنعتي‌ بهشهر,1679,32130740,93303019946,2949,2900,2889,-60,-2.03,2904,-45,-1.53,2869,2950
سحرخيز,صندوق س. گروه زعفران سحرخيز,1678,3643431,79002089095,22444,22950,21505,-939,-4.18,21683,-761,-3.39,21260,22950
پخش,پخش البرز,1676,3914657,227972319750,56300,58000,57800,1500,2.66,58250,1950,3.46,56600,59100
گكوثر,هتل پارسيان كوثر اصفهان,1671,33520901,80001681186,2330,2291,2339,9,0.39,2387,57,2.45,2291,2446
آريا,پليمر آريا ساسول,1666,849748,66053569300,77750,77700,77750,0,0,77750,0,0,77400,78100
آپ,آسان پرداخت پرشين,1663,23804633,190514537180,7580,7800,8110,530,6.99,8000,420,5.54,7790,8110
فگستر,گسترش صنايع روي ايرانيان,1661,8504482,67406290550,8010,8010,7910,-100,-1.25,7930,-80,-1,7700,8200
غچين,كشت‌ و صنعت‌ چين‌ چين,1652,23499870,154387113870,6500,6470,6820,320,4.92,6570,70,1.08,6180,6820
خكاوه,سايپا ديزل,1646,17118387,332107708730,19980,19390,19390,-590,-2.95,19600,-380,-1.9,19390,19710
شبريز,پالايش نفت تبريز,1631,4121835,68398321200,16760,16700,16500,-260,-1.55,16660,-100,-0.6,16490,16850
حريل,ريل پردازسير,1628,21389837,76699385210,3651,3602,3710,59,1.62,3586,-65,-1.78,3410,3800
ختور,رادياتور ايران‌,1625,16727791,101527452300,5960,5910,6190,230,3.86,6070,110,1.85,5810,6230
زشريف,كشت وصنعت شريف آباد,1618,35054897,192425676100,5170,5520,5530,360,6.96,5490,320,6.19,5290,5530
تمشك,صندوق س تمشك نماد رشد-در صندوق,1611,11873071,120021038440,10000,10200,10090,90,0.9,10110,110,1.1,10090,10210
وصنعت,سرمايه گذاري توسعه صنعت وتجارت,1599,33218720,73688377358,2156,2200,2189,33,1.53,2218,62,2.88,2168,2288
فجهان,مجتمع جهان فولاد سيرجان,1597,9764874,31042219969,3210,3179,3201,-9,-0.28,3198,-12,-0.37,3150,3235
وگردش,بانك گردشگري,1584,18335519,143132208290,8030,7860,7840,-190,-2.37,7810,-220,-2.74,7790,8070
فنورد,نوردوقطعات‌ فولادي‌,1565,8301398,144494883300,16680,16700,17510,830,4.98,17410,730,4.38,16700,17510
وپارس,بانك‌پارسيان‌,1558,46134039,87704960523,1915,1897,1900,-15,-0.78,1904,-11,-0.57,1870,1950
آريان,سرمايه گذاري پارس آريان,1553,30766238,134591385474,4349,4290,4450,101,2.32,4375,26,0.6,4245,4464
ولپارس,ليزينگ پارسيان,1547,3714168,16020943530,4382,4300,4314,-68,-1.55,4313,-69,-1.57,4241,4450
سپيدار,سپيدار سيستم آسيا,1544,448824,11516867800,25600,24800,25650,50,0.2,25650,50,0.2,24800,26250
كزغال,زغال سنگ پروده طبس,1531,3455418,72635656600,21350,21350,21050,-300,-1.41,21000,-350,-1.64,20700,21450
ثپرديس,سرمايه گذاري مسكن پرديس,1518,25219420,148359835670,5540,5600,5920,380,6.86,5880,340,6.14,5460,5920
سصفها,سيمان‌اصفهان‌,1512,1891808,150200576460,75640,79390,79420,3780,5,79400,3760,4.97,78000,79420
اپال,فرآوري معدني اپال كاني پارس,1502,4215186,71220883210,16880,16750,16860,-20,-0.12,16890,10,0.06,16750,17090
خموتور,موتورسازان‌تراكتورسازي‌ايران‌,1501,12906580,87486346270,7000,6980,6800,-200,-2.86,6780,-220,-3.14,6650,7050
ولكار,ليزينگ كارآفرين,1500,3465848,30258060740,8480,8450,8800,320,3.77,8730,250,2.95,8420,8800
وبهمن,سرمايه‌گذاري‌بهمن‌,1484,24323371,87255443205,3810,3699,3652,-158,-4.15,3587,-223,-5.85,3544,3763
استقلال,استقلال,1477,13026841,27630888927,2087,2061,2128,41,1.96,2121,34,1.63,2061,2128
وگستر,گسترش سرمايه گذاري ايرانيان,1474,12368531,65763830820,5510,5500,5460,-50,-0.91,5320,-190,-3.45,5130,5510
ضخود1205,اختيارخ خودرو-2000-1401/12/03,1465,162922,172453658000,1072,1005,1115,43,4.01,1059,-13,-1.21,990,1120
شلعاب,لعابيران‌,1462,14622959,111876012250,7350,7560,7710,360,4.9,7650,300,4.08,7450,7710
وغدير,سرمايه‌گذاري‌غدير(هلدينگ‌,1459,12033816,225090973090,18660,18660,18890,230,1.23,18700,40,0.21,18510,18990
ونوين,بانك‌اقتصادنوين‌,1458,24601210,88657760209,3652,3630,3579,-73,-2,3604,-48,-1.31,3549,3650
فاسمين,كالسيمين‌,1455,6037317,159473266330,26790,27190,26700,-90,-0.34,26410,-380,-1.42,25880,27190
فباهنر,مس‌ شهيدباهنر,1451,3702427,124509230610,33550,33850,33550,0,0,33630,80,0.24,32900,34000
غكورش,صنعت غذايي كورش,1448,6504055,63796053750,9950,9790,9780,-170,-1.71,9810,-140,-1.41,9670,9990
شپاكسا,پاكسان‌,1447,54758418,127488338986,2185,2250,2337,152,6.96,2328,143,6.54,2186,2337
صبا,گروه مالي صبا تامين,1445,19383456,73530900471,3799,3751,3805,6,0.16,3795,-4,-0.11,3751,3830
چكاپا,گروه صنايع كاغذ پارس,1438,22737615,69206044171,3009,3050,3044,35,1.16,3044,35,1.16,3003,3086
افرا,افرانت,1437,2889312,71244506050,24850,24600,24300,-550,-2.21,24650,-200,-0.8,23750,25550
ثغرب,شركت سرمايه گذاري مسكن شمالغرب,1423,9914923,79730490300,7900,7950,7990,90,1.14,8040,140,1.77,7850,8190
خاذين,سايپاآذين‌,1421,36702633,98159468170,2586,2580,2715,129,4.99,2674,88,3.4,2560,2715
خفنر,فنرسازي‌خاور,1404,7061555,81429222970,11430,11410,11710,280,2.45,11530,100,0.87,11000,11980
ولغدر,ليزينگ‌خودروغدير,1401,24983684,102782917464,4309,4250,4080,-229,-5.31,4114,-195,-4.53,4030,4328
آكورد,صندوق س. آرمان آتي كوثر-د,1383,14023486,627163956443,44692,44723,44722,30,0.07,44722,30,0.07,44722,44723
شگويا,پتروشيمي تندگويان,1373,9517579,113523931950,12010,12000,12010,0,0,11930,-80,-0.67,11840,12090
قهكمت,قندهكمتان‌,1363,8908582,78579162170,8670,8890,8810,140,1.61,8820,150,1.73,8690,8970
وبانك,سرمايه گذاري گروه توسعه ملي,1357,13184179,140710448680,10870,10990,10760,-110,-1.01,10670,-200,-1.84,10550,10990
وطوبي,سرمايه گذاري اقتصاد شهر طوبي,1357,30256356,62332042498,2092,2024,2042,-50,-2.39,2060,-32,-1.53,2011,2141
سشرق,سيمان‌ شرق‌,1355,7203199,76734885040,10450,10530,10580,130,1.24,10650,200,1.91,10450,10950
غپاك,لبنيات‌ پاك‌,1354,13945120,185347006150,12810,12660,13170,360,2.81,13290,480,3.75,12400,13450
اخابر,مخابرات ايران,1351,18608038,143730972860,7880,7730,7720,-160,-2.03,7720,-160,-2.03,7580,7910
وملل,اعتباري ملل,1335,22988293,84960582624,3615,3660,3619,4,0.11,3696,81,2.24,3523,3790
لپارس,پارس‌ الكتريك‌,1332,861729,68994356970,81010,78600,79990,-1020,-1.26,80070,-940,-1.16,78570,82400
پكوير,كوير تاير,1322,8324142,46984152820,5950,6110,5560,-390,-6.55,5640,-310,-5.21,5540,6110
خمحور,توليدمحورخودرو,1312,27687017,123252717167,4263,4312,4476,213,5,4452,189,4.43,4300,4476
پلاست,كارخانجات توليدي پلاستيران,1303,8831496,102274339320,11450,11560,11560,110,0.96,11580,130,1.14,11170,11790
البرز,بيمه البرز,1301,16918395,34574165433,2070,2039,2048,-22,-1.06,2044,-26,-1.26,2020,2100
ثنور,سرمايه گذاري كوه نور,1300,13378345,98143823350,7130,7310,7340,210,2.95,7340,210,2.95,7280,7340
حخزر,كشتيراني درياي خزر,1295,11039221,334552646600,29800,30900,29750,-50,-0.17,30300,500,1.68,29200,30900
غالبر,لبنيات‌ كالبر,1290,3043140,88451925860,28580,29900,29080,500,1.75,29070,490,1.71,28000,29900
اتكام,بيمه اتكايي امين,1287,76007297,362307111744,4546,4773,4773,227,4.99,4767,221,4.86,4546,4773
دفارا,داروسازي‌ فارابي‌,1279,20989818,467071520920,21970,22370,22550,580,2.64,22250,280,1.27,21900,22560
ومهان,گروه توسعه مالي مهر آيندگان,1267,8579441,47334920270,5620,5540,5540,-80,-1.42,5550,-70,-1.25,5430,5650
غصينو,صنعتي مينو,1265,22292988,294750198570,12780,12420,13410,630,4.93,13220,440,3.44,12420,13410
كيمياتك,آريان كيميا تك,1264,3466779,43482179010,12820,12520,12820,0,0,12540,-280,-2.18,12350,13000
پارسيان,بيمه پارسيان,1262,23756122,88772675732,3531,3472,3778,247,7,3737,206,5.83,3471,3778
اتكاسا,بيمه اتكايي سامان,1256,9347026,40099329344,4330,4350,4299,-31,-0.72,4290,-40,-0.92,4221,4369
غويتا,ويتانا,1243,11589892,62719203360,5400,5340,5420,20,0.37,5410,10,0.19,5300,5590
لبخند,صندوق س. لبخند فارابي-د,1240,140357558,1532500371374,10910,10918,10919,9,0.08,10919,9,0.08,10918,10919
شراز,پالايش نفت شيراز,1228,5126345,74661046580,14950,15150,14660,-290,-1.94,14560,-390,-2.61,14450,15150
آ س پ,آ.س.پ,1224,17783907,130429599340,6870,6930,7350,480,6.99,7330,460,6.7,6930,7350
سكه0312ن06,ربع سكه 0312رفاه(ن),1223,454500,371924118800,705000,1400000,792000,87000,12.34,818315,113315,16.07,792000,1400000
بپاس,بيمه پاسارگاد,1221,4580885,87473853900,19550,19500,19100,-450,-2.3,19200,-350,-1.79,18900,19500
حتوكا,حمل‌ونقل‌توكا,1218,15898497,129958734120,8040,8040,8440,400,4.98,8170,130,1.62,7820,8440
تاپيكو,س. نفت و گاز و پتروشيمي تأمين,1211,4860774,62633185670,12990,12740,12820,-170,-1.31,12930,-60,-0.46,12740,13110
قشكر,شكرشاهرود,1207,24677930,55486516449,2355,2360,2254,-101,-4.29,2248,-107,-4.54,2238,2360
خزر,فنرسازي‌زر,1194,14439779,73096536720,5100,5250,5110,10,0.2,5060,-40,-0.78,4910,5250
امين يكم,صندوق درآمد ثابت امين يكم فردا,1181,28414208,282622403241,9897,9942,9937,40,0.4,9947,50,0.51,9937,9951
كي بي سي,شركت كي بي سي,1175,6580043,85852825480,13340,13490,13000,-340,-2.55,13050,-290,-2.17,12680,13490
دسانكو,داروسازي سبحان انكولوژي,1171,8140314,56106532560,6810,6800,7020,210,3.08,6890,80,1.17,6610,7060
درهآور,دارويي ره آورد تامين,1170,1897993,138651719250,70450,68400,73800,3350,4.76,73050,2600,3.69,68400,75350
فسازان,غلتك سازان سپاهان,1163,23298397,103772167970,4269,4380,4482,213,4.99,4454,185,4.33,4288,4482
كفرآور,فرآورده هاي سيمان شرق,1159,7124579,112107274700,15420,15860,15560,140,0.91,15740,320,2.08,15010,15880
قشير,قند شيروان قوچان و بجنورد,1149,9358970,83086523570,9290,9200,9000,-290,-3.12,8880,-410,-4.41,8640,9200
ثرود,سرمايه‌گذاري مسكن زاينده رود,1148,7366441,80448406990,10730,11000,11160,430,4.01,10920,190,1.77,10500,11160
نوين,بيمه نوين,1134,25034139,46264247073,1907,1938,1852,-55,-2.88,1848,-59,-3.09,1814,1938
شيران,س. صنايع‌شيميايي‌ايران,1099,6790845,74535277420,10950,10700,11080,130,1.19,10970,20,0.18,10500,11090
تاپكيش,تجارت الكترونيك پارسيان كيش,1098,4666286,43456234880,9690,9650,9350,-340,-3.51,9310,-380,-3.92,9080,9650
پارسان,گسترش نفت و گاز پارسيان,1096,4076970,132519303160,32850,32400,32200,-650,-1.98,32500,-350,-1.07,32000,32840
فسبزوار,پارس فولاد سبزوار,1096,671798,16046220920,24060,23590,23760,-300,-1.25,23990,-70,-0.29,23590,24220
شاوان,پالايش نفت لاوان,1095,3345637,69623483300,21050,20850,20800,-250,-1.19,20800,-250,-1.19,20500,21100
شسپا,نفت سپاهان,1094,12914494,52730004375,4106,4120,4057,-49,-1.19,4093,-13,-0.32,4038,4120
غمينو,شركت صنايع غذايي مينو شرق,1094,38743578,337901519030,8260,8300,8830,570,6.9,8720,460,5.57,8240,8830
كچاد,معدني‌وصنعتي‌چادرملو,1093,5016636,59308057730,11830,11990,11900,70,0.59,11830,0,0,11600,12000
همراه,شركت ارتباطات سيار ايران,1089,15562132,124461100790,8130,8150,8000,-130,-1.6,8000,-130,-1.6,7930,8190
كاذر,فرآورده‌هاي‌نسوزآذر,1084,45800186,238734649580,4990,5000,5230,240,4.81,5210,220,4.41,4890,5230
دالبر,البرزدارو,1083,12369152,101958700990,7770,7770,8310,540,6.95,8240,470,6.05,7770,8310
فارس,صنايع پتروشيمي خليج فارس,1078,13597141,127737968290,9390,9420,9420,30,0.32,9390,0,0,9310,9440
پتاير,ايران‌ تاير,1075,35004144,51321250151,1487,1489,1466,-21,-1.41,1466,-21,-1.41,1442,1493
سمايه,بانك سرمايه,1066,11325767,62350655160,5400,5240,5560,160,2.96,5510,110,2.04,5240,5560
ساينا,صنايع بهداشتي ساينا,1062,2483178,79700873500,30800,30000,32950,2150,6.98,32100,1300,4.22,29800,32950
تملت,تامين سرمايه بانك ملت,1060,9013250,28468352286,3190,3193,3190,0,0,3159,-31,-0.97,3120,3259
پدرخش,درخشان‌ تهران‌,1058,6398535,87086283840,13390,13880,13750,360,2.69,13610,220,1.64,13110,14000
خلنت,لنت‌ ترمزايران‌,1057,2000377,65805011500,34400,34000,33100,-1300,-3.78,32900,-1500,-4.36,32680,34000
چدن,توليدي چدن سازان,1048,17048270,42296470796,2463,2425,2514,51,2.07,2481,18,0.73,2400,2530
خريخت,صنايع‌ريخته‌گري‌ايران‌,1042,15966482,66863652926,4068,4045,4250,182,4.47,4188,120,2.95,4022,4264
حبندر,دريايي و کشتيراني خط دريابندر,1041,2799865,41189755860,14310,14100,14730,420,2.94,14710,400,2.8,14100,14730
اوان,مبين وان كيش,1033,4343350,70186063990,15660,16090,15770,110,0.7,16160,500,3.19,15600,16740
خديزل,بهمن  ديزل,1025,11847345,80665078350,6690,6740,6890,200,2.99,6810,120,1.79,6680,6910
كهربا,صندوق س.پشتوانه سكه طلا كهربا,1025,5122971,96629688944,19937,19790,18790,-1147,-5.75,18862,-1075,-5.39,18631,19790
ورازي,بيمه رازي,1024,29473928,42887836267,1457,1434,1454,-3,-0.21,1455,-2,-0.14,1420,1495
پارس,پتروشيمي پارس,1020,19576976,47246891039,2415,2444,2411,-4,-0.17,2414,-1,-0.04,2406,2444
تجلي,تجلي توسعه معادن و فلزات,1014,26474938,39738341557,1471,1475,1506,35,2.38,1501,30,2.04,1451,1520
افق,فروشگاههاي زنجيره اي افق كوروش,1010,4311325,64111426090,14460,14490,14770,310,2.14,14810,350,2.42,14380,15070
چكاوه,صنايع‌كاغذسازي‌كاوه‌,1009,5745432,73946079070,12380,12630,12800,420,3.39,12870,490,3.96,12380,12990
شوينده,مديريت صنعت شوينده ت.ص.بهشهر,1005,4644276,94897208620,19250,19760,20580,1330,6.91,20430,1180,6.13,18810,20590
ريشمك,توليد و صادرات ريشمك,996,2909869,70609221950,23950,25300,24300,350,1.46,24250,300,1.25,23300,25300
ستران,سيمان‌ تهران‌,994,3122736,116995266410,37800,37990,38200,400,1.06,37470,-330,-0.87,36560,38260
شفارس,صنايع‌ شيميايي‌ فارس‌,992,25921110,34765016842,1369,1341,1351,-18,-1.31,1341,-28,-2.05,1315,1379
غدام,خوراك‌  دام‌ پارس‌,984,968638,46661802670,49340,49890,47990,-1350,-2.74,48170,-1170,-2.37,47300,49920
ثنوسا,نوسازي‌وساختمان‌تهران‌,981,17399494,84710622655,4928,4760,4863,-65,-1.32,4869,-59,-1.2,4701,5020
سكرد,سيمان كردستان,979,6965447,51111418750,7580,7290,7330,-250,-3.3,7340,-240,-3.17,7190,7580
سفارس,سيمان فارس و خوزستان,974,3196461,72491487530,22930,23100,22510,-420,-1.83,22680,-250,-1.09,22220,23380
شمواد,توليد مواداوليه الياف مصنوعي,968,2230309,161422623300,65650,71050,73050,7400,11.27,72400,6750,10.28,69300,73150
شپلي,پلي اكريل ايران,954,22641883,263098660460,11290,11620,11620,330,2.92,11620,330,2.92,11600,11620
زنگان,صنعت روي زنگان,951,707506,46272580350,63950,63000,66900,2950,4.61,65400,1450,2.27,62100,67550
فيروزا,صندوق ارمغان فيروزه آسيا-ثابت,950,34849848,1130131863241,32407,32428,32429,22,0.07,32429,22,0.07,32428,32429
بجهرم,توسعه مولد نيروگاهي جهرم,949,14789406,32035075305,2214,2214,2168,-46,-2.08,2166,-48,-2.17,2132,2214
فجر,فولاد اميركبيركاشان,948,5957428,100007528800,16910,17670,16960,50,0.3,16790,-120,-0.71,16300,17670
كسرا,سراميك‌هاي‌صنعتي‌اردكان‌,941,10487022,62469645530,5940,6010,5950,10,0.17,5960,20,0.34,5860,6110
زكشت,كشاورزي مكانيزه اصفهان كشت,939,2055154,55941919550,28100,26900,27400,-700,-2.49,27200,-900,-3.2,26850,28100
قاسم,قاسم ايران,936,11213823,80569386010,7320,7320,7180,-140,-1.91,7180,-140,-1.91,7020,7410
غشهداب,كشت و صنعت شهداب ناب خراسان,922,19403228,41655044429,2197,2190,2140,-57,-2.59,2147,-50,-2.28,2116,2199
خشرق,الكتريك‌ خودرو شرق‌,921,3679359,62993586550,17260,17000,17600,340,1.97,17120,-140,-0.81,16530,17800
پرسپوليس,پرسپوليس,917,9236679,23631820682,2516,2566,2566,50,1.99,2558,42,1.67,2500,2566
آوند,صندوق س. آوند مفيد-د,916,52685712,582478384582,11047,11055,11056,9,0.08,11056,9,0.08,11055,11056
شاراك,پتروشيمي شازند,915,2006508,63013637280,32130,32000,31290,-840,-2.61,31630,-500,-1.56,31010,32250
بنو,بيمه تجارت نو,913,6417578,26159134368,4145,4150,4065,-80,-1.93,4076,-69,-1.66,4005,4195
وخاور,بانك خاورميانه,912,14873545,63415984869,4277,4350,4271,-6,-0.14,4264,-13,-0.3,4175,4350
شتوكا,توكا رنگ فولاد سپاهان,911,3798330,62046049890,17300,17100,16090,-1210,-6.99,16340,-960,-5.55,16090,17310
بزاگرس,نيروگاه زاگرس كوثر,908,15085824,71994522659,4626,4450,4857,231,4.99,4772,146,3.16,4450,4857
پارتا,مجتمع صنعتي آرتاويل تاير,907,4185080,35302884820,8850,8570,8490,-360,-4.07,8440,-410,-4.63,8410,8800
وآوا,سرمايه گذاري آوا نوين,902,11424372,34563990535,3119,3110,3050,-69,-2.21,3025,-94,-3.01,2991,3148
ومدير,گ.مديريت ارزش سرمايه ص ب كشوري,899,2999371,12732956694,4260,4299,4221,-39,-0.92,4248,-12,-0.28,4211,4299
غپآذر,شير پگاه آذربايجان شرقي,897,863694,37874420200,44050,45000,44000,-50,-0.11,43850,-200,-0.45,42550,45100
كروي,توسعه‌ معادن‌ روي‌ ايران‌,894,2240789,64784966650,29900,29300,28750,-1150,-3.85,28910,-990,-3.31,28400,29760
دكيمي,كيميدارو,891,2123929,77105621510,36190,35990,36500,310,0.86,36300,110,0.3,35000,37380
جوين,كشت و صنعت جوين,884,19232068,110177416340,5570,5700,5730,160,2.87,5730,160,2.87,5690,5730
دامين,داروسازي‌ امين‌,874,12080875,41914344016,3547,3510,3459,-88,-2.48,3469,-78,-2.2,3404,3647
شبهرن,نفت‌ بهران‌,871,1725185,34095959210,19920,20000,19700,-220,-1.1,19860,-60,-0.3,19650,20000
چافست,افست‌,870,11173739,66142567850,5950,6030,5900,-50,-0.84,5920,-30,-0.5,5690,6140
شگل,گلتاش‌,870,23302738,148658687420,5980,6390,6390,410,6.86,6380,400,6.69,6190,6390
فنوال,نورد آلومينيوم‌,867,12978852,93800315220,6870,6880,7350,480,6.99,7230,360,5.24,6880,7350
ثباغ,شهر سازي و خانه سازي باغميشه,864,8885308,90364066340,9630,9800,10300,670,6.96,10170,540,5.61,9420,10300
بموتو,موتوژن‌,860,12127217,36462672492,2907,2929,3040,133,4.58,3007,100,3.44,2840,3080
دسبحان,سبحان دارو,857,10478388,78370375090,7200,7200,7470,270,3.75,7480,280,3.89,7050,7560
دبالك,مواد اوليه دارويي البرز بالك,847,8706789,80258573990,8720,8600,9330,610,7,9220,500,5.73,8600,9330
وآرين,شركت توسعه اقتصادي آرين,845,20508712,28232734098,1411,1390,1370,-41,-2.91,1377,-34,-2.41,1369,1416
كپشيرح,ح . پشم‌شيشه‌ايران‌,844,7682171,34970054298,4799,4798,4548,-251,-5.23,4552,-247,-5.15,4465,4798
خودكفا,اقتصادي و خودكفايي آزادگان,844,14278646,116314744060,7920,8090,8150,230,2.9,8150,230,2.9,8050,8150
فايرا,آلومينيوم‌ايران‌,842,10625121,69166037730,6350,6570,6600,250,3.94,6460,110,1.73,6370,6660
پارند,صندوق س. پارند پايدار سپهر,840,46540987,470459679522,10102,10108,10109,7,0.07,10109,7,0.07,10108,10109
سيمرغ,سيمرغ,837,2143558,55261376770,25640,25220,25950,310,1.21,25780,140,0.55,25220,26500
دماوند,توليد نيروي برق دماوند,834,2520921,53333315450,21600,21650,21000,-600,-2.78,21150,-450,-2.08,20900,21850
ساوه,سيمان ساوه,825,488075,40805102200,85250,84900,83700,-1550,-1.82,83600,-1650,-1.94,81200,85400
وملي,گروه‌ صنعتي‌ ملي‌ (هلدينگ‌,820,322307,45737058570,142030,142010,140270,-1760,-1.24,141910,-120,-0.08,139700,144200
كساپا,سايپاشيشه‌,815,3037428,74120633650,25170,26190,24230,-940,-3.73,24400,-770,-3.06,23920,26190
سامانح,ح. بانك سامان,810,46106096,70108133989,1566,1521,1521,-45,-2.87,1521,-45,-2.87,1520,1540
سفاسي,شركت فارسيت اهواز,806,14247171,55553111596,3938,3822,3910,-28,-0.71,3899,-39,-0.99,3820,4055
وسينا,بانك سينا,806,24531134,76447469950,3191,3110,3102,-89,-2.79,3116,-75,-2.35,3011,3203
زماهان,مجتمع توليد گوشت مرغ ماهان,800,4900592,39803363120,8010,8140,8190,180,2.25,8120,110,1.37,7940,8300
بخاور,بيمه زندگي خاورميانه,800,15317670,40519478639,2758,2755,2691,-67,-2.43,2645,-113,-4.1,2589,2758
توريل,توكاريل,798,8570747,94027312040,10730,10600,11260,530,4.94,10970,240,2.24,10200,11260
رتاپ,تجارت الكترونيك  پارسيان,794,7051533,21600386098,3077,3077,3060,-17,-0.55,3063,-14,-0.45,3038,3096
وسين,بيمه سينا,786,30944073,68053259173,2151,2215,2215,64,2.98,2199,48,2.23,2140,2215
شغدير,پتروشيمي غدير,780,1827742,128337250680,70290,70290,70300,10,0.01,70220,-70,-0.1,70000,71050
وپست,پست بانك ايران,771,9807559,57434101100,5950,5770,5870,-80,-1.34,5860,-90,-1.51,5770,5950
درازك,دارويي‌ رازك‌,767,4240213,69182292190,16330,16320,16470,140,0.86,16320,-10,-0.06,15920,16630
ولشرق,ليزينگ ايران و شرق,764,11448987,39135886459,3487,3410,3461,-26,-0.75,3418,-69,-1.98,3362,3520
ولملت,واسپاري ملت,762,12799575,68733587790,5130,5080,5480,350,6.82,5370,240,4.68,5030,5480
هرمز,فولاد هرمزگان جنوب,753,7877312,105397723810,13200,13110,13730,530,4.02,13360,160,1.21,13110,13820
غبهنوش,بهنوش‌ ايران‌,752,1145833,71082371300,59700,59550,61000,1300,2.18,62040,2340,3.92,57660,62680
اميد,تامين سرمايه اميد,751,6308179,34839781150,5700,5660,5470,-230,-4.04,5520,-180,-3.16,5430,5680
دزهراوي,داروسازي‌زهراوي‌,748,8602450,43444869774,5116,5116,5110,-6,-0.12,5050,-66,-1.29,4987,5146
خچرخش,چرخشگر,748,2863660,62772591190,22270,22100,21940,-330,-1.48,21920,-350,-1.57,21380,22490
كبافق,معادن‌ بافق‌,745,1726340,52481612910,31290,30600,30450,-840,-2.68,30400,-890,-2.84,29910,32370
سشمال,سيمان‌ شمال‌,744,3899648,53379728910,13360,13360,13500,140,1.05,13690,330,2.47,13190,14170
زكوثر,سرمايه گذاري كشاورزي كوثر,742,1796369,29458592230,16290,16290,16390,100,0.61,16400,110,0.68,16120,16600
وصنا,گروه‌صنايع‌بهشهرايران‌,735,11972490,33156735470,2742,2700,2770,28,1.02,2769,27,0.98,2684,2870
ونفت,سرمايه‌گذاري‌ صنعت‌ نفت‌,733,9286960,38745922455,4316,4350,4169,-147,-3.41,4172,-144,-3.34,4101,4360
خفناور,مهندسي صنعتي روان فن آور,728,2229550,54094120600,24900,24500,24400,-500,-2.01,24250,-650,-2.61,24200,24850
خعمرا,توسعه و عمران شهرستان نائين,725,4617550,26000676050,5750,5840,5690,-60,-1.04,5630,-120,-2.09,5580,5850
آينده,بازرگاني آينده سازان بهشت پارس,724,5830754,49623646420,8320,8540,8360,40,0.48,8510,190,2.28,8300,8560
كامياب,صندوق س. كامياب آشنا-د,720,25804847,360635849135,13967,13975,13976,9,0.06,13976,9,0.06,13975,13976
سدور,سيمان‌ دورود,719,2855074,25294393670,9120,9250,8860,-260,-2.85,8860,-260,-2.85,8780,9250
ختراك,ريخته‌گري‌ تراكتورسازي‌ ايران‌,718,8002711,111554210920,14100,14190,14160,60,0.43,13940,-160,-1.13,13440,14380
كطبس,ذغال‌سنگ‌ نگين‌ ط‌بس‌,714,1601840,26981355080,16430,16560,16840,410,2.5,16840,410,2.5,16540,17150
ودي,بيمه  دي,711,11542236,57495876152,4798,4850,4900,102,2.13,4981,183,3.81,4740,5050
غشهد,شهد ايران ‌,708,5561065,37521442760,6500,6530,6820,320,4.92,6750,250,3.85,6380,6820
وپسا,س. پتروشيمي ساختمان  خليج فارس,706,16691133,30074961805,1758,1788,1805,47,2.67,1802,44,2.5,1732,1810
كفپارس,فرآورده‌هاي‌ نسوز پارس‌,705,12048067,52059605310,4444,4480,4340,-104,-2.34,4321,-123,-2.77,4210,4480
شپارس,بين‌ المللي‌ محصولات‌  پارس‌,703,5004826,32771666960,6520,6520,6430,-90,-1.38,6550,30,0.46,6390,6660
قنيشا,قند  نيشابور,698,14934242,41705716926,2812,2750,2757,-55,-1.96,2793,-19,-0.68,2712,2869
زدشت,كشت و صنعت دشت خرم دره,696,1777759,53398535850,31100,31100,29650,-1450,-4.66,30050,-1050,-3.38,29650,31100
زگلدشت,كشت و دام گلدشت نمونه اصفهان,687,3761523,71572642700,18260,18300,19270,1010,5.53,19030,770,4.22,17680,19500
بالبر,كابل‌ البرز,686,869241,52628238980,62710,64890,59580,-3130,-4.99,60550,-2160,-3.44,59580,64890
ساربيل,سيمان آرتا اردبيل,679,1570104,71249747020,47250,47860,44890,-2360,-4.99,45380,-1870,-3.96,44890,47860
حپترو,حمل و نقل پتروشيمي( سهامي عام,677,1373365,51353854460,37450,37820,36210,-1240,-3.31,37390,-60,-0.16,36000,39300
تفارس,تامين سرمايه خليج فارس,677,10688122,58926343160,5640,5720,5510,-130,-2.3,5510,-130,-2.3,5480,5720
كاوه,فولاد كاوه جنوب كيش,677,5597149,43734603160,7770,7990,7800,30,0.39,7790,20,0.26,7760,8050
مفاخر,توسعه فناوري اطلاعات خوارزمي,676,3643411,31075106530,8660,8760,8480,-180,-2.08,8530,-130,-1.5,8380,8890
دكپسول,توليد ژلاتين كپسول ايران,674,933161,60896302850,66800,65050,66050,-750,-1.12,65250,-1550,-2.32,64050,67400
شكام,صنايع شيميايي كيمياگران امروز,672,4535539,37649407230,8490,8650,8260,-230,-2.71,8300,-190,-2.24,8160,8650
غبهار,كشت وصنعت بهاران گلبهار خراسان,671,1974304,32278532120,16070,16140,16200,130,0.81,16350,280,1.74,16000,16550
وهنر,گروه توسعه هنر ايران,668,10959321,31477511813,2944,2860,2899,-45,-1.53,2872,-72,-2.45,2856,2995
ميهن,بيمه ميهن,668,11996072,76962654580,6650,6650,6320,-330,-4.96,6420,-230,-3.46,6320,6650
تصميم,صندوق س با درآمد ثابت تصميم,667,20862028,477152602416,22858,22872,22871,13,0.06,22872,14,0.06,22870,23400
بهپاك,صنعتي بهپاك,665,14733292,107139579950,7000,7150,7350,350,5,7270,270,3.86,6840,7350
كمنگنز,معادن‌منگنزايران‌,658,2970593,34519229770,11600,11680,11500,-100,-0.86,11620,20,0.17,11450,11820
غشاذر,پگاه‌آذربايجان‌غربي‌,657,4575229,31162112410,6900,6800,6750,-150,-2.17,6810,-90,-1.3,6600,7000
تشتاد,صنايع توليدي اشتاد ايران‌,656,4395752,26731135080,6010,6150,5990,-20,-0.33,6080,70,1.16,5880,6190
دلر,داروسازي‌ اكسير,654,3337583,81886750730,23770,23090,24950,1180,4.96,24530,760,3.2,23090,24950
شصدف,صنعتي دوده فام,650,629495,21477289600,34250,33550,34150,-100,-0.29,34100,-150,-0.44,33550,34950
زرفام,صندوق س.پشتوانه طلا زرفام آشنا,646,1449822,22394382705,16848,16800,15350,-1498,-8.89,15446,-1402,-8.32,15164,16800
نطرين,عطرين نخ قم,645,4182392,30450338150,7490,7480,7400,-90,-1.2,7280,-210,-2.8,7170,7550
كيميا,معدني كيمياي زنجان گستران,643,9879588,78810752060,8160,8180,8020,-140,-1.72,7980,-180,-2.21,7810,8240
والبر,سرمايه‌ گذاري‌ البرز(هلدينگ‌,639,7137132,45124807020,6330,6330,6360,30,0.47,6320,-10,-0.16,6230,6490
وسكاب,س.ص.بازنشستگي كاركنان بانكها,638,7872899,24445066668,3127,3149,3119,-8,-0.26,3105,-22,-0.7,3080,3149
كپشير,پشم‌شيشه‌ايران‌,637,5099426,41255792940,8490,8130,8070,-420,-4.95,8090,-400,-4.71,8070,8290
دلقما,دارويي‌ لقمان‌,632,13322147,41130979360,3116,3189,3066,-50,-1.6,3087,-29,-0.93,3023,3189
تكمبا,كمباين‌ سازي‌ ايران‌,632,4066477,25094646310,6380,6290,6140,-240,-3.76,6170,-210,-3.29,6060,6470
شپاس,نفت پاسارگاد,626,2130372,41612901720,20490,20750,19500,-990,-4.83,19530,-960,-4.69,19470,20750
مداران,داده‌پردازي‌ايران‌,626,4232859,29871385160,6890,6960,7160,270,3.92,7060,170,2.47,6900,7210
كگاز,شيشه‌ و گاز,624,2786996,41898601930,15620,15400,15000,-620,-3.97,15030,-590,-3.78,14890,15530
لسرما,سرما آفرين‌,623,1476007,38627481010,26560,26570,27020,460,1.73,26170,-390,-1.47,25240,27350
دتوزيع,توزيع دارو پخش,621,2038938,73834859100,35400,35400,36800,1400,3.95,36200,800,2.26,34700,36950
بكهنوج,توليد برق ماهتاب كهنوج,618,16804696,24949395329,1478,1484,1510,32,2.17,1485,7,0.47,1440,1510
چفيبر,فيبر ايران‌,616,4290347,24066671450,5840,5750,5550,-290,-4.97,5610,-230,-3.94,5550,5850
خراسان,پتروشيمي خراسان,614,355810,41245316640,116540,116770,115810,-730,-0.63,116230,-310,-0.27,115680,117390
خپويش,سازه‌ پويش‌,613,7799950,182518830000,22290,23400,23400,1110,4.98,23400,1110,4.98,23400,23400
اعتلا,شركت سرمايه گذاري اعتلاء البرز,613,17563754,87325662460,5230,5200,4970,-260,-4.97,4970,-260,-4.97,4970,5200
تماوند,تامين سرمايه دماوند,611,4928724,30657075730,6400,6220,6200,-200,-3.13,6220,-180,-2.81,6100,6390
سدبير,س. تدبيرگران فارس وخوزستان,610,2263885,72682393300,30200,31100,32300,2100,6.95,32100,1900,6.29,31050,32300
خكمك,كمك‌فنرايندامين‌,610,2009174,44196846900,22550,22000,21810,-740,-3.28,22000,-550,-2.44,21530,22720
كيا,كيا الكترود شرق,604,14011517,134506663200,9150,9600,9600,450,4.92,9600,450,4.92,9500,9600
سفار,سيمان‌فارس‌,601,633829,58910900900,97620,96000,93900,-3720,-3.81,92940,-4680,-4.79,92740,96000
زمگسا,كشاورزي‌ ودامپروي‌ مگسال‌,598,2249586,76755675180,32960,32360,33840,880,2.67,34120,1160,3.52,32360,34600
شرنگي,شيميايي رنگين,598,655921,27353303550,42800,41800,41650,-1150,-2.69,41700,-1100,-2.57,41550,43200
ولصنم,ليزينگ‌صنعت‌ومعدن‌,595,24587825,144894570285,5545,5610,5933,388,7,5893,348,6.28,5610,5933
بمپنا,توليد برق عسلويه  مپنا,586,6504210,41941594510,6350,6330,6410,60,0.94,6450,100,1.57,6090,6660
كرماشا,صنايع پتروشيمي كرمانشاه,582,617549,39948814170,64940,65250,64890,-50,-0.08,64830,-110,-0.17,64220,65250
وشمال,س. چشم انداز توسعه شمال,582,1270788,27020117250,21450,21850,21050,-400,-1.86,21250,-200,-0.93,21050,21850
خرينگ,رينگ‌سازي‌مشهد,581,2659050,81325938330,29340,30000,30800,1460,4.98,30580,1240,4.23,29500,30800
سدشت,صنايع سيمان دشتستان,577,1401566,47660456590,33770,33780,33980,210,0.62,34010,240,0.71,32540,34880
حتايد,تايدواترخاورميانه,576,6796794,35986581120,5390,5400,5380,-10,-0.19,5290,-100,-1.86,5160,5400
ملت,بيمه ملت,576,11579190,18625898620,1651,1610,1622,-29,-1.76,1611,-40,-2.42,1583,1640
جم,پتروشيمي جم,575,1285121,47857039080,37490,37000,37400,-90,-0.24,37370,-120,-0.32,37000,37730
وثوق,سرمايه گذاري وثوق امين,573,3877956,90701320850,23000,23000,23650,650,2.83,23250,250,1.09,22800,23650
اطلس,صندوق س.توسعه اطلس مفيد-س,573,156958,49953888045,322882,322875,318495,-4387,-1.36,318263,-4619,-1.43,317100,322875
خفولا,خدمات فني فولاد يزد,570,1081534,54735611700,51650,52000,50150,-1500,-2.9,50600,-1050,-2.03,50150,52100
كلوند,كاشي‌ الوند,569,1566856,53968650200,34040,34140,34050,10,0.03,34440,400,1.18,33200,35490
ضخود1211,اختيارخ خودرو-3250-1401/12/03,565,94091,17243641000,207,193,210,3,1.45,183,-24,-11.59,146,220
سرو,صندوق س سروسودمند مدبران-سهام,561,522330,48481307990,94100,92510,92660,-1440,-1.53,92820,-1280,-1.36,92350,93890
خكرمان,سرمايه گذاري آرمان گستر پاريز,559,23101261,106751672989,4763,4621,4621,-142,-2.98,4621,-142,-2.98,4621,4672
وپترو,سرمايه‌گذاري صنايع پتروشيمي‌,558,3129625,52054905710,16770,16110,16800,30,0.18,16630,-140,-0.83,16100,17180
ثبات,صندوق س. ثبات ويستا -د,556,104425517,1397793986985,13377,13385,13386,9,0.07,13386,9,0.07,13385,13386
قصفها,قنداصفهان‌,555,385160,37277024050,95360,92500,96440,1080,1.13,96780,1420,1.49,92500,99000
فزرين,زرين معدن آسيا,550,4238933,29048783430,7100,7090,6900,-200,-2.82,6850,-250,-3.52,6800,7090
فولاژ,فولاد آلياژي ايران,550,4314580,48661816820,10980,11300,11220,240,2.19,11110,130,1.18,11090,11500
شكربن,كربن‌ ايران‌,549,7906574,28960763554,3729,3732,3626,-103,-2.76,3663,-66,-1.77,3607,3779
وثنو,سرمايه گذاري ساختماني نوين,546,10956755,24346071268,2237,2277,2224,-13,-0.58,2222,-15,-0.67,2173,2278
رنيك,جنرال مكانيك,546,3200231,50085569960,16100,16030,15500,-600,-3.73,15650,-450,-2.8,15440,16070
قشرين,قند شيرين خراسان,539,7239192,64712921670,9190,8960,9000,-190,-2.07,8940,-250,-2.72,8920,9110
كفرا,فراورده‌ هاي‌ نسوزايران‌,537,4068296,35896969420,8890,8680,9020,130,1.46,8820,-70,-0.79,8520,9090
كورز,ورزيران‌,537,78148,41913599100,522150,537800,537800,15650,3,536350,14200,2.72,509400,537800
وهور,مديريت انرژي اميد  تابان هور,536,14897998,21876907618,1499,1530,1459,-40,-2.67,1468,-31,-2.07,1455,1530
وايران,ليزينگ ايرانيان,528,6749651,28357822836,4144,4001,4309,165,3.98,4201,57,1.38,4001,4318
سپر,صندوق س سپر سرمايه بيدار- ثابت,526,19615663,326271838604,16622,16632,16632,10,0.06,16633,11,0.07,16632,16635
غشان,شيرپاستوريزه‌پگاه‌خراسان‌,525,3703796,25541978340,6850,6820,6850,0,0,6900,50,0.73,6700,7050
كحافظ,كاشي‌ وسراميك‌ حافظ‌,524,6922808,44568190350,6450,6260,6430,-20,-0.31,6440,-10,-0.16,6260,6600
ولتجار,واسپاري تجار ايرانيان,524,9658252,24550060824,2598,2534,2522,-76,-2.93,2542,-56,-2.16,2521,2598
ومشان,س. فني و مهندسي مشانير,518,608011,59971991400,100400,97400,97400,-3000,-2.99,98650,-1750,-1.74,97400,103400
زاگرس,پتروشيمي زاگرس,514,445496,60377108350,136250,134500,135200,-1050,-0.77,135550,-700,-0.51,133700,137800
ساروم,سيمان‌اروميه‌,513,1089874,33597106440,30760,30520,30930,170,0.55,30830,70,0.23,30300,31200
كپارس,كاشي‌ پارس‌,511,4776953,44707027100,9420,9150,9400,-20,-0.21,9360,-60,-0.64,9150,9700
سبهان,سيمان‌ بهبهان‌,509,859969,47406608980,56230,56500,55000,-1230,-2.19,55130,-1100,-1.96,53920,57250
تاصيكو,سرمايه گذاري صدرتامين,508,2678399,32705000240,12260,11900,12170,-90,-0.73,12250,-10,-0.08,11900,12300
بكاب,صنايع‌جوشكاب‌يزد,504,1557731,52336829890,31750,32390,34000,2250,7.09,33600,1850,5.83,32390,34000
وبوعلي,سرمايه‌گذاري‌بوعلي‌,500,10495330,28055224839,2691,2700,2666,-25,-0.93,2673,-18,-0.67,2630,2729
شنفت,نفت‌ پارس‌,499,3488434,27218312680,7880,7790,7900,20,0.25,7840,-40,-0.51,7700,7970
طخود1205,اختيارف خودرو-2000-1401/12/03,497,231660,2356325000,14,17,9,-5,-35.71,10,-4,-28.57,8,17
وتوصا,گروه س توسعه صنعتي ايران,496,2046430,16792503640,8260,8300,8200,-60,-0.73,8210,-50,-0.61,8040,8400
وفتخار,سرمايه گذاري افتخار سهام,495,5678004,20277129209,3527,3600,3608,81,2.3,3571,44,1.25,3527,3608
هم وزن,صندوق س. شاخصي كيان-س,492,8151784,98660573292,12266,12191,12092,-174,-1.42,12103,-163,-1.33,11900,12259
پيزد,مجتمع صنايع لاستيك يزد,491,3020292,48914552430,15460,16230,16090,630,4.08,16200,740,4.79,15450,16230
ونيكي,سرمايه‌گذاري‌ ملي‌ايران‌,490,3449309,23130025000,6920,6750,6700,-220,-3.18,6870,-50,-0.72,6650,6890
فروس,فروسيليس‌ ايران‌,490,9101610,60114852040,6760,6760,6560,-200,-2.96,6600,-160,-2.37,6500,6760
ضدي203,اختيارخ دي-600-14020217,489,76461,24926600000,343,321,342,-1,-0.29,326,-17,-4.96,317,362
ارفع,شركت آهن و فولاد ارفع,488,1130253,20786936380,18230,18600,18340,110,0.6,18270,40,0.22,18200,18680
بميلا,توسعه سرمايه گذاري ميلاد پارس,484,5076334,48350271080,9770,9910,9600,-170,-1.74,9520,-250,-2.56,9480,9910
تيپيكو,سرمايه گذاري دارويي تامين,483,1514762,39373649590,26060,26500,25880,-180,-0.69,26030,-30,-0.12,25800,26880
آباد,توريستي ورفاهي آبادگران ايران,482,1693755,48997211580,27750,27820,29130,1380,4.97,28930,1180,4.25,27820,29130
خليبل,ماليبل سايپا,482,1304384,34585599200,26600,25950,27350,750,2.82,26500,-100,-0.38,25850,27350
غگرجي,بيسكويت‌  گرجي‌,482,8663027,15575353819,1795,1780,1826,31,1.73,1798,3,0.17,1744,1838
سخاش,سيمان‌خاش‌,480,273354,20671333040,75430,76620,75290,-140,-0.19,75620,190,0.25,73780,78800
شپترو,پتروشيمي آبادان,480,8885051,16289637754,1828,1836,1839,11,0.6,1833,5,0.27,1791,1872
فرآور,فرآوري‌موادمعدني‌ايران‌,479,1285768,34644581940,27690,28000,27200,-490,-1.77,26940,-750,-2.71,26600,28000
غشوكو,شوكو پارس,472,7409585,66094736240,9180,9000,8910,-270,-2.94,8920,-260,-2.83,8910,9180
حفاري,حفاري شمال,471,6010858,26809440514,4463,4592,4482,19,0.43,4460,-3,-0.07,4434,4592
نفيس,صندوق س.پشتوانه طلاي صبا,471,2323109,27576521083,12451,12150,12007,-444,-3.57,11871,-580,-4.66,11600,12298
كقزوي,شيشه‌ قزوين‌,470,3965624,75071490470,19370,19700,19030,-340,-1.76,18930,-440,-2.27,18790,19700
غگلستا,شير پاستوريزه پگاه گلستان,469,1669781,27214788680,15950,16420,16200,250,1.57,16300,350,2.19,15700,16590
حبندرح,ح.دريايي وكشتيراني خط دريابندر,462,1767672,18674629990,10300,10190,10430,130,1.26,10560,260,2.52,10190,10600
آسيا,بيمه آسيا,462,14077049,26799381706,1895,1910,1917,22,1.16,1904,9,0.47,1882,1937
تپمپي,پمپ‌ سازي‌ ايران‌,461,2573092,59243555720,22710,22120,23500,790,3.48,23020,310,1.37,22120,23500
قزوين,كارخانجات‌ قند قزوين‌,455,6812762,42295828770,6460,6600,6140,-320,-4.95,6210,-250,-3.87,6140,6600
داسوه,داروسازي‌ اسوه‌,454,564771,28007098740,48580,48600,50890,2310,4.76,49590,1010,2.08,46500,50990
نيرو,نيرو سرمايه,453,1444786,48875368550,32950,33900,33900,950,2.88,33850,900,2.73,33300,33900
سيلام,سيمان‌ ايلام‌,452,5280154,63882023100,12150,12100,12220,70,0.58,12100,-50,-0.41,11800,12220
حآساح,ح.آسيا سير ارس,450,2973422,19145911400,6390,6220,6400,10,0.16,6440,50,0.78,6180,6600
كپرور,فرآوري زغال سنگ پروده طبس,446,4759666,44385850310,9650,9850,9480,-170,-1.76,9330,-320,-3.32,9200,9850
وسنا,سرمايه گذاري نيروگاهي ايران,445,2585926,22572764620,8970,8950,9180,210,2.34,8730,-240,-2.68,8710,9180
وسرمد,بيمه  سرمد,442,9188446,15128873832,1686,1646,1648,-38,-2.25,1647,-39,-2.31,1636,1687
كسعدي,كاشي‌ سعدي‌,441,2007444,22479460080,10710,10900,11240,530,4.95,11200,490,4.58,10560,11240
كساوه,صنايع‌ كاشي‌ و سراميك‌ سينا,439,709120,37274086100,53170,51150,51980,-1190,-2.24,52560,-610,-1.15,51150,53490
سخوز,سيمان خوزستان,439,629693,21992815910,35280,35280,34950,-330,-0.94,34930,-350,-0.99,33720,35430
اپرداز,آتيه داده پرداز,438,4413920,22748075070,5180,5220,5130,-50,-0.97,5150,-30,-0.58,5000,5260
شجم,صنايع پتروشيمي تخت جمشيد,437,2643690,21619204220,8510,8300,8170,-340,-4,8180,-330,-3.88,8090,8550
ضسپا1205,اختيارخ خساپا-2000-1401/12/10,436,72852,38007191000,514,560,560,46,8.95,522,8,1.56,470,564
غشصفا,شيرپاستوريزه‌پگاه‌اصفهان‌,435,769765,17073739890,21890,21500,22180,290,1.32,22180,290,1.32,21500,22700
واميد,گروه مديريت سرمايه گذاري اميد,435,3080865,40002670330,13110,12880,12920,-190,-1.45,13070,-40,-0.31,12880,13090
فردا,صندوق س آواي فرداي زاگرس-ثابت,434,29699196,448413323400,15087,15097,15099,12,0.08,15098,11,0.07,15097,15099
كگهر,سنگ آهن گهرزمين,434,174260,7767005600,45100,44050,44300,-800,-1.77,45050,-50,-0.11,44000,45050
بساما,بيمه سامان,432,3687227,42419332660,11470,11600,11550,80,0.7,11500,30,0.26,11360,11800
غفارس,شير پاستوريزه پگاه فارس,429,3143337,26827642340,8640,8400,8680,40,0.46,8530,-110,-1.27,8400,8700
فغدير,آهن و فولاد غدير ايرانيان,426,1231776,19654301520,16090,16450,16060,-30,-0.19,15960,-130,-0.81,15790,16450
وامير,گروه صنعتي و معدني امير,426,166733,52221135050,321950,331200,312350,-9600,-2.98,313200,-8750,-2.72,312300,331200
ثعتما,س. ساختماني اعتماد گستر,425,1337388,19078413450,14160,14450,14250,90,0.64,14270,110,0.78,13920,14450
واحيا,م .صنايع و معادن احياء سپاهان,425,6659688,102261348500,15790,15550,15320,-470,-2.98,15360,-430,-2.72,15320,15790
سرود,سيمان‌شاهرود,424,1424658,41879750070,29370,30540,29650,280,0.95,29400,30,0.1,28950,30540
ضستا1106,اختيارخ شستا-1100-1401/11/05,423,203783,266597000,5,2,1,-4,-80,1,-4,-80,1,3
سكارون,سيمان كارون,422,330291,20627869800,61050,62800,62850,1800,2.95,62450,1400,2.29,61500,62850
فوكا,فولاد كاويان,418,1684399,21917356760,13180,13000,13180,0,0,13060,-120,-0.91,12870,13200
داراب,پتروشيمي داراب,418,7971803,7983801383,1028,1002,1010,-18,-1.75,1005,-23,-2.24,998,1034
وصندوق,سرمايه‌گذاري‌صندوق‌بازنشستگي‌,417,1995725,29145634140,14760,14550,14680,-80,-0.54,14720,-40,-0.27,14490,14760
قمرو,قند مرودشت‌,416,1684499,19292511510,11650,11770,11400,-250,-2.15,11450,-200,-1.72,11320,11780
سصوفي,سيمان‌ صوفيان‌,415,2390111,59097415170,25010,25450,24970,-40,-0.16,24730,-280,-1.12,24010,25450
ثجوان,تامين مسكن جوانان,413,5275704,26626523590,4970,4850,5110,140,2.82,5050,80,1.61,4830,5110
رانفور,خدمات‌انفورماتيك‌,410,5324160,23659021747,4498,4450,4390,-108,-2.4,4478,-20,-0.44,4390,4669
تكشا,گسترش‌صنايع‌وخدمات‌كشاورزي‌,399,701274,18302809740,26840,26010,26160,-680,-2.53,26100,-740,-2.76,25500,27000
داوه,داروسازي آوه سينا,398,2796330,23171757070,8540,8600,8290,-250,-2.93,8290,-250,-2.93,7990,8650
مبين,مبين انرژي خليج فارس,397,1053361,33861239890,32190,32050,32200,10,0.03,32180,-10,-0.03,32030,32900
جهرم,پتروشيمي جهرم,395,11437308,10378438419,933,907,906,-27,-2.89,907,-26,-2.79,906,933
ضسپا1206,اختيارخ خساپا-2200-1401/12/10,393,53322,19715580000,354,419,409,55,15.54,370,16,4.52,330,419
پلاسك,پلاسكوكار,392,5056866,20913274133,4158,4290,4146,-12,-0.29,4136,-22,-0.53,4050,4290
رمپنا,گروه مپنا (سهامي عام),388,3171123,36848952610,11830,11420,11570,-260,-2.2,11760,-70,-0.59,11420,11830
ساراب,سيمان‌ داراب‌,388,813613,20839602220,24990,26300,25400,410,1.64,25610,620,2.48,24310,26600
وسپه,سرمايه‌گذاري‌ سپه‌,385,5895798,28753709200,4866,4831,4867,1,0.02,4873,7,0.14,4831,4920
سپاها,سيمان‌سپاهان‌,384,2350709,28794399580,12370,12640,12240,-130,-1.05,12250,-120,-0.97,12080,12640
شكلر,نيروكلر,383,1220582,35984768710,30290,29700,29500,-790,-2.61,29480,-810,-2.67,29160,30000
كنور,توسعه معدني و صنعتي صبانور,383,1304667,23034092000,17250,17640,17590,340,1.97,17350,100,0.58,16800,18000
وسبحان,سرمايه گذاري سبحان,377,9056692,20248045923,2193,2200,2211,18,0.82,2236,43,1.96,2170,2289
سمتاز,سيمان ممتازان كرمان,375,1409898,53325395750,37700,38800,36700,-1000,-2.65,37800,100,0.27,36600,38800
فافزا,فولاد افزا سپاهان,375,885573,36354066250,40250,40150,41150,900,2.24,41050,800,1.99,39300,41450
ساذري,آذريت‌,374,2710720,20886070260,7920,7690,7800,-120,-1.52,7700,-220,-2.78,7690,7890
دتماد,توليدمواداوليه‌داروپخش‌,373,931900,36096740340,38830,39390,38590,-240,-0.62,38730,-100,-0.26,38310,39390
فجام,جام‌دارو,372,1968870,10950830460,5530,5720,5550,20,0.36,5550,20,0.36,5500,5720
دقاضي,داروسازي شهيد قاضي,371,1377515,26596726800,18910,19470,18850,-60,-0.32,19310,400,2.12,18550,19470
آرام,صندوق س شاخصي آرام مفيد,370,2187565,25555616030,11760,11770,11660,-100,-0.85,11680,-80,-0.68,11580,11770
دپارس,پارس‌ دارو,369,1368431,57940814930,40510,41550,42000,1490,3.68,42340,1830,4.52,41550,42530
واحصا,احياء صنايع خراسان,369,259607,16661870600,65950,64050,64000,-1950,-2.96,64200,-1750,-2.65,64000,65900
تپسي,پيشگامان فن آوري و دانش آراميس,369,8246730,42212706740,4910,4900,5150,240,4.89,5120,210,4.28,4900,5150
دجابر,داروسازي‌ جابرابن‌حيان‌,368,1744330,22939717170,13370,13020,13250,-120,-0.9,13150,-220,-1.65,12850,13370
سبجنو,سيمان‌ بجنورد,367,994966,41742991520,43830,42550,42000,-1830,-4.18,41950,-1880,-4.29,41640,43610
فافق,صنايع مس افق كرمان,366,5465305,27134603760,5070,5000,5010,-60,-1.18,4960,-110,-2.17,4920,5070
رفاه,فروشگاه هاي زنجيره اي رفاه,364,212999,69085411200,314950,324350,324350,9400,2.98,324350,9400,2.98,324000,324350
آفاق,صندوق س نوع دوم افق آتي-ثابت,363,15509903,155518592921,10020,10027,10027,7,0.07,10027,7,0.07,10027,10028
باران,بيمه زندگي باران,361,4591610,17751559489,3777,3879,3862,85,2.25,3866,89,2.36,3773,3888
لبوتان,گروه‌صنعتي‌بوتان‌,360,2001406,26148051490,12460,13000,13080,620,4.98,13060,600,4.82,12700,13080
ولراز,ليزينگ رازي,355,1143664,29000554100,26100,25750,25400,-700,-2.68,25350,-750,-2.87,25350,25750
سخزر,سيمان‌ خزر,353,1266807,37731713790,29360,29000,29330,-30,-0.1,29780,420,1.43,28420,30600
ثشرق,سرمايه گذاري مسكن شمال شرق,351,4244600,20703264576,4829,4990,4850,21,0.43,4878,49,1.01,4768,4990
پكرمان,گروه‌ صنعتي‌ بارز,351,1709434,34228406730,20530,20890,19830,-700,-3.41,20020,-510,-2.48,19700,20890
ضستا1205,اختيارخ شستا-1000-1401/12/03,350,68055,6006935000,102,90,95,-7,-6.86,88,-14,-13.73,80,100
شزنگ,تجهيزنيروي‌زنگان‌,350,383000,28473360750,72900,74350,74350,1450,1.99,74350,1450,1.99,73550,74350
شفارا,پتروشيمي فارابي,347,14943606,88634725010,5770,5740,5940,170,2.95,5930,160,2.77,5740,5940
قجام,فرآوردههاي غذايي وقندتربت‌جام‌,347,3856063,29845927620,7970,7740,7740,-230,-2.89,7740,-230,-2.89,7740,7740
فخاس,فولاد خراسان,345,1288451,14323300600,11360,11360,11150,-210,-1.85,11330,-30,-0.26,10930,11360
كسرام,پارس‌ سرام‌,343,2571082,15842884330,6140,6020,6100,-40,-0.65,6160,20,0.33,6020,6330
سباقر,سيمان باقران,339,2295453,34428844820,15150,15150,14710,-440,-2.9,15000,-150,-0.99,14700,15600
وتعاون,بيمه تعاون,339,7999731,13919704124,1794,1749,1732,-62,-3.46,1740,-54,-3.01,1720,1789
تپكو,توليدتجهيزات‌سنگين‌هپكو,338,8477816,15022689952,1721,1772,1772,51,2.96,1772,51,2.96,1772,1772
وسديد,گروه ‌صنعتي‌سديد,331,13506191,38398101013,2761,2843,2843,82,2.97,2843,82,2.97,2843,2843
وتوكا,سرمايه‌گذاري‌توكافولاد(هلدينگ,328,1730305,15618146360,9040,8950,9000,-40,-0.44,9030,-10,-0.11,8910,9210
فبيرا,بسته‌ بندي‌ ايران‌,327,10311249,21221371477,2002,1981,2061,59,2.95,2058,56,2.8,1981,2062
پاسا,ايران‌ياساتايرورابر,325,1460529,15504512150,10640,10950,10600,-40,-0.38,10620,-20,-0.19,10300,10950
ثامان,سامان‌ گستراصفهان‌,323,934448,15086556050,16280,16400,16540,260,1.6,16150,-130,-0.8,15500,16670
سفارود,كارخانه فارسيت درود,319,1076976,13865491030,13120,13010,12860,-260,-1.98,12870,-250,-1.91,12860,13380
ثتوسا,س.توسعه و عمران استان اردبيل,316,1236157,23145928410,19280,19570,18710,-570,-2.96,18720,-560,-2.9,18710,19570
ما,بيمه  ما,315,3750939,12092799797,3283,3202,3178,-105,-3.2,3234,-49,-1.49,3150,3350
كخاك,صنايع‌خاك‌چيني‌ايران‌,313,5177631,77890082770,14970,15100,15350,380,2.54,15040,70,0.47,14850,15450
بفجر,فجر انرژي خليج فارس,313,1599462,33551875800,21030,21050,21000,-30,-0.14,21010,-20,-0.1,20810,21050
زيتون,صندوق س زيتون نماد پايا- مختلط,312,903959,12944870180,14340,14330,14310,-30,-0.21,14320,-20,-0.14,14290,14350
پسهند,صنايع‌ لاستيكي‌  سهند,311,1244484,49517677920,39040,39040,39750,710,1.82,39790,750,1.92,38580,40330
پاكشو,گروه صنعتي پاكشو,310,1462599,9078456890,6370,6330,6220,-150,-2.35,6360,-10,-0.16,6160,6330
پرديس,سرمايه گذاري پرديس,310,7052648,26142628644,3724,3660,3700,-24,-0.64,3707,-17,-0.46,3660,3773
فلامي,لاميران‌,309,997995,24494797340,23430,24600,24600,1170,4.99,24540,1110,4.74,24010,24600
شخارك,پتروشيمي‌ خارك‌,308,296895,11735844040,40360,39650,39410,-950,-2.35,40260,-100,-0.25,39230,40300
دروز,داروسازي‌ روزدارو,308,988405,22180435570,22630,23200,22260,-370,-1.63,22440,-190,-0.84,21830,23200
ومعلم,بيمه معلم,306,4788051,9081889149,1874,1851,1895,21,1.12,1888,14,0.75,1840,1933
قتربت,قند تربت حيدريه,306,810286,15688129040,19420,19150,19130,-290,-1.49,19360,-60,-0.31,19000,19930
تبرك,گروه كارخانجات صنعتي تبرك,306,1481293,14838990020,10040,10100,10000,-40,-0.4,10020,-20,-0.2,9810,10180
سلار,شركت سيمان لارستان,303,878291,24130557000,26700,27500,27500,800,3,27450,750,2.81,27000,27500
ضجار2022,اختيارخ وتجارت-1500-1402/02/20,301,37732,17799104000,543,549,498,-45,-8.29,472,-71,-13.08,435,549
ضستا1206,اختيارخ شستا-1100-1401/12/03,300,90427,4534895000,60,72,53,-7,-11.67,50,-10,-16.67,46,72
گنج2,صندوق س. طلا كيميا زرين كاردان,294,2933241,2933241,18781,1,1,-18780,-99.99,1,-18780,-99.99,1,1
ركيش,كارت اعتباري ايران كيش,293,4679584,14480752037,3121,3073,3070,-51,-1.63,3094,-27,-0.87,3060,3187
دسانكوح,ح . داروسازي سبحان انكولوژي,292,1892892,9228996588,4752,4950,4902,150,3.16,4876,124,2.61,4612,5000
ضخود1206,اختيارخ خودرو-2200-1401/12/03,288,44331,41379010000,993,900,950,-43,-4.33,933,-60,-6.04,870,954
اتكاي,بيمه اتكايي ايرانيان,287,4373037,28150714960,6170,6020,6470,300,4.86,6440,270,4.38,6020,6470
لوتوس,تامين سرمايه لوتوس پارسيان,286,1701771,8495623141,4989,5029,5000,11,0.22,4990,1,0.02,4939,5029
ضستا6004,اختيارخ شستا-865-1402/06/08,284,50954,17204490000,344,350,339,-5,-1.45,338,-6,-1.74,332,350
درازي,پخش رازي,281,979263,23395624450,25000,25200,23850,-1150,-4.6,23900,-1100,-4.4,23250,25750
بنيرو,نيروترانس‌,280,2850349,8569693358,3137,3005,3010,-127,-4.05,3057,-80,-2.55,2950,3096
دابور,داروسازي‌ ابوريحان‌,279,868674,16496806300,19190,19690,19250,60,0.31,18990,-200,-1.04,18700,19690
غپونه,نوش پونه مشهد,275,875781,14254374720,16800,16050,16150,-650,-3.87,16320,-480,-2.86,16050,16590
واتي,سرمايه‌ گذاري‌ آتيه‌ دماوند,275,1689444,18110659750,10700,10520,10600,-100,-0.93,10720,20,0.19,10520,10910
غگلپا,شير پاستوريزه پگاه گلپايگان,274,299574,18559144700,61850,61850,62050,200,0.32,61950,100,0.16,60500,63200
كوثر,بيمه كوثر,269,5119760,24070647505,4735,4625,4745,10,0.21,4702,-33,-0.7,4625,4820
وتوسم,سرمايه‌گذاري‌توسعه‌ملي‌,268,3047643,15549304680,5140,5110,5100,-40,-0.78,5100,-40,-0.78,5040,5160
دارو,كارخانجات‌داروپخش‌,264,1190725,25493313630,21370,21500,21460,90,0.42,21410,40,0.19,21330,21640
آساميد,صندوق س.مشترك آسمان اميد -د,264,8748603,149506708836,17080,17090,17091,11,0.06,17089,9,0.05,17089,17091
ضستا1105,اختيارخ شستا-1000-1401/11/05,259,94972,1632679000,28,25,20,-8,-28.57,17,-11,-39.29,14,25
ماني,صندوق س. با درآمد ثابت ماني,258,12737381,170699969307,13393,13401,13401,8,0.06,13401,8,0.06,13401,13402
كصدف,كاشي صدف سرام استقلال آباده,257,398609,10595256500,26300,26900,26950,650,2.47,26600,300,1.14,26100,26950
كترام,توليدي‌ كاشي‌ تكسرام‌,255,11356403,106863752230,8970,9410,9410,440,4.91,9410,440,4.91,9410,9410
كاسپين,داروسازي كاسپين تامين,254,1926150,30074543570,15700,15120,15700,0,0,15610,-90,-0.57,15120,15900
تايرا,تراكتورسازي‌ايران‌,254,567688,15662037380,28030,28000,27400,-630,-2.25,27830,-200,-0.71,27210,28000
كشرق,صنعتي و معدني شمال شرق شاهرود,254,62181,6762782050,112650,111500,109250,-3400,-3.02,110900,-1750,-1.55,106700,113150
وارس,سرمايه گذاري ارس صبا,249,1232730,21789691180,18030,17520,18000,-30,-0.17,17680,-350,-1.94,17490,18220
دسبحا,گروه دارويي سبحان,248,1200196,12750188340,10670,10890,10490,-180,-1.69,10650,-20,-0.19,10290,10890
گپارس,امور رفاهي كارگزاران پارس,245,183907,26135826400,139200,135200,141900,2700,1.94,142100,2900,2.08,135050,143350
تپولا,مهندسي مرآت پولاد,242,1194197,22860803690,19400,19600,18860,-540,-2.78,19140,-260,-1.34,18820,19600
وحكمت,بيمه حكمت صبا,242,7663911,13796678928,1813,1760,1814,1,0.06,1800,-13,-0.72,1760,1833
ضستا0105,اختيارخ شستا-1100-1402/01/09,241,112265,9263261000,91,84,81,-10,-10.99,83,-8,-8.79,80,92
زپارس,ملي كشت و صنعت و دامپروري پارس,239,320920,23007639310,72110,72240,70550,-1560,-2.16,71870,-240,-0.33,70000,72490
شدوص,دوده‌ صنعتي‌ پارس‌,238,1363329,17547300530,12990,12800,12840,-150,-1.15,12870,-120,-0.92,12750,13050
وكادو,تكادو,238,649521,12173409510,18740,18400,19170,430,2.29,18740,0,0,18400,19170
فولاي,صنايع فولاد آلياژي يزد,237,5581396,35681864628,5975,6393,6393,418,7,6393,418,7,6393,6393
وتوشه,سرمايه‌ گذاري‌ پارس‌ توشه‌,236,2907197,16597611290,5770,5650,5710,-60,-1.04,5710,-60,-1.04,5470,5850
هجرت,پخش هجرت,232,1483352,45714116950,30850,30150,30950,100,0.32,30800,-50,-0.16,30150,31450
سجام,مجتمع سيمان غرب آسيا,229,3213895,7328872896,2306,2307,2285,-21,-0.91,2287,-19,-0.82,2240,2321
تسه0011,امتيازتسهيلات مسكن بهمن 1400,228,2800,3424118400,1224752,1220000,1230000,5248,0.43,1222899,-1853,-0.15,1190000,1260000
سلام,صندوق س سلام فارابي-سهام,228,7655241,84881350530,11120,11120,11080,-40,-0.36,11090,-30,-0.27,11040,11180
جم پيلن,پتروشيمي جم پيلن,228,134296,19174958160,141940,145360,142650,710,0.5,142100,160,0.11,141950,145360
وبشهر,توسعه‌ صنايع‌ بهشهر(هلدينگ,228,2470821,17537607110,7290,7120,7190,-100,-1.37,7210,-80,-1.1,7020,7310
ثنظام,س. ساختماني نظام مهندسي ايران,226,679395,36873176850,52750,54150,54300,1550,2.94,54250,1500,2.84,54000,54300
فاهواز,نورد و لوله اهواز,225,2392787,10428008984,4429,4384,4350,-79,-1.78,4358,-71,-1.6,4341,4429
سفانو,سيمان فارس نو,225,466408,29000732200,62800,60600,61320,-1480,-2.36,62180,-620,-0.99,60600,64200
غمهرا,توليدي‌مهرام‌,224,1875496,16164856230,8240,8600,8650,410,4.98,8610,370,4.49,8350,8650
رافزا,رايان هم افزا,223,176779,11605362600,66850,66350,65400,-1450,-2.17,65650,-1200,-1.8,64800,66350
فراز,صندوق س.سهام فراز داريك-س,222,3157737,57710445716,18261,18399,18264,3,0.02,18276,15,0.08,18261,18400
گوهران,سرمايه گذاري توسعه گوهران اميد,222,2024018,9951496900,4923,4857,4929,6,0.12,4919,-4,-0.08,4857,4970
حسينا,توسعه خدمات دريايي وبندري سينا,221,1016799,11034623920,11030,10800,10850,-180,-1.63,10850,-180,-1.63,10740,11030
تسه1400,امتيازتسهيلات مسكن سال1400,221,2694,3305509033,1219376,1220000,1234000,14624,1.2,1226989,7613,0.62,1220000,1260000
فماك,ماداكتو استيل كرد,220,2567242,41793833080,15520,16190,16290,770,4.96,16280,760,4.9,16000,16290
آبين,كشت و صنعت آبشيرين,219,4154516,40631166480,9500,9780,9780,280,2.95,9530,30,0.32,9780,9780
شفا,سرمايه گذاري شفادارو,216,1061046,19049508160,18150,18000,17890,-260,-1.43,17960,-190,-1.05,17800,18150
دعبيد,لابراتوارداروسازي‌  دكترعبيدي‌,216,838880,11552706510,14090,14100,13730,-360,-2.56,14040,-50,-0.35,13650,14100
وايرا,سرمايه گذاري صنايع ايران,211,5402863,11390541749,2164,2144,2110,-54,-2.5,2108,-56,-2.59,2100,2145
وجامي,سرمايه گذاري جامي,210,5638526,22705170144,3911,4019,4028,117,2.99,4027,116,2.97,4000,4028
شرانل,نفت ايرانول,206,202246,12538398200,61800,61450,62050,250,0.4,61850,50,0.08,61400,62700
كمينا,شيشه سازي مينا,206,1873770,17669651100,9720,9430,9430,-290,-2.98,9430,-290,-2.98,9430,9430
ثاژن,سخت آژند,205,3335450,16076889620,4910,4820,4820,-90,-1.83,4820,-90,-1.83,4820,4830
ضسپا1207,اختيارخ خساپا-2400-1401/12/10,205,26263,6333576000,218,220,274,56,25.69,241,23,10.55,211,274
سهرمز,سيمان‌هرمزگان‌,205,442019,12743429120,28550,28200,28820,270,0.95,28780,230,0.81,28200,29500
اوصتا,صندوق انديشه ورزان صباتامين -د,202,42832025,1121699741725,26171,26188,26188,17,0.06,26188,17,0.06,26188,26189
ثتران,سرمايه گذاري مسكن تهران,202,8315166,44028803970,5043,5295,5295,252,5,5295,252,5,5295,5295
حاريا,كشتيراني آريا,199,1880626,10978756770,5730,5640,5840,110,1.92,5840,110,1.92,5640,5840
سمازن,سيمان‌مازندران‌,194,929908,15618542960,16890,16990,16600,-290,-1.72,16800,-90,-0.53,16440,17230
كاريس,صندوق س.سپند كاريزما-س,192,23486484,407455145659,17461,17299,17320,-141,-0.81,17348,-113,-0.65,17210,17455
پرداخت,به پرداخت ملت,191,440509,5131192500,11850,12110,11650,-200,-1.69,11820,-30,-0.25,11520,12110
سغرب,سيمان‌غرب‌,189,710410,17982808390,25050,24510,26180,1130,4.51,25310,260,1.04,24500,26200
بايكا,كارخانجات كابلسازي ‌ايران‌,188,889189,15252392650,17610,17110,17090,-520,-2.95,17150,-460,-2.61,17090,17940
تابا,تابان نيرو سپاهان,188,393659,9910839300,25900,25300,25150,-750,-2.9,25200,-700,-2.7,25150,25400
فكمند,گسترش قطعه سازي كمند,186,2248487,102081309800,44100,45400,45400,1300,2.95,45400,1300,2.95,45400,45400
قيستو,شركت قند بيستون,186,521125,12692354700,25050,24350,24300,-750,-2.99,24350,-700,-2.79,24300,25800
ضشنا1106,اختيارخ شپنا-7000-1401/11/19,185,14612,10648662000,833,885,700,-133,-15.97,729,-104,-12.48,692,885
دهدشت,صنايع پتروشيمي دهدشت,184,3791958,44742130120,11460,11800,11800,340,2.97,11800,340,2.97,11380,11800
كيان2,صندوق س. با درآمد ثابت كيان,181,18100000,18100000,39985,1,1,-39984,-100,1,-39984,-100,1,1
كتوكا,توليدي و خدمات صنايع نسوز توكا,180,1918522,22657744820,11040,11810,11810,770,6.97,11810,770,6.97,11810,11810
وآفري,بيمه كارآفرين,178,3039635,8319513656,2819,2770,2735,-84,-2.98,2767,-52,-1.84,2735,2800
وزمين,بانك ايران زمين,175,3188143,23879191070,7350,7490,7490,140,1.9,7490,140,1.9,7490,7490
تسه9911,امتياز تسهيلات مسكن بهمن99,172,2313,2833267427,1238382,1231100,1222000,-16382,-1.32,1224932,-13450,-1.09,1200022,1240002
تكنار,مجتمع معادن مس تكنار,172,197764,12506407850,64400,63100,63700,-700,-1.09,63250,-1150,-1.79,62900,64250
دشيمي,شيمي‌ داروئي‌ داروپخش‌,171,738905,17785443350,25330,24070,24070,-1260,-4.97,24070,-1260,-4.97,24070,24070
پاداش,صندوق س. ارزش پاداش-د,169,9489423,97445860048,10262,10269,10269,7,0.07,10269,7,0.07,10268,10269
مدير,ص.س.مديريت ثروت ص.بازنشستگي-س,168,1660078,19936893217,12115,12116,12037,-78,-0.64,12010,-105,-0.87,11800,12199
ممسني,پتروشيمي ممسني,167,3246643,40560494260,12570,12300,12910,340,2.7,12490,-80,-0.64,12300,12910
تسه9912,امتياز تسهيلات مسكن اسفند99,166,1684,2102839474,1269041,1274999,1251003,-18038,-1.42,1248717,-20324,-1.6,1235069,1274999
پلوله,گازلوله‌,165,871040,26275218500,31000,31750,30100,-900,-2.9,30150,-850,-2.74,30100,31750
سغدير,توسعه سرمايه و صنعت غدير,162,788986,5473787170,7020,7090,6930,-90,-1.28,7000,-20,-0.28,6780,7150
آوند2,صندوق س. آوند مفيد-د,161,16009400,16009400,11047,1,1,-11046,-99.99,1,-11046,-99.99,1,1
تسه0009,امتيازتسهيلات مسكن آذر 1400,157,1591,1943365329,1217127,1210100,1217000,-127,-0.01,1221474,4347,0.36,1210000,1260000
وآفر,سرمايه گذاري ارزش آفرينان,157,624212,16427489900,26000,26200,26100,100,0.38,26300,300,1.15,25800,26650
غنيلي,مجتمع توليدي نيلي صنعت كرمان,155,3648900,20871708000,5450,5720,5720,270,4.95,5720,270,4.95,5720,5720
گوهرانح,ح . س. توسعه گوهران اميد,154,1189736,3149514084,2725,2614,2650,-75,-2.75,2647,-78,-2.86,2614,2729
سپيدما,صندوق س. سپيد دماوند-د,153,47108041,678528355798,14395,14403,14404,9,0.06,14404,9,0.06,14403,14404
قپيرا,فرآورده‌هاي‌غدايي‌وقندپيرانشهر,153,787140,6963058250,8770,8820,8780,10,0.11,8810,40,0.46,8650,8920
لخانه,لوازم‌ خانگي‌ پارس‌,151,513986,10792885600,20390,21000,21000,610,2.99,20970,580,2.84,20980,21000
بسويچ,پارس‌سويچ‌,151,1780142,8376266870,4610,4620,4700,90,1.95,4660,50,1.08,4600,4740
تسه0006,امتيازتسهيلات مسكن شهريور1400,150,2816,3444548212,1212358,1250000,1210002,-2356,-0.19,1223206,10848,0.89,1190000,1272975
قشهد,شهد,149,293704,4654448650,16230,15650,15850,-380,-2.34,16110,-120,-0.74,15560,16200
كايتا,ايتالران‌,147,109748,3962251900,35100,36100,36150,1050,2.99,35500,400,1.14,35500,36150
واعتبار,سرمايه گذاري اعتبار ايران,146,3744886,10649972531,2941,2889,2828,-113,-3.84,2869,-72,-2.45,2800,2907
كازرو,پتروشيمي كازرون,145,2066413,25897180630,12440,12470,12540,100,0.8,12530,90,0.72,12310,12810
ارزش,صندوق س ارزش آفرين بيدار-سهام,145,416940,5771783470,14000,13870,13850,-150,-1.07,13840,-160,-1.14,13790,13990
ضستا1204,اختيارخ شستا-900-1401/12/03,144,19347,2740067000,178,187,160,-18,-10.11,142,-36,-20.22,121,187
فروسيل,فروسيليسيم خمين,144,472964,8639675080,18360,18000,18380,20,0.11,18270,-90,-0.49,17970,18440
شاملا,معدني‌ املاح‌  ايران‌,141,779344,9123705100,11860,11600,11800,-60,-0.51,11760,-100,-0.84,11570,11900
داريك,صندوق س.اعتماد داريك-د,139,6796069,98539491195,14479,14499,14501,22,0.15,14499,20,0.14,14499,14501
زعف0210پ11,زعفران0210نگين سحرخيز(پ),139,68774,22562382743,335206,342000,324551,-10655,-3.18,328066,-7140,-2.13,323130,342000
زعف0210پ05,زعفران0210نگين زرين(پ),136,67705,21834251510,327541,328500,318663,-8878,-2.71,322491,-5050,-1.54,318111,328500
هامرز,صندوق س اعتماد هامرز-ثابت,136,9013182,91206059095,10114,10119,10120,6,0.06,10119,5,0.05,10119,10120
ضسپا1208,اختيارخ خساپا-2600-1401/12/10,131,28744,4387523000,148,132,175,27,18.24,153,5,3.38,130,178
تاتمس,كارخانجات صنعتي وتوليدي اتمسفر,131,55105,6387196900,114950,114500,115900,950,0.83,115900,950,0.83,114500,117200
خاتم,صندوق س خاتم ايساتيس پويا-ثابت,130,3836000,59150235800,15410,15420,15420,10,0.06,15420,10,0.06,15419,15421
آتيمس,صندوق س.آرمان آتيه درخشان مس-س,129,56779,12357115938,211205,218103,220000,8795,4.16,217635,6430,3.04,213666,220000
شكبير,پتروشيمي اميركبير,129,196825,15807922400,82750,82750,80300,-2450,-2.96,82350,-400,-0.48,80300,82750
ساروج,بين المللي ساروج بوشهر,128,295547,7786353700,26200,25850,26750,550,2.1,26350,150,0.57,25800,26800
تسه0010,امتيازتسهيلات مسكن دي1400,126,1467,1784006428,1224004,1170003,1220000,-4004,-0.33,1216092,-7912,-0.65,1170003,1226000
نخل,صندوق س.خليج فارس-د,125,15248037,152863953416,10019,10026,10026,7,0.07,10025,6,0.06,10025,10026
كاج,صندوق س. نوع دوم نو ويرا -د,125,12548142,133018886414,10595,10601,10601,6,0.06,10601,6,0.06,10600,10601
ضخود1210,اختيارخ خودرو-3000-1401/12/03,125,18554,5515909000,307,290,360,53,17.26,297,-10,-3.26,260,394
ضخود1208,اختيارخ خودرو-2600-1401/12/03,124,13950,7652556000,531,589,633,102,19.21,549,18,3.39,510,633
ويسا,سرمايه گذاري ايساتيس پويا,124,494650,2996271000,6130,6010,6100,-30,-0.49,6110,-20,-0.33,5990,6230
ضملت3020,اختيارخ وبملت-2227-1402/03/28,122,24300,27511538000,1177,1144,1120,-57,-4.84,1132,-45,-3.82,1093,1157
ضسپا1209,اختيارخ خساپا-2800-1401/12/10,122,33408,3595266000,103,102,124,21,20.39,108,5,4.85,98,124
آساس,صندوق س.آسمان آرماني سهام-س,122,90268,22871987084,254640,252010,254500,-140,-0.05,253379,-1261,-0.5,251552,256045
سيدكو,سرمايه گذاري توسعه صنايع سيمان,120,660228,6529914080,10060,9820,9840,-220,-2.19,10010,-50,-0.5,9760,10100
وسالت,بانك قرض الحسنه رسالت,119,135629,8748070500,66450,64500,64500,-1950,-2.93,64500,-1950,-2.93,64500,64500
زعف0210پ20,زعفران0210نگين وحدت جام(پ),118,59222,18985652274,330337,330000,319994,-10343,-3.13,320584,-9753,-2.95,313989,330000
سخند,صندوق س.سپهرخبرگان نفت-د,118,596807,5509342457,9149,9196,9236,87,0.95,9231,82,0.9,9196,9288
مارون,پتروشيمي مارون,117,40207,7499899850,181100,186000,186950,5850,3.23,181500,400,0.22,183600,188000
ضستا1207,اختيارخ شستا-1200-1401/12/03,115,22186,548892000,40,20,26,-14,-35,25,-15,-37.5,19,34
رشد,صندوق س.رشد پايدار آبان-د,114,5364367,53801766207,10023,10033,10033,10,0.1,10029,6,0.06,10028,10033
ضستا6003,اختيارخ شستا-765-1402/06/08,113,28193,11280302000,398,356,405,7,1.76,400,2,0.5,356,405
سنوين,سرمايه گذاري اقتصاد نوين,112,2149487,13240839920,5990,6160,6160,170,2.84,6160,170,2.84,6160,6160
حپارسا,توسعه حمل و نقل ريلي پارسيان,112,227524,11461855400,51200,51700,50500,-700,-1.37,50400,-800,-1.56,49400,51700
ضخاو1207,اختيارخ وخاور-5000-1401/12/01,110,16835,1234174000,75,75,75,0,0,73,-2,-2.67,70,97
كاردان,صندوق س تجارت شاخصي كاردان,109,40001,9989896610,252150,250000,250500,-1650,-0.65,249740,-2410,-0.96,247650,252000
سقاين,سيمان‌ قائن‌,108,77081,4007759670,52200,52200,51810,-390,-0.75,52140,-60,-0.11,51400,53520
سپ,پرداخت الكترونيك سامان كيش,105,83866,1385164950,16930,16360,16580,-350,-2.07,16920,-10,-0.06,16360,16750
ضستا0106,اختيارخ شستا-1200-1402/01/09,105,32013,2294702000,80,53,68,-12,-15,72,-8,-10,53,99
انار,صندوق س.انارنماد ارزش-درسهام,105,232528,3144504850,13590,13600,13470,-120,-0.88,13520,-70,-0.52,13460,13600
وشهر,بانك شهر,104,1843682,11983933000,6320,6500,6500,180,2.85,6370,50,0.79,6500,6500
دفرا,فرآورده‌هاي‌ تزريقي‌ ايران‌,104,613829,16510418390,27040,27260,26150,-890,-3.29,26900,-140,-0.52,26120,27260
وامين,س. امين توان آفرين ساز,103,392020,4410342090,11360,11300,11240,-120,-1.06,11350,-10,-0.09,11240,11340
وكار,بانك‌ كارآفرين‌,103,1614049,5298107692,3253,3249,3270,17,0.52,3256,3,0.09,3249,3338
فخاسح,ح . فولاد خراسان,103,1671704,15688269800,9630,9410,9300,-330,-3.43,9380,-250,-2.6,9270,9600
شساخت,مهندسي و ساختمان صنايع نفت,103,140084,5246642150,38200,37400,37550,-650,-1.7,38100,-100,-0.26,37150,37850
زعف0210پ18,زعفران0210نگين بهرامن(پ),102,28085,8907104115,327206,330000,314200,-13006,-3.97,317148,-10058,-3.07,314200,330000
وحافظ,بيمه حافظ,101,4212833,14652233174,3377,3478,3478,101,2.99,3478,101,2.99,3478,3478
وپخش,داروپخش‌ (هلدينگ‌,99,61524,2472615360,40260,41470,39720,-540,-1.34,40260,0,0,39670,41470
كهرام,توليدي گرانيت بهسرام,97,78158,4401898500,57400,57600,56300,-1100,-1.92,56400,-1000,-1.74,56300,57600
گنج,صندوق س. طلا كيميا زرين كاردان,96,696348,12355028579,18781,18200,17725,-1056,-5.62,17743,-1038,-5.53,17500,18460
ضخود1212,اختيارخ خودرو-3500-1401/12/03,95,17366,1858477000,131,170,119,-12,-9.16,107,-24,-18.32,99,170
ضخود1207,اختيارخ خودرو-2400-1401/12/03,93,5723,4277894000,736,632,780,44,5.98,747,11,1.49,632,800
تسه0008,امتيازتسهيلات مسكن آبان1400,92,986,1202965924,1222449,1200000,1230000,7551,0.62,1220047,-2402,-0.2,1200000,1270000
تسه0007,امتيازتسهيلات مسكن مهر1400,90,650,793520075,1226439,1210000,1180002,-46437,-3.79,1220800,-5639,-0.46,1180002,1240000
تسه0001,امتيازتسهيلات مسكن فروردين1400,88,677,855286416,1263923,1260000,1255025,-8898,-0.7,1263348,-575,-0.05,1251000,1270000
داريوش,صندوق س. ثروت داريوش -س,88,9808519,128876768048,12575,12650,13030,455,3.62,13139,564,4.49,12549,13145
غناب,روغن‌ نباتي‌ ناب,88,12835,8166268750,655900,636250,636250,-19650,-3,636250,-19650,-3,636250,636250
ضستا1104,اختيارخ شستا-900-1401/11/05,88,39024,4687401000,130,177,120,-10,-7.69,120,-10,-7.69,108,177
پشاهن,توليدي پلاستيك‌ شاهين,88,49690,3279756950,67400,67400,66000,-1400,-2.08,66950,-450,-0.67,65400,67400
ضخود3072,اختيارخ خودرو-3500-1402/03/03,87,6737,2649641000,464,429,450,-14,-3.02,393,-71,-15.3,331,486
گنگين,اقتصادي نگين گردشگري ايرانيان,86,1241193,45215108750,36550,37350,35600,-950,-2.6,36450,-100,-0.27,35500,37350
تسه0005,امتيازتسهيلات مسكن مرداد 1400,85,1293,1564794589,1216877,1170000,1222012,5135,0.42,1210205,-6672,-0.55,1156038,1245000
سهگمت,سيمان‌هگمتان‌,85,126051,5446028610,42540,42700,42860,320,0.75,42760,220,0.52,42680,44100
تسه0002,امتيازتسهيلاتمسكن ارديبهشت1400,84,887,1114292972,1266432,1250000,1252388,-14044,-1.11,1256249,-10183,-0.8,1250000,1277333
سيستم,همكاران سيستم,84,391827,3021821400,7610,7550,7650,40,0.53,7620,10,0.13,7550,7790
حگهر,حمل و نقل گهرترابر سيرجان,83,182339,2103787930,11530,12070,11250,-280,-2.43,11540,10,0.09,11180,12070
ضستا1107,اختيارخ شستا-1200-1401/11/05,83,59175,59175000,1,1,1,0,0,1,0,0,1,1
لبخند2,صندوق س. لبخند فارابي-د,83,8300000,8300000,10910,1,1,-10909,-99.99,1,-10909,-99.99,1,1
گوهر2,صندوق سكه طلاي كيان,80,800000,800000,109228,1,1,-109227,-100,1,-109227,-100,1,1
ددام,داروسازي زاگرس فارمد پارس,77,801109,8932365350,10620,11150,11150,530,4.99,10910,290,2.73,11150,11150
وفتخارح,ح . سرمايه گذاري افتخار سهام,77,1785088,3120936603,1765,1743,1753,-12,-0.68,1748,-17,-0.96,1741,1762
ضستا0104,اختيارخ شستا-1000-1402/01/09,77,36131,4313085000,129,115,120,-9,-6.98,119,-10,-7.75,112,130
ضسپا1210,اختيارخ خساپا-3000-1401/12/10,76,14168,1144376000,100,55,86,-14,-14,81,-19,-19,55,99
اخزا101,اسناد خزانه-م1بودجه01-040326,76,296400,164498593000,554610,553030,555900,1290,0.23,554990,380,0.07,553010,555900
دشيري,شيرين دارو,75,45942,5276438700,111550,114850,114850,3300,2.96,113150,1600,1.43,114850,114850
ضجار2026,اختيارخ وتجارت-1900-1402/02/20,75,6830,1575603000,245,223,232,-13,-5.31,231,-14,-5.71,211,255
ارمغان,ص سرمايه گذاري ارمغان ايرانيان,75,4691490,47309218442,10080,10085,10084,4,0.04,10084,4,0.04,10084,10099
رايكا,صندوق س نوع دوم رايكا- ثابت	,75,2296162,24409300086,10623,10631,10631,8,0.08,10630,7,0.07,10630,10631
ولقمان,سرمايه گذاري لقمان,74,489578,2305342511,4666,4779,4666,0,0,4676,10,0.21,4666,4779
فيروزه,صندوق شاخص30 شركت فيروزه- سهام,73,150000,3099838930,21130,21000,20720,-410,-1.94,20670,-460,-2.18,20350,21270
ضجار2020,اختيارخ وتجارت-1300-1402/02/20,73,5381,3350413000,652,635,638,-14,-2.15,623,-29,-4.45,612,639
تسه0003,امتيازتسهيلات مسكن خرداد1400,71,511,632842118,1253413,1231000,1237222,-16191,-1.29,1238439,-14974,-1.19,1231000,1260000
زعف0210پ16,زعفران0210نگين بيرجند(پ),70,25381,7984426776,324968,322986,312501,-12467,-3.84,314583,-10385,-3.2,312500,323938
ضسپا1204,اختيارخ خساپا-1900-1401/12/10,69,6367,3990036000,629,540,650,21,3.34,627,-2,-0.32,540,680
ترمه,صندوق سرمايه گذاري ترمه-سهام	,68,225542,2431886980,10700,10800,10780,80,0.75,10780,80,0.75,10710,10800
سكرما,سيمان‌ كرمان‌,67,152901,2701196810,17930,17610,17700,-230,-1.28,17880,-50,-0.28,17530,17900
كارين2,صندوق س نگين سامان-ثابت,66,6246184,6246184,10018,1,1,-10017,-99.99,1,-10017,-99.99,1,1
ضخود1209,اختيارخ خودرو-2800-1401/12/03,66,9180,3681402000,394,320,469,75,19.04,401,7,1.78,320,469
درسا,صندوق سرمايه گذاري درسا - سهام,66,4738079,58983355520,12550,12350,12340,-210,-1.67,12450,-100,-0.8,12340,12450
تسه0004,امتيازتسهيلات مسكن تير1400,66,584,708097519,1219909,1180002,1210816,-9093,-0.75,1212496,-7413,-0.61,1180002,1221000
زعف0210پ09,زعفران0210نگين نوين(پ)	,65,30675,9733900927,324172,330000,314300,-9872,-3.05,317324,-6848,-2.11,312228,330000
صنم,ص.س.صندوق در صندوق صنم,65,21162930,281022532299,13440,13450,13279,-161,-1.2,13279,-161,-1.2,13200,13450
شكف,كف,65,55798,2229130100,40750,39950,39950,-800,-1.96,40400,-350,-0.86,39950,39950
شتولي,تولي‌پرس‌,65,172328,2882938500,16410,16730,16730,320,1.95,16590,180,1.1,16720,16730
اخزا001,اسنادخزانه-م1بودجه00-030821,63,131000,84663882000,645920,646000,648090,2170,0.34,646290,370,0.06,645920,648090
ضخود3070,اختيارخ خودرو-3000-1402/03/03,62,7497,4831799000,732,680,626,-106,-14.48,644,-88,-12.02,621,729
اراد103,مرابحه عام دولت103-ش.خ050821,62,7110000,7252200000000,1020000,1020000,1020000,0,0,1020000,0,0,1020000,1020000
ضستا6002,اختيارخ شستا-665-1402/06/08,62,13538,6204340000,461,450,464,3,0.65,458,-3,-0.65,408,464
اخزا002,اسنادخزانه-م2بودجه00-031024,61,48200,29849950000,618170,618400,620500,2330,0.38,619290,1120,0.18,618360,620890
فسا,پتروشيمي فسا,59,1611936,1581309216,953,981,981,28,2.94,957,4,0.42,981,981
ضهاي3009,اختيارخ هاي وب-3690-1402/03/03,58,598,176561920,286,269,400,114,39.86,272,-14,-4.9,250,400
ضستا6006,اختيارخ شستا-1065-1402/06/08,57,8671,1986252000,234,233,226,-8,-3.42,229,-5,-2.14,212,241
اخزا005,اسنادخزانه-م5بودجه00-030626,57,87900,58929274000,669810,669810,671000,1190,0.18,670410,600,0.09,669810,671000
هپارس029,اختيارف ت­ وپارس-2000-02/09/08,57,1285116,1285116,1,1,1,0,0,1,0,0,1,1
اخزا820,اسنادخزانه-م20بودجه98-020806,56,52900,44015202000,830180,834990,832110,1930,0.23,832050,1870,0.23,831900,836350
زعف0210پ10,زعفران0210نگين طلاي سرخ(پ),56,24251,8008894105,328304,339998,326000,-2304,-0.7,330250,1946,0.59,321250,339998
دريا,صندوق س درياي آبي فيروزه-سهام,55,68100,778138020,11370,11400,11420,50,0.44,11430,60,0.53,11400,11500
زعف0210پ08,زعفران0210نگين روستا(پ),54,26442,8389332102,325153,326000,314004,-11149,-3.43,317273,-7880,-2.42,313001,326000
اگ020555,گام بانك اقتصاد نوين0205,54,349813,299388650892,853654,856000,853400,-254,-0.03,855853,2199,0.26,853300,856000
بازده,صندوق س. بازده ثابت-د,54,7495241,77913871558,10390,10397,10394,4,0.04,10395,5,0.05,10394,10397
اخزا903,اسنادخزانه-م3بودجه99-011110,52,63200,62892253000,992770,993340,995540,2770,0.28,995130,2360,0.24,993340,996500
ضخاور1103,اختيارخ خاور-2200-14011109,52,3383,4587048000,1518,1400,1350,-168,-11.07,1356,-162,-10.67,1310,1430
ضخود1200,اختيارخ خودرو-1500-1401/12/03,51,24017,38489834000,1726,1670,1680,-46,-2.67,1603,-123,-7.13,1550,1680
آرمان,بيمه آرمان,51,1080998,5640528970,5280,5130,5300,20,0.38,5240,-40,-0.76,5130,5400
دحاوي,الحاوي,50,351472,4034898560,11150,11480,11480,330,2.96,11270,120,1.08,11480,11480
ضستا6001,اختيارخ شستا-565-1402/06/08,49,3493,1866629000,543,540,540,-3,-0.55,534,-9,-1.66,522,550
اخزا006,اسنادخزانه-م6بودجه00-030723,49,223700,147090319000,657490,656700,658000,510,0.08,657530,40,0.01,656700,658500
آوا,صندوق س.سهام آواي معيار-س,49,108783,1055242933,9878,9700,9650,-228,-2.31,9700,-178,-1.8,9630,9888
ضسپا3028,اختيارخ خساپا-2800-1402/03/24,49,26933,9751456000,401,350,379,-22,-5.49,362,-39,-9.73,350,379
شليا,شركت مواد ويژه ليا,47,530726,24094960400,44100,45400,45400,1300,2.95,45400,1300,2.95,45400,45400
سي تيپ2ن34,گواهي سيمان تيپ2ممتازان(ن),46,1441000,11287353000,7833,7833,7833,0,0,7833,0,0,7833,7833
ضستا1103,اختيارخ شستا-800-1401/11/05,46,10391,2179922000,223,191,220,-3,-1.35,210,-13,-5.83,191,220
قاروم,قند اروميه,46,4983,651868650,133300,131000,130750,-2550,-1.91,133100,-200,-0.15,130650,131450
ضهرم1205,اختيارخ اهرم-11000-1401/12/22,43,730,2518477000,3814,3333,3745,-69,-1.81,3450,-364,-9.54,3210,3747
اخزا0022,اسنادخزانه-م2بودجه00-031024,42,1552,957968230,618170,617000,617510,-660,-0.11,617250,-920,-0.15,615140,618000
ضخاور112,اختيارخ خاور-3900-14020116,42,11837,4895290000,1,450,430,429,42900,414,413,41300,310,450
ضستا1203,اختيارخ شستا-800-1401/12/03,42,4518,1021469000,263,220,242,-21,-7.98,226,-37,-14.07,210,250
طهاي3010,اختيارف هاي وب-4152-1402/03/03,40,36154,46323686352,517,1182,1182,665,128.63,1182,665,128.63,1182,1182
فجوش,جوش‌ و اكسيژن‌ ايران‌,40,319618,738317580,2381,2310,2310,-71,-2.98,2380,-1,-0.04,2310,2310
خبنيان,بنيان ديزل,40,152792,1605843920,10830,10510,10510,-320,-2.95,10830,0,0,10510,10510
ساحل,صندوق س.اوراق دولت خليج فارس-د,40,4616868,50762719105,10988,10995,10996,8,0.07,10995,7,0.06,10995,10996
يارا,صندوق س. آريا-د,40,4555182,58306679043,12792,12794,12800,8,0.06,12800,8,0.06,12794,12801
دارا,صندوق س. دارا الگوريتم-د,39,2309169,23142248967,10017,10021,10022,5,0.05,10022,5,0.05,10021,10022
تداوم,صندوق تداوم اطمينان تمدن-ثابت,39,8618806,87076224702,10099,10105,10105,6,0.06,10103,4,0.04,10103,10105
ضخود3068,اختيارخ خودرو-2600-1402/03/03,38,5034,4300665000,905,800,945,40,4.42,854,-51,-5.64,750,1060
نمرينو,ايران‌ مرينوس‌,38,40962,4992448560,116080,121880,121880,5800,5,117740,1660,1.43,121880,121880
اخزا0052,اسنادخزانه-م5بودجه00-030626,36,1412,943605410,669810,666450,668910,-900,-0.13,668280,-1530,-0.23,665010,669910
ضخاور1107,اختيارخ خاور-3000-14011109,36,3370,1972100000,711,600,550,-161,-22.64,585,-126,-17.72,550,600
فلات,گروه صنايع معادن فلات ايرانيان,35,314629,8856806350,27350,28150,28150,800,2.93,28000,650,2.38,28150,28150
افق ملت,صندوق س در سهام افق ملت,35,10258,1785582430,174750,174750,172500,-2250,-1.29,174070,-680,-0.39,172500,176350
ضخود2036,اختيارخ خودرو-4000-1402/02/13,35,9726,996031000,300,100,104,-196,-65.33,102,-198,-66,100,135
فاما,صنعتي‌ آما,35,240880,1883681600,7310,7820,7820,510,6.98,7370,60,0.82,7820,7820
طخود1207,اختيارف خودرو-2400-1401/12/03,34,10128,272914000,32,30,29,-3,-9.38,27,-5,-15.63,25,37
ضخود1214,اختيارخ خودرو-4000-1401/12/03,34,5547,306455000,51,40,60,9,17.65,55,4,7.84,40,100
ثاصفا,شركت‌ ساختمان‌ اصفهان‌,34,50360,830940000,16020,16500,16500,480,3,16060,40,0.25,16500,16500
اخزا004,اسنادخزانه-م4بودجه00-030522,34,143900,98608493000,684800,684810,685380,580,0.08,685260,460,0.07,684490,688000
نگين,ص.س. زمين و ساختمان نگين شهرري,32,13479,1069286910,79150,78990,79360,210,0.27,79330,180,0.23,77710,79970
ضهاي3000,اختيارخ هاي وب-1845-1402/03/03,32,1039,1265017160,1193,1134,1150,-43,-3.6,1123,-70,-5.87,1010,1190
ضسپا3027,اختيارخ خساپا-2600-1402/03/24,32,3702,1549689000,445,400,480,35,7.87,419,-26,-5.84,387,489
ضستا6005,اختيارخ شستا-965-1402/06/08,32,1989,540128000,278,280,279,1,0.36,272,-6,-2.16,240,280
طخود1206,اختيارف خودرو-2200-1401/12/03,31,8188,169630000,22,23,20,-2,-9.09,21,-1,-4.55,18,23
ضستا6010,اختيارخ شستا-1465-1402/06/08,31,2070,276375000,137,150,144,7,5.11,134,-3,-2.19,115,150
زعف0210پ19,زعفران0210نگين تروند قاينات(پ),30,8303,2630630500,325740,323000,314500,-11240,-3.45,316829,-8911,-2.74,314200,323000
حرهشا,رهشاد سپاهان (سهامي عام,30,26042,2877641000,107300,110500,110500,3200,2.98,108400,1100,1.03,110500,110500
رشد2,صندوق س.رشد پايدار آبان-د,29,2893635,2893635,10023,1,1,-10022,-99.99,1,-10022,-99.99,1,1
ولانا,شركت ليزينگ آريا دانا,29,96740,2413663000,24250,24950,24950,700,2.89,24400,150,0.62,24950,24950
قنقش,قند نقش جهان,28,14002,3333876200,245450,238100,238100,-7350,-2.99,243600,-1850,-0.75,238100,238100
زرين,صندوق س. سهام زرين كوروش-س,28,81033,1204636001,14886,14990,14960,74,0.5,14866,-20,-0.13,14851,14990
غدير05,اجاره غديرايرانيان14050114,28,3410000,3421463850000,982000,990000,1000000,18000,1.83,1003360,21360,2.18,990000,1008810
گنجينه,صندوق س. گنجينه داريوش-د,28,11064734,111100881018,10035,10041,10040,5,0.05,10041,6,0.06,10040,10041
اخزا910,اسنادخزانه-م10بودجه99-020807,28,11300,9400706000,831630,830110,839890,8260,0.99,831920,290,0.03,830110,839890
فبستم,صنايع ‌بسته‌بندي‌ مشهد,28,78715,1026443600,13440,13040,13040,-400,-2.98,13400,-40,-0.3,13040,13040
ضدي215,اختيارخ دي-1400-14020217,28,3399,357799000,90,199,92,2,2.22,105,15,16.67,80,150
ضخاور1104,اختيارخ خاور-2400-14011109,27,2101,2429800000,1313,1200,1150,-163,-12.41,1156,-157,-11.96,1150,1390
ضسپا3029,اختيارخ خساپا-3000-1402/03/24,26,2918,811000000,314,284,240,-74,-23.57,278,-36,-11.46,240,350
فالوم,آلومتك‌,26,304735,2989450350,9530,9810,9810,280,2.94,9610,80,0.84,9810,9810
عقيق,صندوق سرمايه گذاري عقيق-سهام,26,1186752,63281906240,52540,53280,53470,930,1.77,53320,780,1.48,51500,53470
ضخود1204,اختيارخ خودرو-1900-1401/12/03,26,2668,3088796000,1194,1100,1194,0,0,1158,-36,-3.02,1100,1194
سلام2,صندوق س سلام فارابي-سهام,25,250000,250000,11120,1,1,-11119,-99.99,1,-11119,-99.99,1,1
اخزا0062,اسنادخزانه-م6بودجه00-030723,25,898,589440050,657490,655240,656500,-990,-0.15,656390,-1100,-0.17,655240,657500
اخزا003,اسنادخزانه-م3بودجه00-030418,25,22400,15751456000,701430,701910,706000,4570,0.65,703190,1760,0.25,701910,706000
صايند,صندوق س. گنجينه آينده روشن-د,25,117874,1194121190,10141,10096,10140,-1,-0.01,10130,-11,-0.11,10096,10145
بتك,كارخانجات كابل سازي‌ تك‌,25,1025,378737500,377000,369500,369500,-7500,-1.99,376400,-600,-0.16,369500,369500
تكنو,تكنوتار,25,471023,5397923580,10920,11460,11460,540,4.95,11090,170,1.56,11460,11460
ضجار2027,اختيارخ وتجارت-2000-1402/02/20,25,739,135893000,208,201,199,-9,-4.33,184,-24,-11.54,160,217
ضخاور113,اختيارخ خاور-4100-14020116,23,4751,1605004000,423,350,345,-78,-18.44,338,-85,-20.09,301,350
اخزا904,اسنادخزانه-م4بودجه99-011215,23,84200,82063917000,973100,971410,973760,660,0.07,974630,1530,0.16,971410,979990
اخزا007,اسنادخزانه-م7بودجه00-030912,22,45100,28703886000,636350,637000,636510,160,0.03,636450,100,0.02,636350,637000
الماس,صندوق س.امين تدبيرگران فردا-س,21,4089,565777437,139107,142000,140000,893,0.64,138366,-741,-0.53,138000,142000
سپيدما2,صندوق س. سپيد دماوند-د,21,196000000,196000000,14395,1,1,-14394,-99.99,1,-14394,-99.99,1,1
اخزا0012,اسنادخزانه-م1بودجه00-030821,21,861,555011520,645920,645920,646910,990,0.15,644610,-1310,-0.2,641910,660000
اخزا010,اسناد خزانه-م10بودجه00-031115,21,39100,23864449700,609139,611600,610241,1102,0.18,610344,1205,0.2,610200,611600
سيناد,صندوق س.سپهرسودمند سينا-د,21,2691004,26996341467,10025,10032,10032,7,0.07,10032,7,0.07,10032,10033
ثنا,صندوق س.زرين نهال ثنا-س,21,59484,712388590,11677,12000,11700,23,0.2,11976,299,2.56,11700,12000
اخزا908,اسنادخزانه-م8بودجه99-020606,20,118400,102653446000,865490,864500,866010,520,0.06,867010,1520,0.18,864500,867100
اخزا1012,اسناد خزانه-م1بودجه01-040326,20,879,485011510,554610,555000,552010,-2600,-0.47,551780,-2830,-0.51,551000,555000
فردا2,صندوق س آواي فرداي زاگرس-ثابت,20,19700000,19700000,15087,1,1,-15086,-99.99,1,-15086,-99.99,1,1
برن0204پ01,برنج طارم0204تجارت مازندران(پ),20,1252,1033247113,827576,820000,829900,2324,0.28,825277,-2299,-0.28,820000,831000
ضشنا1108,اختيارخ شپنا-8000-1401/11/19,19,1122,120941000,230,271,101,-129,-56.09,108,-122,-53.04,101,271
طخود1204,اختيارف خودرو-1900-1401/12/03,19,3673,35604000,13,8,18,5,38.46,10,-3,-23.08,7,23
ضسپا3025,اختيارخ خساپا-2200-1402/03/24,19,925,677565000,704,750,780,76,10.8,733,29,4.12,700,788
اخزا0042,اسنادخزانه-م4بودجه00-030522,19,832,569080250,684800,656460,684420,-380,-0.06,683990,-810,-0.12,656460,692000
زعف0210پ23,زعفران0210نگين مدبرتوس(پ)	,19,3552,1124959300,324471,323094,312753,-11718,-3.61,316711,-7760,-2.39,312724,323094
رماس,صندوق س.راهبرد ممتازابن سينا-س,19,115909,1520190354,13213,13464,13030,-183,-1.38,13115,-98,-0.74,13024,13464
ضسپا1203,اختيارخ خساپا-1800-1401/12/10,18,2340,1604587000,747,700,728,-19,-2.54,686,-61,-8.17,605,750
ضملي7023,اختيارخ فملي-2520-1402/07/05,18,12129,59346740000,3049,3500,4312,1263,41.42,4893,1844,60.48,3500,5300
ضهرم7010,اختيارخ اهرم-15000-1402/07/23,18,2108,7762153000,5160,5007,3480,-1680,-32.56,3682,-1478,-28.64,3452,5007
اگ020318,گام بانك تجارت0203,17,34529,30920719500,895027,895500,895500,473,0.05,895500,473,0.05,895500,895500
طخود1208,اختيارف خودرو-2600-1401/12/03,17,2615,216240000,78,99,80,2,2.56,83,5,6.41,80,99
ضهاي3010,اختيارخ هاي وب-4152-1402/03/03,17,954,158461288,186,224,177,-9,-4.84,153,-33,-17.74,151,180
ضهاي3006,اختيارخ هاي وب-2998-1402/03/03,17,1104,542181028,422,448,450,28,6.64,453,31,7.35,400,470
طسپا1203,اختيارف خساپا-1800-1401/12/10,17,7085,134430000,21,20,20,-1,-4.76,19,-2,-9.52,18,21
وبازار,صندوق س شاخصي بازارآشنا,17,79258,1091816130,13930,13990,13760,-170,-1.22,13780,-150,-1.08,13720,13990
آسام,صندوق س.آرمان سپهر آشنا-م,17,18922,311914416,16769,16508,16360,-409,-2.44,16484,-285,-1.7,16310,16508
ضهرم1207,اختيارخ اهرم-13000-1401/12/22,17,241,422467000,2141,1850,1995,-146,-6.82,1753,-388,-18.12,1661,1995
زعف0210پ21,زعفران0210نگين ملل(پ),17,1458,473271648,335199,333333,320050,-15149,-4.52,324603,-10596,-3.16,320050,339500
مرواريد,صندوق س. مرواريد بها بازار-س,17,8382,92962937,11384,11031,10982,-402,-3.53,11091,-293,-2.57,10982,11310
زعف0210پ22,زعفران0210نگين گليران(پ),16,8276,2716260160,333811,330000,320010,-13801,-4.13,328209,-5602,-1.68,320010,334000
وثخوز,سرمايه گذاري و توسعه خوزستان,16,13097,414520050,30750,31650,31650,900,2.93,30800,50,0.16,31650,31650
ومللح,ح . اعتباري ملل,16,269573,762105131,2950,3097,2803,-147,-4.98,2827,-123,-4.17,2803,3097
ضدي206,اختيارخ دي-750-14020217,16,1106,237897000,188,219,220,32,17.02,215,27,14.36,201,220
ضخود3067,اختيارخ خودرو-2400-1402/03/03,16,265,278350000,1130,1099,1140,10,0.88,1050,-80,-7.08,853,1152
ضچكا1208,اختيارخ چكاپا-3250-1401/12/07,15,514,83601000,150,179,161,11,7.33,163,13,8.67,145,179
ثمين,صندوق س. ثروت افزون ثمين-س,15,3015422,40816229370,13932,13870,13580,-352,-2.53,13536,-396,-2.84,13530,13870
لپيام,گسترش صنايع پيام,15,20231,530052200,25450,26200,26200,750,2.95,25500,50,0.2,26200,26200
ضدي202,اختيارخ دي-550-14020217,15,287,102697000,368,447,375,7,1.9,358,-10,-2.72,334,399
صنوين,صندوق سرمايه‌گذاري صنوين-مختلط,15,2484,345007260,137820,139380,138000,180,0.13,138890,1070,0.78,137350,139390
هيوا,صندوق س. ثروت هيوا-س,15,106422,1225672502,11599,11600,11501,-98,-0.84,11517,-82,-0.71,11400,11600
فسديد,لوله‌وتجهيزات‌ سديد - ورشكسته,15,10396,669502400,63800,64400,64400,600,0.94,63950,150,0.24,64400,64400
ضهرم1206,اختيارخ اهرم-12000-1401/12/22,15,180,425600000,1248,2600,2650,1402,112.34,2364,1116,89.42,2000,2650
ضجار2025,اختيارخ وتجارت-1800-1402/02/20,14,784,223374000,292,290,298,6,2.05,285,-7,-2.4,278,298
ضشنا1109,اختيارخ شپنا-9000-1401/11/19,14,1515,128785000,122,100,55,-67,-54.92,85,-37,-30.33,55,100
ضخود1113,اختيارخ خودرو-3500-1401/11/12,14,513,10610000,20,35,28,8,40,21,1,5,9,35
ضخود3071,اختيارخ خودرو-3250-1402/03/03,14,3201,1588500000,619,490,500,-119,-19.22,496,-123,-19.87,490,500
ضخود3073,اختيارخ خودرو-3750-1402/03/03,14,826,232451000,384,2,287,-97,-25.26,281,-103,-26.82,2,300
شگامرن,مجتمع پترو صنعت گامرون,14,7409,2971362500,383450,402550,400900,17450,4.55,401050,17600,4.59,400000,402550
نشان,صندوق س. نشان هامرز-د,14,311733,3616415038,11594,11601,11601,7,0.06,11601,7,0.06,11601,11602
طهاي3006,اختيارف هاي وب-2998-1402/03/03,14,1025,355464196,321,320,320,-1,-0.31,320,-1,-0.31,280,320
ضدي207,اختيارخ دي-800-14020217,14,1256,262338000,212,223,222,10,4.72,209,-3,-1.42,192,223
ضخود3069,اختيارخ خودرو-2800-1402/03/03,14,1568,910267000,803,501,640,-163,-20.3,581,-222,-27.65,500,847
سكه0211پ02,تمام سكه طرح جديد0211ملت,14,2300,4753890700,2066276,2066909,2066909,633,0.03,2066909,633,0.03,2066909,2066909
ضهرم7009,اختيارخ اهرم-14000-1402/07/23,13,2239,8944176000,6250,4501,3940,-2310,-36.96,3995,-2255,-36.08,3928,4501
فنرژي,گسترش صنايع انرژي آذرآب,13,32084,557619920,17730,17380,17380,-350,-1.97,17690,-40,-0.23,17380,17380
پادا,صندوق س.پاداش سرمايه پارس-س,13,10532,1368657306,129943,130598,129233,-710,-0.55,129952,9,0.01,128510,131099
ضجار2024,اختيارخ وتجارت-1700-1402/02/20,13,560,199120000,330,519,359,29,8.79,356,26,7.88,350,400
برليان,صندوق سرمايه گذاري برليان-سهام,13,21976,235831520,10890,10700,10690,-200,-1.84,10730,-160,-1.47,10690,10850
ضخود0111,اختيارخ خودرو-3500-1402/01/09,13,1724,431000000,309,250,250,-59,-19.09,250,-59,-19.09,250,250
ضشنا1105,اختيارخ شپنا-6500-1401/11/19,12,226,267168000,1262,1280,1194,-68,-5.39,1182,-80,-6.34,1150,1280
اخزا008,اسنادخزانه-م8بودجه00-030919,12,20000,12695475000,633400,633400,635990,2590,0.41,634770,1370,0.22,633400,635990
اخزا103,اسناد خزانه-م3بودجه01-040520,12,167900,89760023000,533470,535500,534630,1160,0.22,534600,1130,0.21,534100,535500
گنجين,صندوق س. گنجينه يكم آويد-د,12,520313,9119105638,17520,17526,17526,6,0.03,17526,6,0.03,17526,17531
سكه0312پ01,تمام سكه طرح جديد0312 رفاه,12,1800,3720436200,2066276,2066909,2066909,633,0.03,2066909,633,0.03,2066909,2066909
ضستا1102,اختيارخ شستا-700-1401/11/05,12,4980,1512639000,321,310,319,-2,-0.62,304,-17,-5.3,302,319
برن0203پ02,برنج فجر0203 تجارت مازندران(پ),12,681,390645634,573000,553333,580000,7000,1.22,573635,635,0.11,553333,580000
ضخود3074,اختيارخ خودرو-4000-1402/03/03,11,376,86050000,315,210,280,-35,-11.11,229,-86,-27.3,210,280
اخزا009,اسناد خزانه-م9بودجه00-031101,11,6300,3891840000,614270,616960,617000,2730,0.44,617750,3480,0.57,616000,619490
اراد112,مرابحه عام دولت112-ش.خ 040408,11,1005000,917560000000,912000,912000,913000,1000,0.11,912990,990,0.11,912000,913000
زعف0210پ24,زعفران0210نگين پارسيلون(پ),11,2800,885712300,325781,320001,312112,-13669,-4.2,316326,-9455,-2.9,312112,320001
ضخاور1106,اختيارخ خاور-2800-14011109,11,722,535440000,899,1250,700,-199,-22.14,742,-157,-17.46,700,1250
اخزا0072,اسنادخزانه-م7بودجه00-030912,10,401,254193510,636350,630190,639930,3580,0.56,633900,-2450,-0.39,630190,639930
سي تيپ2ن32,گواهي سيمان تيپ2هرمزگان(ن),10,370000,3871310000,10463,10463,10463,0,0,10463,0,0,10463,10463
ضخود1109,اختيارخ خودرو-2600-1401/11/12,10,241,140743000,629,600,540,-89,-14.15,584,-45,-7.15,488,663
شسم,توليد سموم‌ علف‌ كش,10,1186,376021300,310850,317050,317050,6200,1.99,311300,450,0.14,317050,317050
ضخود1213,اختيارخ خودرو-3750-1401/12/03,10,967,79150000,74,100,80,6,8.11,82,8,10.81,80,100
ضسپا1201,اختيارخ خساپا-1600-1401/12/10,10,3131,2896790000,846,888,980,134,15.84,925,79,9.34,888,980
ضسپا3020,اختيارخ خساپا-1600-1402/03/24,9,133,146335000,940,1100,1100,160,17.02,1100,160,17.02,986,1200
ضترا3024,اختيارخ شتران-4000-1402/03/28,9,158,179248000,1132,1200,1120,-12,-1.06,1134,2,0.18,1080,1200
ضملت1148,اختيارخ وبملت-3500-1401/11/24,9,261,39450000,174,151,150,-24,-13.79,151,-23,-13.22,150,155
اخزا909,اسنادخزانه-م9بودجه99-020316,9,108300,99130481000,915990,915280,915300,-690,-0.08,915330,-660,-0.07,915270,919000
ولملتح,ح . واسپاري ملت,9,32499,128522050,3960,4000,3950,-10,-0.25,3955,-5,-0.13,3950,4000
طلا2,صندوق س.پشتوانه طلاي لوتوس,9,900000,900000,159544,1,1,-159543,-100,1,-159543,-100,1,1
اخزا0032,اسنادخزانه-م3بودجه00-030418,8,100,69335400,701430,690110,700900,-530,-0.08,693350,-8080,-1.15,690110,700900
ضمان,صندوق تضمين ا.سرمايه كاريزما-م,8,2666444,31730683600,12079,11900,11900,-179,-1.48,11900,-179,-1.48,11900,11900
ضسپا3026,اختيارخ خساپا-2400-1402/03/24,8,334,186000000,592,500,600,8,1.35,557,-35,-5.91,500,600
ضخود1111,اختيارخ خودرو-3000-1401/11/12,8,269,61170000,201,250,230,29,14.43,227,26,12.94,180,250
سي تيپ2ن17,گواهي سيمان تيپ2ماهان كرمان(ن),8,238000,1810704000,7608,7608,7608,0,0,7608,0,0,7608,7608
اگ020719,گام بانك صادرات ايران0207,8,74155,60584560845,815029,816999,816999,1970,0.24,816999,1970,0.24,816999,816999
ثروتم,صندوق س. ثروت آفرين پارسيان-س,8,9162,999574638,109996,109371,108280,-1716,-1.56,109100,-896,-0.81,108280,109371
ضملت1144,اختيارخ وبملت-2600-1401/11/24,8,23,19110000,943,900,990,47,4.98,831,-112,-11.88,720,990
تاراز,صندوق س آواي تاراز زاگرس-سهام,8,15613,208619360,13500,13400,13310,-190,-1.41,13360,-140,-1.04,13310,13400
وملت,سرمايه گذاري ملت,8,48822,109019526,2190,2233,2233,43,1.96,2191,1,0.05,2233,2233
ضهرم7008,اختيارخ اهرم-13000-1402/07/23,8,5280,25136000000,5178,4750,4760,-418,-8.07,4761,-417,-8.05,4750,4800
ضملت1146,اختيارخ وبملت-3000-1401/11/24,7,220,96656000,850,450,550,-300,-35.29,439,-411,-48.35,401,550
ضفلا7023,اختيارخ فولاد-2150-1402/07/26,7,138,457847000,3203,3000,3500,297,9.27,3318,115,3.59,2500,3500
ضخاور111,اختيارخ خاور-3700-14020116,7,580,305600000,560,600,520,-40,-7.14,527,-33,-5.89,505,600
ضشنا2025,اختيارخ شپنا-5859-1402/02/24,7,68,112858000,1578,1706,1600,22,1.39,1660,82,5.2,1519,1706
ضترا1147,اختيارخ شتران-4327-1401/11/19,7,33,15925974,250,299,240,-10,-4,298,48,19.2,240,304
ضفلا7025,اختيارخ فولاد-2813-1402/07/26,6,364,909636000,2496,2499,2499,3,0.12,2499,3,0.12,2499,2499
ضسپا1202,اختيارخ خساپا-1700-1401/12/10,6,1418,1185250000,761,850,850,89,11.7,836,75,9.86,800,850
ضدي200,اختيارخ دي-450-14020217,6,87,42413000,525,530,505,-20,-3.81,488,-37,-7.05,422,530
سي تيپ2ن04,گواهي سيمان تيپ2فارس نو(ن),6,120000,974880000,8124,8124,8124,0,0,8124,0,0,8124,8124
سي تيپ2ن07,گواهي سيمان تيپ 2تهران(ن),6,98000,890820000,9090,9090,9090,0,0,9090,0,0,9090,9090
آرمانح,ح.بيمه آرمان,6,6102,22803174,3808,3737,3737,-71,-1.86,3737,-71,-1.86,3737,3737
سپيدما4,صندوق س. سپيد دماوند-د,6,228348550,3289054861100,14395,14402,14404,9,0.06,14404,9,0.06,14402,14404
دقاضيح,ح . داروسازي شهيد قاضي,6,7631,133244900,18230,17900,17400,-830,-4.55,17460,-770,-4.22,17400,17900
ضهرم1209,اختيارخ اهرم-15000-1401/12/22,6,544,464595000,917,910,850,-67,-7.31,854,-63,-6.87,850,1045
ضستا6000,اختيارخ شستا-465-1402/06/08,6,84,55028000,651,680,656,5,0.77,655,4,0.61,650,680
اخزا907,اسنادخزانه-م7بودجه99-020704,6,9000,7614059000,846060,845500,846020,-40,0,846010,-50,-0.01,845500,846990
ضخاور110,اختيارخ خاور-3500-14020116,6,66,52451000,860,700,795,-65,-7.56,795,-65,-7.56,656,800
اراد50,مرابحه عام دولت5-ش.خ0302,6,65000,65000000000,1000000,1000000,1000000,0,0,1000000,0,0,1000000,1000000
ضستا0103,اختيارخ شستا-900-1402/01/09,6,1206,234439000,270,240,190,-80,-29.63,194,-76,-28.15,190,240
هم وزن2,صندوق س. شاخصي كيان-س,6,3900000,3900000,12266,1,1,-12265,-99.99,1,-12265,-99.99,1,1
ضفلا1173,اختيارخ فولاد-5000-1401/11/26,6,140,173560000,1233,1250,1210,-23,-1.87,1240,7,0.57,1210,1250
ضجار2021,اختيارخ وتجارت-1400-1402/02/20,5,71,37385000,599,511,575,-24,-4.01,527,-72,-12.02,511,575
ضكاريس207,اختيارخ كاريس-18000-14020205,5,19,25650000,1534,1350,1350,-184,-11.99,1350,-184,-11.99,1350,1350
ضجار2018,اختيارخ وتجارت-1100-1402/02/20,5,37,30622000,835,812,833,-2,-0.24,828,-7,-0.84,800,870
اخزا9032,اسنادخزانه-م3بودجه99-011110,5,122,121165950,992770,992020,994000,1230,0.12,993160,390,0.04,992010,994100
ضهرم7002,اختيارخ اهرم-7500-1402/07/23,5,5000,42000000000,8595,8400,8400,-195,-2.27,8400,-195,-2.27,8400,8400
ضسلا7003,اختيارخ سلام-9000-1402/07/19,5,4760,18564000000,3890,3900,3900,10,0.26,3900,10,0.26,3900,3900
ضستا6007,اختيارخ شستا-1165-1402/06/08,5,201,38290000,204,240,186,-18,-8.82,190,-14,-6.86,186,240
گام020813,گواهي اعتبارمولد رفاه0208	,5,325000,259460500000,1000000,798340,798340,-201660,-20.17,798340,-201660,-20.17,798340,798340
ضهاي3008,اختيارخ هاي وب-3460-1402/03/03,5,16,5387480,304,310,310,6,1.97,311,7,2.3,310,320
ضملت1143,اختيارخ وبملت-2400-1401/11/24,5,356,358961000,1228,1050,1000,-228,-18.57,1008,-220,-17.92,1000,1050
ضخود1108,اختيارخ خودرو-2400-1401/11/12,5,142,98905000,612,700,650,38,6.21,697,85,13.89,650,700
ثبات2,صندوق س. ثبات ويستا -د,5,21000000,21000000,13377,1,1,-13376,-99.99,1,-13376,-99.99,1,1
طستا1105,اختيارف شستا-1000-1401/11/05,5,3301,13204000,3,10000,4,1,33.33,4,1,33.33,4,4
ضچكا1207,اختيارخ چكاپا-3000-1401/12/07,5,163,39121000,274,250,200,-74,-27.01,240,-34,-12.41,200,250
ضترا3023,اختيارخ شتران-3750-1402/03/28,5,150,185770000,1329,1251,1201,-128,-9.63,1238,-91,-6.85,1201,1251
ضترا3029,اختيارخ شتران-6500-1402/03/28,5,31,13670000,500,500,410,-90,-18,441,-59,-11.8,400,500
ضستا6008,اختيارخ شستا-1265-1402/06/08,4,802,166395000,217,245,150,-67,-30.88,207,-10,-4.61,150,245
سكه0111پ05,تمام سكه طرح جديد0111آينده,4,500,1033454500,2066276,2066909,2066909,633,0.03,2066909,633,0.03,2066909,2066909
ضملي7030,اختيارخ فملي-4853-1402/07/05,4,58,116800000,2132,2000,2200,68,3.19,2014,-118,-5.53,2000,2200
زعف0210پ25,زعفران0210نگين زرپران (پ),4,220,71609985,334766,343999,320000,-14766,-4.41,325500,-9266,-2.77,320000,343999
بذر,صندوق س بذر اميد آفرين-سهام,4,5268,665611800,127800,126350,125630,-2170,-1.7,126350,-1450,-1.13,125630,126360
اخزا911,اسنادخزانه-م11بودجه99-020906,4,17500,14262675000,814910,815010,815010,100,0.01,815010,100,0.01,815010,815010
ضستا0101,اختيارخ شستا-700-1402/01/09,4,42,16300000,370,382,390,20,5.41,388,18,4.86,382,390
طسپا1204,اختيارف خساپا-1900-1401/12/10,4,103,3592000,20,50,21,1,5,35,15,75,21,50
هماي2,صندوق س هماي آگاه-ثابت,4,13700000,13700000,10019,1,1,-10018,-99.99,1,-10018,-99.99,1,1
اخزا905,اسنادخزانه-م5بودجه99-020218,4,79200,73945090000,935330,933660,933650,-1680,-0.18,933650,-1680,-0.18,933650,933660
فيروزه2,صندوق شاخص30 شركت فيروزه- سهام,4,36702,36702,21130,1,1,-21129,-100,1,-21129,-100,1,1
اخزا9102,اسنادخزانه-م10بودجه99-020807,4,336,267392300,831630,790050,809800,-21830,-2.62,795810,-35820,-4.31,790050,809800
سپر2,صندوق س سپر سرمايه بيدار- ثابت,4,66700000,66700000,16622,1,1,-16621,-99.99,1,-16621,-99.99,1,1
سكه0112پ03,تمام سكه طرح جديد0112سامان,4,700,1446836300,2066276,2066909,2066909,633,0.03,2066909,633,0.03,2066909,2066909
فيروزا2,صندوق ارمغان فيروزه آسيا-ثابت,4,55000000,55000000,32407,1,1,-32406,-100,1,-32406,-100,1,1
اخزا0102,اسناد خزانه-م10بودجه00-031115,4,117,70830040,609139,578690,606120,-3019,-0.5,605380,-3759,-0.62,578690,608990
غدير052,اجاره غديرايرانيان14050114,4,7370,7400207550,982000,1008810,1000000,18000,1.83,1004100,22100,2.25,1000000,1008810
پاداش2,صندوق س. ارزش پاداش-د,4,24500000,24500000,10262,1,1,-10261,-99.99,1,-10261,-99.99,1,1
ضحفا1208,اختيارخ حفارس-16000-1401/12/24,3,5,5000000,1800,1000,1000,-800,-44.44,1000,-800,-44.44,1000,1000
ضدي212,اختيارخ دي-1100-14020217,3,12,1565000,138,80,135,-3,-2.17,130,-8,-5.8,80,135
ضستا6009,اختيارخ شستا-1365-1402/06/08,3,103,16204000,150,290,156,6,4,157,7,4.67,156,290
ضخود1203,اختيارخ خودرو-1800-1401/12/03,3,25,28715000,1226,1133,1211,-15,-1.22,1149,-77,-6.28,1133,1211
پخش2,پخش البرز,3,5730000,324318000000,56300,56600,56600,300,0.53,56600,300,0.53,56600,56600
اراد644,مرابحه عام دولتي64-ش.خ0111,3,41820000,41747680910000,998680,998166,998335,-345,-0.03,998271,-409,-0.04,998166,998335
اراد107,مرابحه عام دولت107-ش.خ030724,3,450000,421650000000,922890,937000,937000,14110,1.53,937000,14110,1.53,937000,937000
كاوه2,فولاد كاوه جنوب كيش,3,13450000,105375500000,7770,7850,7790,20,0.26,7835,65,0.84,7790,7850
ضكاريس205,اختيارخ كاريس-16000-14020205,3,155,367500000,2856,2350,2400,-456,-15.97,2371,-485,-16.98,2350,2450
طستا6006,اختيارف شستا-1065-1402/06/08,3,999,197802000,200,198,198,-2,-1,198,-2,-1,198,198
سي تيپ2ن01,گواهي سيمان تيپ 2 فارس(ن),3,70000,630280000,9004,9004,9004,0,0,9004,0,0,9004,9004
ويستا,صندوق س. ويستا -س,3,1250,16953548,13516,13576,13573,57,0.42,13563,47,0.35,13494,13576
عقيق2,صندوق سرمايه گذاري عقيق-سهام,3,1180000,1180000,52540,1,1,-52539,-100,1,-52539,-100,1,1
سي تيپ2ن02,گواهي سيمان تيپ2صوفيان(ن),3,140000,1033200000,7380,7380,7380,0,0,7380,0,0,7380,7380
چنوپا,نيوپان‌ 22 بهمن‌,3,2543,45036530,17200,17710,17710,510,2.97,17710,510,2.97,17710,17710
اكالا,كارگزاران بورس كالاي ايران,3,43245,801762300,19930,18540,18540,-1390,-6.97,19910,-20,-0.1,18540,18540
اراد105,مرابحه عام دولت105-ش.خ030503,3,60000,57145000000,986000,945800,986000,0,0,952420,-33580,-3.41,945800,986000
ضهرم1208,اختيارخ اهرم-14000-1401/12/22,3,4,4881000,1493,1210,1255,-238,-15.94,1220,-273,-18.29,1206,1255
ضخود1112,اختيارخ خودرو-3250-1401/11/12,3,90,10790000,150,120,120,-30,-20,120,-30,-20,119,120
ضخاور1105,اختيارخ خاور-2600-14011109,3,15,13756000,1115,850,925,-190,-17.04,917,-198,-17.76,850,925
اوج,صندوق س.اوج دماوند-س,3,34483,393359579,11545,11507,11393,-152,-1.32,11407,-138,-1.2,11393,11507
ضسپا1200,اختيارخ خساپا-1500-1401/12/10,3,3,3112000,941,1050,1031,90,9.56,1037,96,10.2,1031,1050
ضترا1146,اختيارخ شتران-4018-1401/11/19,3,10,7798760,450,450,500,50,11.11,482,32,7.11,450,500
ضملت1145,اختيارخ وبملت-2800-1401/11/24,3,314,197764000,727,551,650,-77,-10.59,630,-97,-13.34,551,650
اگ0207192,گام بانك صادرات ايران0207,3,701910,571165224300,815029,813730,813730,-1299,-0.16,813730,-1299,-0.16,813730,813730
اراد120,مرابحه عام دولت120-ش.خ040417	,3,32,29344320,916480,917010,917010,530,0.06,917010,530,0.06,917010,917010
افران4,صندوق س افرا نماد پايدار-ثابت,3,121145049,2298000434481,18956,18969,18969,13,0.07,18969,13,0.07,18969,18969
ضترا3025,اختيارخ شتران-4500-1402/03/28,3,6,6600000,1233,1200,1000,-233,-18.9,1100,-133,-10.79,1000,1200
ضملي7020,اختيارخ فملي-1853-1402/07/05,2,22,107000000,5000,4500,4900,-100,-2,4864,-136,-2.72,4500,4900
ضملت3024,اختيارخ وبملت-2969-1402/03/28,2,20,11500000,442,700,450,8,1.81,575,133,30.09,450,700
ضبساما305,اختيارخ بساما-12000-14020310,2,2,2000000,901,1000,1000,99,10.99,1000,99,10.99,1000,1000
ضخاور1113,اختيارخ خاور-4200-14011109,2,200,22000000,1,120,100,99,9900,110,109,10900,100,120
اراد314,مرابحه عام دولت3-ش.خ 0208,2,9320000,8654477440000,994300,928484,928700,-65600,-6.6,928592,-65708,-6.61,928484,928700
اراد122,مرابحه عام دولت122-ش.خ030807,2,17,15942260,938130,937780,937780,-350,-0.04,937780,-350,-0.04,937780,937780
صمعاد2122,صكوك اجاره معادن212-6ماهه21%,2,365000,357193850000,1000000,1000000,952690,-47310,-4.73,978613,-21387,-2.14,952690,1000000
ضهرم1200,اختيارخ اهرم-7000-1401/12/22,2,10,74200000,8000,7500,7300,-700,-8.75,7420,-580,-7.25,7300,7500
ضتفارس607,اختيارخ تفارس-4199-14020629,2,2,1333000,900,777,556,-344,-38.22,666,-234,-26,556,777
ضسرو1018,اختيارخ سرو-90000-1402/10/06,2,1777,459657920,28255,26000,25696,-2559,-9.06,25867,-2388,-8.45,25696,26000
طخود1108,اختيارف خودرو-2400-1401/11/12,2,100,1001000,50,10,11,-39,-78,10,-40,-80,10,11
طخود1200,اختيارف خودرو-1500-1401/12/03,2,38,3572000,49,80,99,50,102.04,94,45,91.84,80,99
ضستا1202,اختيارخ شستا-700-1401/12/03,2,2,709000,385,359,350,-35,-9.09,354,-31,-8.05,350,359
ضپلا1208,اختيارخ پالايش-100000-01/12/16,2,360,73800000,22740,21000,20100,-2640,-11.61,20500,-2240,-9.85,20100,21000
ضپلا1209,اختيارخ پالايش-110000-01/12/16,2,500,65000000,14500,13000,13000,-1500,-10.34,13000,-1500,-10.34,13000,13000
سي تيپ2ن14,گواهي سيمان تيپ2ساوه(ن),2,45000,340830000,7574,7574,7574,0,0,7574,0,0,7574,7574
اخزا1014,اسناد خزانه-م1بودجه01-040326,2,250168,139418324000,554610,558500,555500,890,0.16,557299,2689,0.48,555500,558500
سي تيپ2ن24,گواهي سيمان تيپ2هگمتان(ن),2,24000,144048000,6002,6002,6002,0,0,6002,0,0,6002,6002
سي تيپ2ن05,گواهي سيمان تيپ 2خاش(ن),2,75000,607200000,8096,8096,8096,0,0,8096,0,0,8096,8096
ضستا1108,اختيارخ شستا-1300-1401/11/05,2,2000,2000000,1,1,1,0,0,1,0,0,1,1
ضدار1211,اختيارخ ص.دارا-160000-01/12/16,2,20,130000,1000,1800,800,-200,-20,650,-350,-35,500,800
طستا0105,اختيارف شستا-1100-1402/01/09,2,100,13800000,1,138,138,137,13700,138,137,13700,138,138
ضستا1201,اختيارخ شستا-600-1401/12/03,2,110,49500000,480,450,450,-30,-6.25,450,-30,-6.25,450,450
ضملي7028,اختيارخ فملي-4187-1402/07/05,2,7,17493000,2361,2499,2499,138,5.84,2499,138,5.84,2499,2499
اخزا9082,اسنادخزانه-م8بودجه99-020606,2,73,62807740,865490,864700,858130,-7360,-0.85,860380,-5110,-0.59,858130,864700
اخزا0082,اسنادخزانه-م8بودجه00-030919,2,76,48065400,633400,633400,632400,-1000,-0.16,632440,-960,-0.15,632400,633400
كرماشا2,صنايع پتروشيمي كرمانشاه,2,5397401,350304104600,64940,64940,64600,-340,-0.52,64902,-38,-0.06,64600,64940
صپا ه 19,بار پايه هفته 19صنعتي,2,13170,7770300,810,590,590,-220,-27.16,590,-220,-27.16,590,590
اراد61,مرابحه عام دولت61-ش.خ0309,2,60000,60000000000,1000000,1000000,1000000,0,0,1000000,0,0,1000000,1000000
صايپا038,صكوك مرابحه سايپا038-3ماهه 18%,2,20000,19800000000,990000,990000,990000,0,0,990000,0,0,990000,990000
زعف0210پ102,زعفران0210نگين طلاي سرخ(پ),2,872539,292300565000,328304,335000,335000,6696,2.04,335000,6696,2.04,335000,335000
ضهرم7004,اختيارخ اهرم-9000-1402/07/23,2,6,45800000,8500,7500,7660,-840,-9.88,7633,-867,-10.2,7500,7660
سي تيپ2ن11,گواهي سيمان تيپ2دورود(ن),2,28000,180796000,6457,6457,6457,0,0,6457,0,0,6457,6457
ثهام,صندوق س ثروت هامرز-سهام,2,4790,64386000,13280,13450,13400,120,0.9,13440,160,1.2,13400,13450
كخاك2,صنايع‌خاك‌چيني‌ايران‌,2,6000000,90060000000,14970,15010,15010,40,0.27,15010,40,0.27,15010,15010
اراد1214,مرابحه عام دولت121-ش.خ030324,2,49360000,45075231160000,959000,913187,913200,-45800,-4.78,913193,-45807,-4.78,913187,913200
سي تيپ2ن41,گواهي سيمان تيپ2بوكان(ن),2,110000,727430000,6613,6613,6613,0,0,6613,0,0,6613,6613
افران2,صندوق س افرا نماد پايدار-ثابت,2,56600000,56600000,18956,1,1,-18955,-99.99,1,-18955,-99.99,1,1
ضترا3019,اختيارخ شتران-2800-1402/03/28,2,7,14000000,1,2000,2000,1999,199900,2000,1999,199900,2000,2000
جستا0000,آتي شستا-1401/11/12,2,4,4380000,1112,1089,1097,-15,-1.35,1099,-13,-1.17,1089,1097
ضهرم1211,اختيارخ اهرم-18000-1401/12/22,2,20,7110000,700,310,401,-299,-42.71,355,-345,-49.29,310,401
سپرمي,پرميت‌,2,500,16600000,33500,33200,33200,-300,-0.9,33500,0,0,33200,33200
درسا2,صندوق سرمايه گذاري درسا - سهام,2,1500000,1500000,12550,1,1,-12549,-99.99,1,-12549,-99.99,1,1
كيش05,مرابحه س. و توسعه كيش14050724,2,300000,300000000000,1000000,1000000,1000000,0,0,1000000,0,0,1000000,1000000
كمند4,صندوق س. با درآمد ثابت كمند,2,425503600,4305245424800,10112,10118,10118,6,0.06,10118,6,0.06,10118,10118
پارسان2,گسترش نفت و گاز پارسيان,2,26946000,884249220000,32850,32770,32850,0,0,32816,-34,-0.1,32770,32850
اخزا9142,اسنادخزانه-م14بودجه99-021025,2,20,15800000,799990,790000,790000,-9990,-1.25,790000,-9990,-1.25,790000,790000
ضملي1170,اختيارخ فملي-5500-1401/11/12,2,11,21110000,1515,2000,1911,396,26.14,1919,404,26.67,1911,2000
كارا2,صندوق س. كارا -د,2,95000000,95000000,13184,1,1,-13183,-99.99,1,-13183,-99.99,1,1
وصنعت2,سرمايه گذاري توسعه صنعت وتجارت,2,48999999,107309997810,2156,2190,2190,34,1.58,2190,34,1.58,2190,2190
داريوش2,صندوق س. ثروت داريوش -س,2,9500000,9500000,12575,1,1,-12574,-99.99,1,-12574,-99.99,1,1
بوعلي2,پتروشيمي بوعلي سينا,1,5000000,186300000000,36030,37260,37260,1230,3.41,37260,1230,3.41,37260,37260
ديران2,ايران‌دارو,1,4700000,68902000000,15330,14660,14660,-670,-4.37,14660,-670,-4.37,14660,14660
غگز,گز سكه,1,1000,2285000,2177,2285,2285,108,4.96,2285,108,4.96,2285,2285
صيدك404,صكوك مرابحه صيدك404-3ماهه18%,1,10000,9600000000,960000,960000,960000,0,0,960000,0,0,960000,960000
تملي804,تسهيلات مسكن ب. ملي-تير98,1,5,3243395,682819,648679,648679,-34140,-5,648679,-34140,-5,648679,648679
سمتا022,سلف موازي استاندارد سمتا022,1,100,104370200,1043217,1043702,1043702,485,0.05,1043702,485,0.05,1043702,1043702
اگ0205552,گام بانك اقتصاد نوين0205,1,4239950,3629397200000,853654,856000,856000,2346,0.27,856000,2346,0.27,856000,856000
اخزا9044,اسنادخزانه-م4بودجه99-011215,1,100000,97376000000,973100,973760,973760,660,0.07,973760,660,0.07,973760,973760
شكام4,صنايع شيميايي كيمياگران امروز,1,238846747,1982428000100,8490,8300,8300,-190,-2.24,8300,-190,-2.24,8300,8300
شراز2,پالايش نفت شيراز,1,6200000,89962000000,14950,14510,14510,-440,-2.94,14510,-440,-2.94,14510,14510
مصفها112,مشاركت ش اصفهان112-3ماهه18%,1,5,5050000,1000000,1010000,1010000,10000,1,1010000,10000,1,1010000,1010000
طستا1108,اختيارف شستا-1300-1401/11/05,1,11,2860000,171,260,260,89,52.05,260,89,52.05,260,260
سمتا021,سلف موازي استاندارد سمتا021,1,100,104132400,1040840,1041324,1041324,484,0.05,1041324,484,0.05,1041324,1041324
پالايش2,صندوق پالايشي يكم-سهام,1,2800000,2800000,118680,1,1,-118679,-100,1,-118679,-100,1,1
واميد2,گروه مديريت سرمايه گذاري اميد,1,38000000,498180000000,13110,13110,13110,0,0,13110,0,0,13110,13110
شگويا2,پتروشيمي تندگويان,1,4203976,50069354160,12010,11910,11910,-100,-0.83,11910,-100,-0.83,11910,11910
اخزا0092,اسناد خزانه-م9بودجه00-031101,1,63,36764280,614270,583560,583560,-30710,-5,583560,-30710,-5,583560,583560
وبملت2,بانك ملت,1,108485000,379697500000,3560,3500,3500,-60,-1.69,3500,-60,-1.69,3500,3500
اخزا9092,اسنادخزانه-م9بودجه99-020316,1,2,1820020,915990,910010,910010,-5980,-0.65,910010,-5980,-0.65,910010,910010
اخزا9112,اسنادخزانه-م11بودجه99-020906,1,42,34271580,814910,815990,815990,1080,0.13,815990,1080,0.13,815990,815990
قاسم2,قاسم ايران,1,5705591,40737919740,7320,7140,7140,-180,-2.46,7140,-180,-2.46,7140,7140
خعمراح,ح. توسعه و عمران شهرستان نائين,1,1121,5044500,3580,4500,4500,920,25.7,4500,920,25.7,4500,4500
سپر4,صندوق س سپر سرمايه بيدار- ثابت,1,60200000,999922000000,16622,16610,16610,-12,-0.07,16610,-12,-0.07,16610,16610
غصينو4,صنعتي مينو,1,7584834,100271505480,12780,13220,13220,440,3.44,13220,440,3.44,13220,13220
اخزا9094,اسنادخزانه-م9بودجه99-020316,1,437000,401384500000,915990,918500,918500,2510,0.27,918500,2510,0.27,918500,918500
اخزا9104,اسنادخزانه-م10بودجه99-020807,1,800000,670080000000,831630,837600,837600,5970,0.72,837600,5970,0.72,837600,837600
اخزا9054,اسنادخزانه-م5بودجه99-020218,1,143465,133946097250,935330,933650,933650,-1680,-0.18,933650,-1680,-0.18,933650,933650
اخزا9042,اسنادخزانه-م4بودجه99-011215,1,14,13342140,973100,953010,953010,-20090,-2.06,953010,-20090,-2.06,953010,953010
ياقوت2,صندوق س ياقوت آگاه-ثابت,1,400000,400000,16861,1,1,-16860,-99.99,1,-16860,-99.99,1,1
اعتماد2,صندوق س.اعتماد آفرين پارسيان-د,1,7600000,7600000,51188,1,1,-51187,-100,1,-51187,-100,1,1
دتوليد2,داروسازي توليد دارو,1,3195438,34798319820,11370,10890,10890,-480,-4.22,10890,-480,-4.22,10890,10890
اراد1052,مرابحه عام دولت105-ش.خ030503,1,1700,1607860000,986000,945800,945800,-40200,-4.08,945800,-40200,-4.08,945800,945800
سمگا2,گروه سرمايه گذاري ميراث فرهنگي,1,82650000,569458500000,6810,6890,6890,80,1.17,6890,80,1.17,6890,6890
تايرا2,تراكتورسازي‌ايران‌,1,3000000,83820000000,28030,27940,27940,-90,-0.32,27940,-90,-0.32,27940,27940
اخزا9072,اسنادخزانه-م7بودجه99-020704,1,89,71534640,846060,803760,803760,-42300,-5,803760,-42300,-5,803760,803760
گام0203132,گواهي اعتبار مولد رفاه0203,1,800,724000000,876000,905000,905000,29000,3.31,905000,29000,3.31,905000,905000
گام0206132,گواهي اعتبار مولد رفاه0206	,1,323,276165000,833000,855000,855000,22000,2.64,855000,22000,2.64,855000,855000
ضخود1201,اختيارخ خودرو-1600-1401/12/03,1,2,4798000,1630,2399,2399,769,47.18,2399,769,47.18,2399,2399
تاراز2,صندوق س آواي تاراز زاگرس-سهام,1,70000,70000,13500,1,1,-13499,-99.99,1,-13499,-99.99,1,1
ضفلا1172,اختيارخ فولاد-4500-1401/11/26,1,1,1600000,1662,1600,1600,-62,-3.73,1600,-62,-3.73,1600,1600
ضجار2023,اختيارخ وتجارت-1600-1402/02/20,1,1,470000,476,470,470,-6,-1.26,470,-6,-1.26,470,470
ضدي211,اختيارخ دي-1000-14020217,1,100,13000000,140,130,130,-10,-7.14,130,-10,-7.14,130,130
اوصتا4,صندوق انديشه ورزان صباتامين -د,1,57273000,1499922597000,26171,26189,26189,18,0.07,26189,18,0.07,26189,26189
اخزا1032,اسناد خزانه-م3بودجه01-040520,1,49,25808300,533470,526700,526700,-6770,-1.27,526700,-6770,-1.27,526700,526700
ضترا1142,اختيارخ شتران-2781-1401/11/19,1,2,4206800,967,1300,1300,333,34.44,1300,333,34.44,1300,1300
زمگسا2,كشاورزي‌ ودامپروي‌ مگسال‌,1,2200000,73700000000,32960,33500,33500,540,1.64,33500,540,1.64,33500,33500
اگ020618,گام بانك تجارت0206,1,7988,6731887000,835000,842750,842750,7750,0.93,842750,7750,0.93,842750,842750
اراد334,مرابحه عام دولت3-ش.خ 0303,1,2986450,2627777355000,990000,879900,879900,-110100,-11.12,879900,-110100,-11.12,879900,879900
ضسپا3019,اختيارخ خساپا-1500-1402/03/24,1,10,12490000,1249,1249,1249,0,0,1249,0,0,1249,1249
فولاد2,فولاد مباركه اصفهان,1,32850000,202027500000,6230,6150,6150,-80,-1.28,6150,-80,-1.28,6150,6150
ضپلا1203,اختيارخ پالايش-62000-01/12/16,1,5,2500100,50000,50002,50002,2,0,50002,2,0,50002,50002
سكه0310پ04,تمام سكه طرح جديد 0310 صادرات,1,100,206690900,2063593,2066909,2066909,3316,0.16,2066909,3316,0.16,2066909,2066909
سپنتا031,سلف موازي پنتان پتروكنگان031,1,100,198584000,1984788,1985840,1985840,1052,0.05,1985840,1052,0.05,1985840,1985840
گام0112132,گواهي اعتبار مولد رفاه0112,1,2600,2509000000,940000,965000,965000,25000,2.66,965000,25000,2.66,965000,965000
جم2,پتروشيمي جم,1,3000000,112110000000,37490,37370,37370,-120,-0.32,37370,-120,-0.32,37370,37370
ضستا1208,اختيارخ شستا-1300-1401/12/03,1,1,29000,34,29,29,-5,-14.71,29,-5,-14.71,29,29
اراد502,مرابحه عام دولت5-ش.خ0302,1,1300,1300000000,1000000,1000000,1000000,0,0,1000000,0,0,1000000,1000000
فارس2,صنايع پتروشيمي خليج فارس,1,64653451,607095904890,9390,9390,9390,0,0,9390,0,0,9390,9390
ستران2,سيمان‌ تهران‌,1,32000000,1184000000000,37800,37000,37000,-800,-2.12,37000,-800,-2.12,37000,37000
طهرم1207,اختيارف اهرم-13000-1401/12/22,1,20,19220000,923,961,961,38,4.12,961,38,4.12,961,961
اخزا8202,اسنادخزانه-م20بودجه98-020806,1,77,60728360,830180,788680,788680,-41500,-5,788680,-41500,-5,788680,788680
جم پيلن2,پتروشيمي جم پيلن,1,350000,49735000000,141940,142100,142100,160,0.11,142100,160,0.11,142100,142100
نخل4,صندوق س.خليج فارس-د,1,19940000,199918440000,10019,10026,10026,7,0.07,10026,7,0.07,10026,10026
سي تيپ2ن31,گواهي سيمان تيپ2گيلان سبز(ن),1,70000,441840000,6312,6312,6312,0,0,6312,0,0,6312,6312
صباايده01,مرابحه ايده پردازصبادانا050929,1,5000,4100000000,857380,820000,820000,-37380,-4.36,820000,-37380,-4.36,820000,820000
سي تيپ2ن12,گواهي سيمان تيپ2خزر(ن),1,32000,237568000,6459,7424,7424,965,14.94,7424,965,14.94,7424,7424
ضملت1141,اختيارخ وبملت-2000-1401/11/24,1,400,639600000,1500,1599,1599,99,6.6,1599,99,6.6,1599,1599
سي تيپ2ن33,گواهي سيمان تيپ2ساروج بوشهر(ن),1,50000,503100000,10062,10062,10062,0,0,10062,0,0,10062,10062
متا0203,آتي متانول-1402/03/17,1,100,90990000,909800,909900,909900,100,0.01,909900,100,0.01,909900,909900
تملي809,تسهيلات مسكن ب. ملي-آذر98,1,1,606954,638898,606954,606954,-31944,-5,606954,-31944,-5,606954,606954
اگ020455,گام بانك اقتصاد نوين0204,1,10000,8763000000,915118,876300,876300,-38818,-4.24,876300,-38818,-4.24,876300,876300
سمتا023,سلف موازي استاندارد سمتا023,1,100,104769000,1047203,1047690,1047690,487,0.05,1047690,487,0.05,1047690,1047690
ضدار1200,اختيارخ ص.دارا-62000-01/12/16,1,1,581840,58184,58184,58184,0,0,58184,0,0,58184,58184
سي تيپ2ن20,گواهي سيمان تيپ2كوير كاشان(ن),1,10000,70240000,7024,7024,7024,0,0,7024,0,0,7024,7024
سمتا031,سلف موازي متانول مرجان 031,1,100,96697100,966544,966971,966971,427,0.04,966971,427,0.04,966971,966971
ثروت,ص.خ.ثروت آفرين فيروزه 85%تاديه,1,2000,1380000000,690000,690000,690000,0,0,690000,0,0,690000,690000
ضخاور1100,اختيارخ خاور-1600-14011109,1,1,2000000,2122,2000,2000,-122,-5.75,2000,-122,-5.75,2000,2000
متا0201,آتي متانول-1402/01/17,1,100,90920000,909300,909200,909200,-100,-0.01,909200,-100,-0.01,909200,909200
ضشنا1107,اختيارخ شپنا-7500-1401/11/19,1,5,1250000,307,250,250,-57,-18.57,250,-57,-18.57,250,250
سمتا011,سلف موازي استاندارد سمتا011,1,10,99305900,9926870,9930590,9930590,3720,0.04,9930590,3720,0.04,9930590,9930590
ضدي208,اختيارخ دي-850-14020217,1,500,75000000,1,150,150,149,14900,150,149,14900,150,150
نسب0201,آتي نفتاي سبك-1402/01/17,1,100,175000000,1740900,1750000,1750000,9100,0.52,1750000,9100,0.52,1750000,1750000
اراد94,مرابحه عام دولت94-ش.خ030816,1,100000,91000000000,948400,910000,910000,-38400,-4.05,910000,-38400,-4.05,910000,910000
سي تيپ2ن21,گواهي سيمان تيپ2زاوه تربت(ن),1,20000,117140000,5857,5857,5857,0,0,5857,0,0,5857,5857
سي تيپ2ن38,گواهي سيمان تيپ2مازندران(ن),1,32000,243456000,7608,7608,7608,0,0,7608,0,0,7608,7608
وغدير2,سرمايه‌گذاري‌غدير(هلدينگ‌,1,32500000,605800000000,18660,18640,18640,-20,-0.11,18640,-20,-0.11,18640,18640
ضپلا1207,اختيارخ پالايش-90000-01/12/16,1,2,561200,29072,28060,28060,-1012,-3.48,28060,-1012,-3.48,28060,28060
اراد119,مرابحه عام دولت119-ش.خ060811	,1,100000,95235000000,952250,952350,952350,100,0.01,952350,100,0.01,952350,952350
سمتا025,سلف موازي متانول بوشهر 025,1,100,116213900,1161599,1162139,1162139,540,0.05,1162139,540,0.05,1162139,1162139
اخزا1034,اسناد خزانه-م3بودجه01-040520,1,103716,55508803200,533470,535200,535200,1730,0.32,535200,1730,0.32,535200,535200
سي تيپ2ن10,گواهي سيمان تيپ 2غرب(ن),1,20000,127440000,6374,6372,6372,-2,-0.03,6372,-2,-0.03,6372,6372
طهرم1208,اختيارف اهرم-14000-1401/12/22,1,5,8000000,1190,1600,1600,410,34.45,1600,410,34.45,1600,1600
ضجار2019,اختيارخ وتجارت-1200-1402/02/20,1,16,12000000,850,750,750,-100,-11.76,750,-100,-11.76,750,750
ضهاي3003,اختيارخ هاي وب-2399-1402/03/03,1,7,6829200,700,900,900,200,28.57,900,200,28.57,900,900
طشنا1107,اختيارف شپنا-7500-1401/11/19,1,10,2400000,250,240,240,-10,-4,240,-10,-4,240,240
زعف0118ن192,زعفران0118نگين تروندقاينات(ن),1,475000,226861900000,250000,477604,477604,227604,91.04,477604,227604,91.04,477604,477604
زعف0118ن112,زعفران0118نگين سحرخيز(ن),1,131000,64309865000,250000,490915,490915,240915,96.37,490915,240915,96.37,490915,490915
ضهرم1204,اختيارخ اهرم-10000-1401/12/22,1,10,42050000,4815,4205,4205,-610,-12.67,4205,-610,-12.67,4205,4205
ضترا1143,اختيارخ شتران-3090-1401/11/19,1,11,17869192,1223,1004,1004,-219,-17.91,1004,-219,-17.91,1004,1004
سمتا024,سلف موازي متانول بوشهر 024,1,100,102198100,1021506,1021981,1021981,475,0.05,1021981,475,0.05,1021981,1021981
پارس2,پتروشيمي پارس,1,83000000,199200000000,2415,2400,2400,-15,-0.62,2400,-15,-0.62,2400,2400
وپويا2,سرمايه گذاري پويا,1,35000000,88900000000,2630,2540,2540,-90,-3.42,2540,-90,-3.42,2540,2540
شبهرن2,نفت‌ بهران‌,1,10000000,196500000000,19920,19650,19650,-270,-1.36,19650,-270,-1.36,19650,19650
گام020361,گواهي اعتبار مولد شهر0203,1,170000,152082000000,889400,894600,894600,5200,0.58,894600,5200,0.58,894600,894600
شپديس2,پتروشيمي پرديس,1,1280000,199488000000,158130,155850,155850,-2280,-1.44,155850,-2280,-1.44,155850,155850
اراد1032,مرابحه عام دولت103-ش.خ050821,1,1000,1020000000,1020000,1020000,1020000,0,0,1020000,0,0,1020000,1020000
اخزا9052,اسنادخزانه-م5بودجه99-020218,1,44,41065200,935330,933300,933300,-2030,-0.22,933300,-2030,-0.22,933300,933300
شبندر2,پالايش نفت بندرعباس,1,21840000,199180800000,9330,9120,9120,-210,-2.25,9120,-210,-2.25,9120,9120
سنفت021,سلف موازي نفت.س صادر اروند 021,1,100,237555000,2374446,2375550,2375550,1104,0.05,2375550,1104,0.05,2375550,2375550
كارا4,صندوق س. كارا -د,1,22700000,299458400000,13184,13192,13192,8,0.06,13192,8,0.06,13192,13192
امين يكم4,صندوق درآمد ثابت امين يكم فردا,1,25000000,248700000000,9897,9948,9948,51,0.52,9948,51,0.52,9948,9948
اراد92,مرابحه عام دولت92-ش.خ020825,1,180000,171540000000,957720,953000,953000,-4720,-0.49,953000,-4720,-0.49,953000,953000
ضپلا1206,اختيارخ پالايش-80000-01/12/16,1,5,1855500,40099,37110,37110,-2989,-7.45,37110,-2989,-7.45,37110,37110
ضستا1101,اختيارخ شستا-600-1401/11/05,1,10,4000000,495,400,400,-95,-19.19,400,-95,-19.19,400,400
ضجار2029,اختيارخ وتجارت-2400-1402/02/20,1,50,10000000,157,200,200,43,27.39,200,43,27.39,200,200
نسب0203,آتي نفتاي سبك-1402/03/17,1,100,173090000,1730800,1730900,1730900,100,0.01,1730900,100,0.01,1730900,1730900
صينا205,صكوك منفعت سينا دارو-3ماهه 19%,1,70,68243140,984750,974902,974902,-9848,-1,974902,-9848,-1,974902,974902
طهاي3009,اختيارف هاي وب-3690-1402/03/03,1,1,650400,694,600,600,-94,-13.54,600,-94,-13.54,600,600
