نماد,نام,تعداد,حجم,ارزش,دیروز,اولین,آخرین معامله - مقدار,آخرین معامله - تغییر,آخرین معامله - درصد,قیمت پایانی - مقدار,قیمت پایانی - تغییر,قیمت پایانی - درصد,کمترین,بیشترین
اسياتك,انتقال داده هاي آسياتك,65915,120423196,1783454004750,14170,14860,14870,700,4.94,14810,640,4.52,14210,14870
ددانا,داروسازي دانا,20190,2152023,84897307350,37250,39450,39450,2200,5.91,39450,2200,5.91,39450,39450
سآبيك,سيمان آبيك,17714,25033959,390780099990,14870,15610,15610,740,4.98,15610,740,4.98,15610,15610
شپنا,پالايش نفت اصفهان,17224,323775903,2190683218210,6470,6530,6850,380,5.87,6770,300,4.64,6480,6850
پالايش,صندوق پالايشي يكم-سهام,16491,19469131,1513389465850,76710,76500,78500,1790,2.33,77730,1020,1.33,76400,79100
شستا,سرمايه گذاري تامين اجتماعي,16413,877161322,890485719543,1013,1017,1014,1,0.1,1015,2,0.2,1007,1040
كرمان,س. توسعه و عمران استان كرمان,12716,560957300,591553095777,1005,1035,1065,60,5.97,1055,50,4.98,1026,1065
خودرو,ايران‌ خودرو,10399,372740237,843135068377,2257,2278,2275,18,0.8,2262,5,0.22,2237,2295
فولاد,فولاد مباركه اصفهان,10114,83136147,1006676062960,12260,12260,12120,-140,-1.14,12110,-150,-1.22,11950,12280
فزر,پويا زركان آق دره,9547,21655440,634408158400,30000,30350,28750,-1250,-4.17,29300,-700,-2.33,28400,30700
وخارزم,سرمايه گذاري خوارزمي,9455,211813127,1115074059190,4980,5270,5270,290,5.82,5260,280,5.62,5160,5270
قثابت,قند ثابت‌ خراسان‌,8278,166204615,558489203254,3252,3310,3240,-12,-0.37,3360,108,3.32,3190,3414
افرا,افرانت,7796,19527270,656538695700,35150,33400,33700,-1450,-4.13,33600,-1550,-4.41,33400,34650
خگستر,گسترش‌سرمايه‌گذاري‌ايران‌خودرو,7705,168397215,642716615920,3804,3850,3841,37,0.97,3817,13,0.34,3750,3890
كدما,معدني‌ دماوند,7593,5341207,472045810010,91770,89100,87300,-4470,-4.87,88380,-3390,-3.69,87190,93500
شتران,پالايش نفت تهران,7564,109287036,599905230730,5390,5400,5530,140,2.6,5490,100,1.86,5370,5620
ثرود,سرمايه‌گذاري مسكن زاينده رود,7518,47968232,553637701390,11690,10990,11850,160,1.37,11540,-150,-1.28,10990,12350
دارا يكم,صندوق واسطه گري مالي يكم-سهام,7489,5084637,589019207290,115300,115400,116580,1280,1.11,115840,540,0.47,115130,116650
مديريت,س. و خدمات مديريت صند. ب كشوري,7426,55201530,525656596760,9050,9110,9590,540,5.97,9520,470,5.19,8700,9590
حكشتي,كشتيراني جمهوري اسلامي ايران,7419,56558716,1297376112720,22070,22190,23170,1100,4.98,22940,870,3.94,22130,23170
شبندر,پالايش نفت بندرعباس,7317,73475863,656297393860,8770,8850,9010,240,2.74,8930,160,1.82,8760,9180
خساپا,سايپا,7180,256808987,528796494181,2049,2056,2074,25,1.22,2059,10,0.49,2027,2090
تفارس,تامين سرمايه خليج فارس,6962,62466036,205888054656,3200,3296,3296,96,3,3296,96,3,3296,3296
سپيد,سپيد ماكيان,6693,23607635,542562448080,22010,22900,23000,990,4.5,22980,970,4.41,22370,23110
فملي,ملي‌ صنايع‌ مس‌ ايران‌,6534,73465016,543327700110,7450,7400,7410,-40,-0.54,7400,-50,-0.67,7360,7460
وتجارت,بانك تجارت,6047,194807721,418415506405,2130,2155,2176,46,2.16,2148,18,0.85,2128,2179
وبملت,بانك ملت,5718,205057097,796239173591,3861,3890,3950,89,2.31,3883,22,0.57,3810,3955
تسه1401,امتيازتسهيلات مسكن سال1401,5666,291204,340610927726,1170444,1150000,1178000,7556,0.65,1169664,-780,-0.07,1140000,1228000
وسپهر,سرمايه گذاري مالي سپهرصادرات,5657,31948202,282420484240,8400,8750,8900,500,5.95,8840,440,5.24,8530,8900
كمند,صندوق س. با درآمد ثابت كمند,5609,243594227,2463386406710,10108,10113,10113,5,0.05,10113,5,0.05,10112,10114
غدام,خوراك‌  دام‌ پارس‌,4973,4107243,233571286370,59230,59020,56980,-2250,-3.8,56870,-2360,-3.98,56270,60000
ذوب,ذوب آهن اصفهان,4936,96731752,270243235468,2805,2800,2790,-15,-0.53,2794,-11,-0.39,2760,2830
انرژي,بورس انرژي ايران,4712,4256400,252226040280,59730,59450,59050,-680,-1.14,59260,-470,-0.79,58000,60800
غزر,صنعتي زر ماكارون,4425,15952009,162903710120,9950,9980,10150,200,2.01,10210,260,2.61,9820,10440
تپكو,توليدتجهيزات‌سنگين‌هپكو,4327,121476365,209326353504,1681,1731,1715,34,2.02,1723,42,2.5,1690,1731
آريا,پليمر آريا ساسول,4196,1937135,153847970450,79100,79700,79550,450,0.57,79400,300,0.38,78950,80800
شبريز,پالايش نفت تبريز,4096,27793694,642493528820,22340,22340,23510,1170,5.24,23120,780,3.49,22300,23680
خزر,فنرسازي‌زر,4093,52499718,175312857553,3268,3280,3296,28,0.86,3339,71,2.17,3217,3455
كزغال,زغال سنگ پروده طبس,3947,12829467,270288339800,20050,20150,21250,1200,5.99,21050,1000,4.99,20150,21250
فلوله,لوله‌وماشين‌سازي‌ايران‌,3927,114941752,226918849604,1947,1910,2000,53,2.72,1974,27,1.39,1850,2040
فرابورس,فرابورس ايران,3837,17193669,240519447100,14090,13900,14010,-80,-0.57,13990,-100,-0.71,13800,14450
بهير,س. توسعه تجارت هيرمند,3671,4596300,37367919000,7900,8130,8130,230,2.91,8130,230,2.91,8130,8130
حگهر,حمل و نقل گهرترابر سيرجان,3625,21887486,187075862590,8870,8550,8410,-460,-5.19,8550,-320,-3.61,8340,8990
هاي وب,داده گسترعصرنوين-هاي وب,3608,35091878,348516769600,9560,9520,9890,330,3.45,9930,370,3.87,9520,10120
خپارس,پارس‌ خودرو,3576,129066767,151403460807,1173,1191,1181,8,0.68,1173,0,0,1155,1191
ضخود3057,اختيارخ خودرو-2000-1401/03/04,3564,200009,46542069000,230,240,250,20,8.7,233,3,1.3,213,257
خبهمن,گروه‌بهمن‌,3543,143747485,266600050198,1851,1865,1869,18,0.97,1855,4,0.22,1843,1890
رمپنا,گروه مپنا (سهامي عام),3514,25376776,470398043220,17610,18660,18410,800,4.54,18540,930,5.28,17660,18660
كالا,بورس كالاي ايران,3461,8730354,229358567970,26120,26630,26290,170,0.65,26270,150,0.57,25890,26900
فجهانح,ح. مجتمع جهان فولاد سيرجان,3371,4695661,8360589632,1792,1800,1781,-11,-0.61,1780,-12,-0.67,1755,1801
كيان,صندوق س. با درآمد ثابت كيان,3357,28038430,981514470818,34972,35006,35004,32,0.09,35006,34,0.1,35004,35008
نوري,پتروشيمي نوري,3349,2563604,302730748650,118040,118490,118100,60,0.05,118090,50,0.04,117970,118490
خاور,ايران خودرو ديزل,3292,175018876,293654980431,1630,1678,1678,48,2.94,1678,48,2.94,1652,1678
سبزوا,سيمان لار سبزوار,3266,34523610,150273001278,4250,4420,4337,87,2.05,4353,103,2.42,4260,4490
خزاميا,زامياد,3217,31988585,309890511350,9350,9560,9810,460,4.92,9690,340,3.64,9500,9810
غگل,گلوكوزان‌,3213,28320970,150629953370,5300,5410,5290,-10,-0.19,5320,20,0.38,5170,5500
ولپارس,ليزينگ پارسيان,3193,17585692,57328431708,3227,3120,3388,161,4.99,3260,33,1.02,3066,3388
كاما,باما,3188,25641844,160846638210,6290,6350,6320,30,0.48,6270,-20,-0.32,6150,6450
چخزر,صنايع چوب خزر كاسپين,3156,2213478,66408335550,29000,29100,30450,1450,5,30000,1000,3.45,29100,30450
سمگا,گروه سرمايه گذاري ميراث فرهنگي,3108,21636249,200454370550,8920,8720,9420,500,5.61,9260,340,3.81,8720,9450
فجهان,مجتمع جهان فولاد سيرجان,3092,11079280,37763231402,3454,3390,3398,-56,-1.62,3435,-19,-0.55,3390,3460
پارس,پتروشيمي پارس,3092,67339216,186442164673,2725,2740,2799,74,2.72,2769,44,1.61,2706,2799
گدنا,تهيه توزيع غذاي دنا آفرين فدك,3054,3409597,48473611300,13780,13510,14260,480,3.48,14220,440,3.19,13510,14430
ورنا,سرمايه‌گذاري‌ رنا(هلدينگ‌,3030,52447571,298120600490,5730,5730,5660,-70,-1.22,5680,-50,-0.87,5520,5890
ثاميد,توسعه و عمران اميد,3006,53471162,88578582960,1579,1649,1657,78,4.94,1657,78,4.94,1626,1657
شپاكسا,پاكسان‌,2905,59543144,165899759162,2881,2909,2713,-168,-5.83,2786,-95,-3.3,2710,2909
وغدير,سرمايه‌گذاري‌غدير(هلدينگ‌,2851,19495761,288494875050,14620,14520,14710,90,0.62,14800,180,1.23,14520,15100
قچار,فراوردههاي غذايي وقند چهارمحال,2784,30222491,325534763060,10610,10590,10940,330,3.11,10770,160,1.51,10590,11000
غبشهر,صنعتي‌ بهشهر,2775,137054270,598997360529,4126,4340,4373,247,5.99,4371,245,5.94,4251,4373
غمارگ,مارگارين‌,2745,69727325,235021958460,3184,3310,3375,191,6,3371,187,5.87,3279,3375
فخوز,فولاد  خوزستان,2733,34311206,202113382850,5950,6000,5890,-60,-1.01,5890,-60,-1.01,5830,6000
پترول,گ.س.وت.ص.پتروشيمي خليج فارس,2728,42962299,100376866606,2315,2291,2356,41,1.77,2336,21,0.91,2291,2372
اعتماد,صندوق س.اعتماد آفرين پارسيان-د,2725,34982750,1556911166430,44476,44504,44506,30,0.07,44505,29,0.07,44504,44507
سيمرغ,سيمرغ,2695,7675700,208707317460,26210,26220,26980,770,2.94,27190,980,3.74,26210,27760
سپيدار,سپيدار سيستم آسيا,2673,1037022,22892399800,22100,22100,22000,-100,-0.45,22100,0,0,21350,22400
لپارس,پارس‌ الكتريك‌,2666,1226634,135572026440,110540,113990,108970,-1570,-1.42,110520,-20,-0.02,108200,113990
تجلي,تجلي توسعه معادن و فلزات,2627,63029757,97086987984,1516,1520,1542,26,1.72,1540,24,1.58,1511,1569
شوينده,مديريت صنعت شوينده ت.ص.بهشهر,2600,6627045,146560424100,23160,22300,22470,-690,-2.98,22120,-1040,-4.49,21780,22770
سامان,بانك سامان,2599,132836536,487807507481,3652,3680,3761,109,2.98,3672,20,0.55,3560,3761
ختوقا,قطعات‌ اتومبيل‌ ايران‌,2581,50121907,170377478827,3243,3250,3437,194,5.98,3399,156,4.81,3250,3437
خنصير,مهندسي‌نصيرماشين‌,2556,8743419,138716723900,15480,15700,15960,480,3.1,15870,390,2.52,15200,16170
وآذر,سرمايه‌گذاري‌توسعه‌آذربايجان‌,2541,2846237,331489322380,111880,117000,117470,5590,5,116470,4590,4.1,112290,117470
بترانس,ايران‌ ترانسفو,2522,70277113,178801844454,2514,2550,2522,8,0.32,2544,30,1.19,2500,2630
سدبير,س. تدبيرگران فارس وخوزستان,2487,5080578,154504499700,28900,29350,30600,1700,5.88,30400,1500,5.19,28500,30600
بورس,بورس اوراق بهادار تهران,2426,18301448,159328411330,8720,8760,8700,-20,-0.23,8710,-10,-0.11,8580,8960
غويتا,ويتانا,2399,30498397,173097547690,5420,5480,5690,270,4.98,5680,260,4.8,5480,5690
شسپا,نفت سپاهان,2377,89672135,314224367077,3411,3480,3510,99,2.9,3504,93,2.73,3431,3580
ومدير,گ.مديريت ارزش سرمايه ص ب كشوري,2376,18057008,82228335110,4404,4400,4590,186,4.22,4554,150,3.41,4336,4611
شاروم,پتروشيمي اروميه,2369,1798358,27960129910,15480,15460,15550,70,0.45,15550,70,0.45,15220,15900
توسن,توسعه سامانه ي نرم افزاري نگين,2348,2359273,50060199650,20950,21600,21000,50,0.24,21200,250,1.19,21000,21650
سصفها,سيمان‌اصفهان‌,2337,4251856,249138774230,56160,58700,58960,2800,4.99,58600,2440,4.34,56300,58960
خموتور,موتورسازان‌تراكتورسازي‌ايران‌,2335,47631977,225944606361,4608,4378,4838,230,4.99,4744,136,2.95,4378,4838
افران,صندوق س افرا نماد پايدار-ثابت,2305,42788846,702351329738,16403,16413,16414,11,0.07,16414,11,0.07,16413,16416
صباح,ح . گروه مالي صبا تامين,2299,23660734,55678591104,2340,2350,2379,39,1.67,2353,13,0.56,2331,2387
فسبزوار,پارس فولاد سبزوار,2294,1634016,45037308800,27480,27420,27490,10,0.04,27560,80,0.29,27420,27990
شگويا,پتروشيمي تندگويان,2278,8113908,98841281500,12120,12150,12200,80,0.66,12170,50,0.41,12110,12440
ثبهساز,بهساز كاشانه تهران,2277,15737417,26110990819,1610,1582,1659,49,3.04,1659,49,3.04,1582,1674
ثالوند,سرمايه گذاري مسكن الوند,2259,24575636,204158315720,8100,8580,8580,480,5.93,8310,210,2.59,7920,8580
وساپا,سرمايه‌گذاري‌ سايپا,2243,44600212,213190082560,4830,4750,4790,-40,-0.83,4780,-50,-1.04,4690,4940
وهامون,سرمايه گذاري هامون صبا,2238,63057683,131171034716,1867,2001,2121,254,13.6,2080,213,11.41,2001,2121
كيمياتك,آريان كيميا تك,2209,1248961,33075110110,26510,26010,26210,-300,-1.13,26480,-30,-0.11,26010,26950
سيتا,سرمايه گذاري سيمان تامين,2179,4503055,50463562360,11240,10810,11380,140,1.25,11210,-30,-0.27,10810,11380
شلرد,كود شيميايي اوره لردگان,2147,13851595,174487006210,12780,12740,12510,-270,-2.11,12600,-180,-1.41,12490,12930
هماي,صندوق س هماي آگاه-ثابت,2117,56775854,569164317045,10018,10025,10025,7,0.07,10025,7,0.07,10023,10025
شبريزح,ح. پالايش نفت تبريز,2110,6598775,102404662600,14890,14750,15800,910,6.11,15520,630,4.23,14750,16000
خچرخش,چرخشگر,2107,16022158,248245563540,14790,15200,15670,880,5.95,15490,700,4.73,14250,15670
غكورش,صنعت غذايي كورش,2104,3945708,179820940750,44160,44790,45190,1030,2.33,45570,1410,3.19,44500,46260
امين يكم,صندوق درآمد ثابت امين يكم فردا,2091,58715845,588462662719,10014,10022,10022,8,0.08,10022,8,0.08,10019,10031
همراه,شركت ارتباطات سيار ايران,2082,22157207,228783580430,9940,10000,10300,360,3.62,10330,390,3.92,9910,10430
بوعلي,پتروشيمي بوعلي سينا,2057,555480,49113119360,87690,88300,88600,910,1.04,88060,370,0.42,87690,89500
ساينا,صنايع بهداشتي ساينا,2056,1519254,131113141700,90500,89000,85600,-4900,-5.41,86300,-4200,-4.64,85100,93500
صبا,گروه مالي صبا تامين,2048,20293856,99479120510,4890,4800,4950,60,1.23,4900,10,0.2,4800,4950
تليسه,دامداري تليسه نمونه,1998,36381268,165711665342,4313,4400,4571,258,5.98,4555,242,5.61,4400,4571
قرن,پديده شيمي قرن,1994,4189524,100295006850,24390,24300,23950,-440,-1.8,23940,-450,-1.85,23500,24770
پارند2,صندوق س. پارند پايدار سپهر,1975,197500000,197500000,10108,1,1,-10107,-99.99,1,-10107,-99.99,1,1
اعتلا,شركت سرمايه گذاري اعتلاء البرز,1971,27116485,120087828286,4695,4500,4420,-275,-5.86,4429,-266,-5.67,4414,4585
شپلي,پلي اكريل ايران,1966,16075748,121589080410,7660,7480,7620,-40,-0.52,7560,-100,-1.31,7440,7880
آبين,كشت و صنعت آبشيرين,1935,24368037,119112222966,4803,4947,4820,17,0.35,4888,85,1.77,4688,4947
فگستر,گسترش صنايع روي ايرانيان,1903,5348755,42570241450,7670,7760,8040,370,4.82,7960,290,3.78,7570,8050
حفاري,حفاري شمال,1879,24780155,110307259967,4475,4351,4517,42,0.94,4451,-24,-0.54,4351,4550
بپيوند,برق و انرژي پيوندگستر پارس,1876,2687391,36091661130,12670,13430,13430,760,6,13430,760,6,13430,13430
ورازي,بيمه رازي,1861,68572773,141349981321,2003,2060,2060,57,2.85,2061,58,2.9,2038,2063
پارند,صندوق س. پارند پايدار سپهر,1855,61327060,620245784805,10108,10114,10114,6,0.06,10114,6,0.06,10113,10114
كماسه,تامين‌ ماسه‌ ريخته‌گري‌,1854,33482587,134583430356,4038,4030,4040,2,0.05,4020,-18,-0.45,3902,4111
فافزا,فولاد افزا سپاهان,1852,1591507,89680398450,55750,56100,55900,150,0.27,56350,600,1.08,54500,57400
غگيلا,شيرپاستوريزه پگاه گيلان,1833,4003756,62474028520,14880,14850,15620,740,4.97,15600,720,4.84,14850,15620
وتوصا,گروه س توسعه صنعتي ايران,1793,13134257,128308514890,9700,9750,9800,100,1.03,9770,70,0.72,9600,9950
وسبحان,سرمايه گذاري سبحان,1788,85540592,352526518815,3904,3865,4138,234,5.99,4121,217,5.56,3801,4138
وگستر,گسترش سرمايه گذاري ايرانيان,1756,12602850,87558439320,7310,7340,6940,-370,-5.06,6950,-360,-4.92,6880,7340
وتوكا,سرمايه‌گذاري‌توكافولاد(هلدينگ,1748,15995344,173227094830,10230,10230,10840,610,5.96,10830,600,5.87,10230,10840
آبادا,توليد نيروي برق آبادان,1737,2764563,36768687900,12670,13300,13300,630,4.97,13300,630,4.97,13300,13300
اخابر,مخابرات ايران,1702,58610701,480034369670,7750,7850,8210,460,5.94,8190,440,5.68,7850,8210
كلر,كلر پارس,1701,961051,86751450550,91650,91500,89600,-2050,-2.24,90250,-1400,-1.53,89200,93950
ثشاهد,سرمايه‌ گذاري‌ شاهد,1696,11774737,112075003760,9200,9210,9520,320,3.48,9520,320,3.48,9210,9690
امين,تامين سرمايه امين,1679,771041,8304694630,10770,10770,10770,0,0,10770,0,0,10770,10780
وپارس,بانك‌پارسيان‌,1668,37393282,74058199466,1974,1975,1979,5,0.25,1978,4,0.2,1947,2020
اهرم,صندوق س سهامي كاريزما- اهرمي,1638,43173701,584334217230,13470,13510,13680,210,1.56,13530,60,0.45,13450,13720
بگيلان,توسعه مسير برق گيلان,1626,1232272,19013956960,14700,15430,15430,730,4.97,15220,520,3.54,15430,15430
خكاوه,سايپا ديزل,1624,18017501,164384517240,8910,8710,9130,220,2.47,9120,210,2.36,8710,9170
پيزد,مجتمع صنايع لاستيك يزد,1619,2893253,37674286560,12670,13000,13140,470,3.71,13020,350,2.76,12420,13280
رافزا,رايان هم افزا,1617,173816,9589260850,54350,52000,54550,200,0.37,54900,550,1.01,52000,57000
دتوليد,داروسازي توليد دارو,1611,8212320,75569304560,9490,9710,9100,-390,-4.11,9200,-290,-3.06,8930,9780
چكاپا,گروه صنايع كاغذ پارس,1608,44486607,148361960514,3194,3225,3353,159,4.98,3335,141,4.41,3200,3353
وسينا,بانك سينا,1589,77305165,185858695230,2378,2429,2432,54,2.27,2404,26,1.09,2360,2510
شصدف,صنعتي دوده فام,1588,2257335,78455299800,33450,34500,34550,1100,3.29,34750,1300,3.89,34000,35100
بنو,بيمه تجارت نو,1586,16442973,98639189010,5770,5800,6050,280,4.85,6000,230,3.99,5560,6050
زماهان,مجتمع توليد گوشت مرغ ماهان,1584,11777049,108353287230,8720,8870,9240,520,5.96,9200,480,5.5,8870,9240
خصدرا,صنعتي‌ دريايي‌ ايران‌,1584,52478822,103877299660,1932,1900,1989,57,2.95,1979,47,2.43,1900,1989
ضخود4011,اختيارخ خودرو-2000-1401/04/08,1577,65937,20398912000,313,319,318,5,1.6,309,-4,-1.28,296,330
كفپارس,فرآورده‌هاي‌ نسوز پارس‌,1545,20151361,92728399480,4795,4690,4561,-234,-4.88,4602,-193,-4.03,4560,4750
كترام,توليدي‌ كاشي‌ تكسرام‌,1545,3570720,99487562030,29020,27570,27630,-1390,-4.79,27860,-1160,-4,27570,29280
ثفارس,عمران‌وتوسعه‌فارس‌,1536,16314028,113846520160,6740,7010,6870,130,1.93,6980,240,3.56,6690,7070
خودكفا,اقتصادي و خودكفايي آزادگان,1536,13820846,105107398910,7420,7300,7640,220,2.96,7600,180,2.43,7300,7640
بكاب,صنايع‌جوشكاب‌يزد,1516,1128175,72477649440,64520,64600,64160,-360,-0.56,64240,-280,-0.43,62980,66100
آپ,آسان پرداخت پرشين,1514,9035728,63295001300,6810,6800,7010,200,2.94,7000,190,2.79,6800,7080
زنجان,صنايع كشاورزي وكود زنجان,1491,16202272,64363935192,4070,3961,3988,-82,-2.01,3973,-97,-2.38,3948,4070
ديران,ايران‌دارو,1484,4972358,101532215540,20470,20000,20380,-90,-0.44,20420,-50,-0.24,19750,21290
وبرق,س.کارکنان صنعت برق زنجان وقزوي,1475,1096419,89034703150,83000,84000,80550,-2450,-2.95,81200,-1800,-2.17,80550,84000
قشرين,قند شيرين خراسان,1462,11123371,58504902860,5290,5420,5250,-40,-0.76,5260,-30,-0.57,5140,5440
كفرآور,فرآورده هاي سيمان شرق,1460,7352123,134587193800,18750,18250,18200,-550,-2.93,18300,-450,-2.4,18200,18950
پتاير,ايران‌ تاير,1456,30773568,49794294760,1590,1619,1614,24,1.51,1618,28,1.76,1590,1667
ولشرق,ليزينگ ايران و شرق,1443,25960662,64196504151,2526,2500,2501,-25,-0.99,2473,-53,-2.1,2375,2561
زدشت,كشت و صنعت دشت خرم دره,1433,4251980,121909110800,27350,28200,28500,1150,4.2,28650,1300,4.75,27800,28950
ثمسكن,سرمايه‌گذاري‌ مسكن‌,1418,17803342,76168092651,4175,4276,4289,114,2.73,4278,103,2.47,4100,4350
ولكار,ليزينگ كارآفرين,1415,2417439,15564319930,6420,6420,6500,80,1.25,6440,20,0.31,6420,6520
لكما,كارخانجات‌مخابراتي‌ايران‌,1415,54758467,49855005809,889,899,915,26,2.92,910,21,2.36,893,915
غسالم,سالمين‌,1411,11718232,41829041732,3535,3500,3532,-3,-0.08,3570,35,0.99,3448,3668
آرام,صندوق س شاخصي آرام مفيد,1408,6292672,69646552700,11040,11050,11100,60,0.54,11070,30,0.27,11040,11120
فاسمين,كالسيمين‌,1401,5813753,121006937620,20760,20500,20980,220,1.06,20810,50,0.24,20500,21100
ولساپا,ليزينگ رايان‌ سايپا,1385,47815067,77136357537,1596,1600,1630,34,2.13,1613,17,1.07,1583,1650
ميدكو,توسعه معادن وص.معدني خاورميانه,1371,5598102,256162631300,45580,45580,46150,570,1.25,45760,180,0.39,45580,46150
لطيف,محصولات كاغذي لطيف,1367,243119,11008654950,44200,44600,44900,700,1.58,45300,1100,2.49,44550,46300
فگسترح,ح . گسترش صنايع روي ايرانيان,1362,841738,4127323049,4791,4742,4900,109,2.28,4903,112,2.34,4742,4990
سرو,صندوق س سروسودمند مدبران-سهام,1357,5271630,425935676460,79280,81900,80900,1620,2.04,80800,1520,1.92,79570,81900
زگلدشت,كشت و دام گلدشت نمونه اصفهان,1340,9010281,103247108480,10840,11220,11490,650,6,11460,620,5.72,11200,11490
سفارس,سيمان فارس و خوزستان,1320,5960292,125132936870,21170,21500,20980,-190,-0.9,20990,-180,-0.85,20800,21500
شكربن,كربن‌ ايران‌,1301,18089324,70580421775,3905,4050,3900,-5,-0.13,3902,-3,-0.08,3809,4050
حگردش,ريل گردش ايرانيان,1291,16112485,41051029096,2594,2656,2550,-44,-1.7,2548,-46,-1.77,2517,2656
كچاد,معدني‌وصنعتي‌چادرملو,1291,6626476,109512716080,16440,16490,16750,310,1.89,16520,80,0.49,16410,16760
مفاخر,توسعه فناوري اطلاعات خوارزمي,1290,3353443,179697743300,51700,50100,54500,2800,5.42,53600,1900,3.68,50100,54750
زفكا,كشت و دامداري فكا,1272,9698037,103384654680,10270,10450,10470,200,1.95,10660,390,3.8,10230,10880
طلا,صندوق س.پشتوانه طلاي لوتوس,1269,605521,62078612667,102443,102990,102333,-110,-0.11,102521,78,0.08,102320,102990
فزرين,زرين معدن آسيا,1267,7639138,55554079720,7020,7000,7240,220,3.13,7270,250,3.56,7000,7400
ثاخت,بين‌المللي‌توسعه‌ساختمان,1264,26553462,61988071523,2303,2300,2340,37,1.61,2334,31,1.35,2274,2388
وكبهمن,مديريت سرمايه گذاري كوثربهمن,1257,1625522,9954633110,6060,6130,6100,40,0.66,6120,60,0.99,6080,6190
خريخت,صنايع‌ريخته‌گري‌ايران‌,1256,21571679,73806582425,3448,3310,3402,-46,-1.33,3421,-27,-0.78,3310,3521
گكيش,توريستي ورفاهي آبادگران كيش,1239,2055678,70209651300,34450,33450,34300,-150,-0.44,34150,-300,-0.87,33450,35450
ملت,بيمه ملت,1226,45937271,58927185749,1249,1236,1297,48,3.84,1283,34,2.72,1235,1320
ماديرا,صنايع ماديران,1219,15052733,50356473313,3313,3330,3390,77,2.32,3345,32,0.97,3250,3440
ونوين,بانك‌اقتصادنوين‌,1213,22991592,88002511409,3807,3750,3861,54,1.42,3828,21,0.55,3750,3874
افق,فروشگاههاي زنجيره اي افق كوروش,1206,1163950,54680357120,45520,45000,47310,1790,3.93,46930,1410,3.1,45000,47490
جم پيلن,پتروشيمي جم پيلن,1196,1160683,156707620840,134630,135460,134610,-20,-0.01,135010,380,0.28,134400,136990
غشهداب,كشت و صنعت شهداب ناب خراسان,1194,18111915,50284657468,2684,2710,2758,74,2.76,2776,92,3.43,2710,2830
غصينو,صنعتي مينو,1193,7551502,119411721610,15090,15840,15840,750,4.97,15810,720,4.77,15030,15840
فاراك,ماشين‌ سازي‌ اراك‌,1186,57204226,95129138699,1598,1620,1677,79,4.94,1663,65,4.07,1605,1677
پارسيان,بيمه پارسيان,1174,21308143,76620001904,3589,3478,3603,14,0.39,3596,7,0.2,3478,3700
شغدير,پتروشيمي غدير,1174,1059915,101390020190,93980,94990,97350,3370,3.59,95660,1680,1.79,94220,97990
فتوسا,توليد و توسعه سرب روي ايرانيان,1173,3736853,31053248430,7920,8310,8310,390,4.92,8310,390,4.92,8310,8310
فروي,ذوب روي اصفهان,1172,2235530,37081191180,16480,16500,16590,110,0.67,16590,110,0.67,16400,16880
اپال,فرآوري معدني اپال كاني پارس,1150,1489328,30406139110,20570,20030,20300,-270,-1.31,20530,-40,-0.19,20000,20700
زبينا,كشاورزي و دامپروري بينالود,1140,16915093,56128952839,3194,3230,3350,156,4.88,3318,124,3.88,3230,3385
فباهنر,مس‌ شهيدباهنر,1128,2003792,64574092220,31920,31680,32590,670,2.1,32230,310,0.97,31680,32690
سشمال,سيمان‌ شمال‌,1127,5110496,63095055720,11890,11820,12600,710,5.97,12350,460,3.87,11280,12600
فارس,صنايع پتروشيمي خليج فارس,1122,12112310,102392372750,8460,8410,8450,-10,-0.12,8450,-10,-0.12,8330,8490
سفار,سيمان‌فارس‌,1120,1100994,102899787430,90160,94610,91530,1370,1.52,93460,3300,3.66,91260,94660
حآسا,آسيا سير ارس,1116,2873594,38763192790,13390,13050,13580,190,1.42,13490,100,0.75,13050,13840
سدشت,صنايع سيمان دشتستان,1110,1521503,50994416120,35060,34000,33310,-1750,-4.99,33520,-1540,-4.39,33310,34450
خفولا,خدمات فني فولاد يزد,1103,4661941,87600777450,18280,18820,18820,540,2.95,18790,510,2.79,18390,18820
دسانكو,داروسازي سبحان انكولوژي,1100,4026291,45796515900,11360,11240,11390,30,0.26,11370,10,0.09,11240,11590
ولراز,ليزينگ رازي,1097,1948557,55287766500,28250,29050,28000,-250,-0.88,28350,100,0.35,27500,29050
خكمك,كمك‌فنرايندامين‌,1097,3940942,84613691190,21640,21610,21500,-140,-0.65,21470,-170,-0.79,20580,22600
ختور,رادياتور ايران‌,1093,4541872,60322296390,13040,13040,13320,280,2.15,13280,240,1.84,13000,13420
فسرب,ملي‌ سرب‌وروي‌ ايران‌,1088,20866884,36707345814,1708,1750,1758,50,2.93,1759,51,2.99,1710,1790
البرز,بيمه البرز,1088,52551294,131050557863,2465,2470,2480,15,0.61,2494,29,1.18,2431,2525
كارا,صندوق س. كارا -د,1085,52675726,600544670315,11393,11400,11401,8,0.07,11401,8,0.07,11400,11402
شسينا,صنايع‌شيميايي‌سينا,1077,26880381,54018965474,1985,2000,2008,23,1.16,2010,25,1.26,1951,2033
زشريف,كشت وصنعت شريف آباد,1077,15307664,66866748783,4148,4090,4396,248,5.98,4368,220,5.3,4090,4396
وجامي,سرمايه گذاري جامي,1070,11248596,49079467082,4326,4197,4455,129,2.98,4363,37,0.86,4197,4455
كيسون,شركت كيسون,1059,25325324,43972389382,1725,1752,1717,-8,-0.46,1736,11,0.64,1705,1776
كپارس,كاشي‌ پارس‌,1053,3762747,37738241170,10240,9910,9930,-310,-3.03,10030,-210,-2.05,9820,10200
وملي,گروه‌ صنعتي‌ ملي‌ (هلدينگ‌,1051,398856,57717586170,143870,142300,144200,330,0.23,144710,840,0.58,142300,148000
زپارس,ملي كشت و صنعت و دامپروري پارس,1043,3432349,130443553290,37050,37060,38650,1600,4.32,38000,950,2.56,37060,38800
غچين,كشت‌ و صنعت‌ چين‌ چين,1042,3816276,49217321130,13280,13000,12770,-510,-3.84,12900,-380,-2.86,12670,13280
كحافظ,كاشي‌ وسراميك‌ حافظ‌,1041,10828300,54755372056,5020,5085,5020,0,0,5057,37,0.74,4950,5150
شاراك,پتروشيمي شازند,1038,1873629,87536880970,46560,46900,47210,650,1.4,46700,140,0.3,46000,47240
خمهر,مهركام‌پارس‌,1037,19082915,40304383173,2089,2080,2135,46,2.2,2112,23,1.1,2052,2170
نطرين,عطرين نخ قم,1036,5960867,34592256270,5590,5620,5910,320,5.72,5800,210,3.76,5580,5920
تملت,تامين سرمايه بانك ملت,1019,9560588,36103335688,3778,3700,3778,0,0,3776,-2,-0.05,3700,3848
وپويا,سرمايه گذاري پويا,1018,10153924,25874845552,2406,2550,2550,144,5.99,2548,142,5.9,2488,2550
كگل,معدني و صنعتي گل گهر,1018,4923172,66890298200,13610,13660,13610,0,0,13600,-10,-0.07,13410,13660
پاكشو,گروه صنعتي پاكشو,1018,8792762,59148099050,6740,6850,6680,-60,-0.89,6730,-10,-0.15,6650,6850
ثنور,سرمايه گذاري كوه نور,1016,6248396,50496721130,8110,8190,8130,20,0.25,8080,-30,-0.37,7870,8230
كسرا,سراميك‌هاي‌صنعتي‌اردكان‌,1015,11323821,82340087740,7280,7110,7190,-90,-1.24,7270,-10,-0.14,7110,7460
آگاس,صندوق س.هستي بخش آگاه-س,1002,843673,73618691028,86395,87198,87553,1158,1.34,87260,865,1,86901,87820
وگردش,بانك گردشگري,998,7077645,77190060660,11160,10830,10950,-210,-1.88,10910,-250,-2.24,10830,11180
وشمال,س. چشم انداز توسعه شمال,982,2412729,57565101400,23450,23650,23500,50,0.21,23850,400,1.71,23300,23900
گشان,توسعه بين المللي پديده شانديز,979,2335134,47264838850,20000,20200,20300,300,1.5,20250,250,1.25,20000,20400
سشرق,سيمان‌ شرق‌,978,6726740,59837460630,8970,9130,8860,-110,-1.23,8900,-70,-0.78,8760,9130
ضهرم6003,اختيارخ اهرم-13000-1401/06/30,974,55542,1310788770,2101,2151,2500,399,18.99,2360,259,12.33,2151,2500
فرآور,فرآوري‌موادمعدني‌ايران‌,972,2266136,77585173170,34130,34970,34090,-40,-0.12,34240,110,0.32,33600,35510
پدرخش,درخشان‌ تهران‌,966,5470928,41776630820,7380,7480,7740,360,4.88,7640,260,3.52,7100,7740
ثبات,صندوق س. ثبات ويستا -د,965,43107856,500333614214,11601,11606,11607,6,0.05,11607,6,0.05,11606,11613
شيران,س. صنايع‌شيميايي‌ايران,965,3536726,71161381970,20010,20000,20300,290,1.45,20110,100,0.5,19920,20580
وپست,پست بانك ايران,964,21496750,86686448420,4039,4060,4044,5,0.12,4033,-6,-0.15,3993,4113
ضسپا3015,اختيارخ خساپا-2000-1401/03/25,963,46609,6517345000,145,150,140,-5,-3.45,140,-5,-3.45,135,150
زنگان,صنعت روي زنگان,957,893585,48693026050,55500,56000,53900,-1600,-2.88,54500,-1000,-1.8,53500,57500
فيروزا,صندوق ارمغان فيروزه آسيا-ثابت,957,17420275,490908550223,28152,28173,28172,20,0.07,28180,28,0.1,28172,30967
پسهند,صنايع‌ لاستيكي‌  سهند,954,3685628,141071216080,37330,37880,39180,1850,4.96,38280,950,2.54,36530,39190
بالاس,مهندسي ساختمان تاسيسات راه آهن,954,1368134,42430346300,30200,30850,31200,1000,3.31,31000,800,2.65,29900,31650
وصنعت,سرمايه گذاري توسعه صنعت وتجارت,954,21747489,50155126561,2301,2300,2299,-2,-0.09,2306,5,0.22,2271,2370
شفارس,صنايع‌ شيميايي‌ فارس‌,953,22981437,31164834292,1364,1375,1350,-14,-1.03,1356,-8,-0.59,1330,1397
آكورد,صندوق س. آرمان آتي كوثر-د,950,8242389,320627568083,38869,38899,38899,30,0.08,38900,31,0.08,38899,38902
شجم,صنايع پتروشيمي تخت جمشيد,934,5559445,65121836730,11810,11620,11830,20,0.17,11710,-100,-0.85,11550,11940
كوير,توليدي فولاد سپيد فراب كوير,934,9295768,39179916410,4198,4105,4250,52,1.24,4214,16,0.38,4105,4291
غاذر,كشت‌وصنعت‌پياذر,933,1718804,106833788350,59260,60090,62220,2960,4.99,62160,2900,4.89,60090,62220
كيميا,معدني كيمياي زنجان گستران,920,4759554,32481029510,6810,6800,6800,-10,-0.15,6820,10,0.15,6730,6980
تابا,تابان نيرو سپاهان,915,2143805,50485084250,23000,23500,23650,650,2.83,23550,550,2.39,22950,23650
ميهن,بيمه ميهن,904,18331217,68617729675,3647,3750,3825,178,4.88,3743,96,2.63,3521,3828
تاپيكو,س. نفت و گاز و پتروشيمي تأمين,903,6552933,108898470720,16490,16350,16820,330,2,16610,120,0.73,16350,17020
بهپاك,صنعتي بهپاك,899,8674268,69767962270,7730,7610,7900,170,2.2,8040,310,4.01,7610,8190
جوين,كشت و صنعت جوين,898,12824877,84688269480,6210,6600,6630,420,6.76,6600,390,6.28,6450,6790
وآوا,سرمايه گذاري آوا نوين,896,9678328,35931181029,3517,3500,3728,211,6,3713,196,5.57,3500,3728
خاهن,آهنگري‌ تراكتورسازي‌ ايران‌,893,6262188,36520775820,5800,5730,5990,190,3.28,5830,30,0.52,5630,6070
درهآور,دارويي ره آورد تامين,883,2261902,81265544050,35700,36900,35350,-350,-0.98,35950,250,0.7,35000,37350
خاذين,سايپاآذين‌,879,15015428,30685043044,2043,2050,2030,-13,-0.64,2044,1,0.05,2002,2095
ثنوسا,نوسازي‌وساختمان‌تهران‌,878,8413903,41280400320,4810,4830,4920,110,2.29,4910,100,2.08,4830,4980
حسير,ريل سير كوثر,876,2918257,54893991350,18850,18350,19000,150,0.8,18800,-50,-0.27,18350,19300
وبانك,سرمايه گذاري گروه توسعه ملي,871,10317237,106557490060,10230,10340,10310,80,0.78,10320,90,0.88,10270,10400
غبهار,كشت وصنعت بهاران گلبهار خراسان,860,2514416,39010668220,15690,15220,15710,20,0.13,15510,-180,-1.15,15220,16130
چدن,توليدي چدن سازان,856,15642145,37875650798,2424,2382,2416,-8,-0.33,2421,-3,-0.12,2380,2478
خرينگ,رينگ‌سازي‌مشهد,849,1547655,37037604020,23170,23170,24250,1080,4.66,23930,760,3.28,22740,24310
سپاها,سيمان‌سپاهان‌,848,7046298,71184665780,10060,10050,10140,80,0.8,10100,40,0.4,9970,10300
شلعاب,لعابيران‌,846,4826683,29044978460,6030,6100,5930,-100,-1.66,6020,-10,-0.17,5850,6290
شپديس,پتروشيمي پرديس,842,869649,154403942630,177420,176020,177670,250,0.14,177550,130,0.07,176020,177910
تسه9903,امتياز تسهيلات مسكن خرداد99,840,11260,12900464492,1154282,1100500,1165200,10918,0.95,1145690,-8592,-0.74,1096568,1209999
ثتران,سرمايه گذاري مسكن تهران,838,13984492,49590235585,3446,3570,3598,152,4.41,3546,100,2.9,3448,3610
چكارن,كارتن‌ ايران‌,837,19277438,55219323888,2851,2802,2852,1,0.04,2864,13,0.46,2800,2929
كرماشا,صنايع پتروشيمي كرمانشاه,835,2393107,158085291150,65730,64940,66200,470,0.72,66060,330,0.5,64930,67250
تمحركه,ماشين سازي نيرو محركه,832,4026717,49455763770,12140,12130,12380,240,1.98,12280,140,1.15,11900,12380
كرازي,كارخانجات‌توليدي‌شيشه‌رازي‌,830,23019597,37206261421,1604,1601,1605,1,0.06,1616,12,0.75,1600,1670
نوين,بيمه نوين,827,15762090,32234367246,2059,2070,2055,-4,-0.19,2045,-14,-0.68,2000,2135
دجابر,داروسازي‌ جابرابن‌حيان‌,823,3572723,43520072970,12250,11900,12140,-110,-0.9,12180,-70,-0.57,11850,12600
ماديراح,ح صنايع ماديران,819,15559269,26318800674,1661,1650,1692,31,1.87,1692,31,1.87,1637,1740
تسه1400,امتيازتسهيلات مسكن سال1400,817,9142,10712094445,1171183,1112700,1210000,38817,3.31,1171745,562,0.05,1112700,1229742
زكوثر,سرمايه گذاري كشاورزي كوثر,815,2338352,39538331890,16350,17200,16730,380,2.32,16910,560,3.43,16510,17240
قجام,فرآوردههاي غذايي وقندتربت‌جام‌,811,9823771,61539119800,6220,6230,6240,20,0.32,6260,40,0.64,6130,6340
ثپرديس,سرمايه گذاري مسكن پرديس,810,11710801,56929360613,4743,4771,4790,47,0.99,4861,118,2.49,4752,4997
ونيكي,سرمايه‌گذاري‌ ملي‌ايران‌,805,10821190,107274687480,9870,9910,9990,120,1.22,9910,40,0.41,9820,10050
وسديد,گروه ‌صنعتي‌سديد,804,16214459,23997399320,1437,1480,1480,43,2.99,1480,43,2.99,1480,1480
آ س پ,آ.س.پ,801,11908164,67861478530,5400,5550,5650,250,4.63,5700,300,5.56,5410,5720
كاوه,فولاد كاوه جنوب كيش,799,3716584,47646410400,12900,12630,12850,-50,-0.39,12850,-50,-0.39,12630,12990
فنورد,نوردوقطعات‌ فولادي‌,795,253059,61013656950,241360,250000,237500,-3860,-1.6,241100,-260,-0.11,237500,250000
كنور,توسعه معدني و صنعتي صبانور,793,5466238,108696349740,19830,19450,19970,140,0.71,19890,60,0.3,19440,20020
آباد,توريستي ورفاهي آبادگران ايران,785,1175420,39931106440,33510,32360,34900,1390,4.15,33970,460,1.37,32350,35150
دبالك,مواد اوليه دارويي البرز بالك,782,6462685,68962719490,10110,10000,10710,600,5.93,10670,560,5.54,9920,10710
وثنوح,ح. سرمايه گذاري ساختماني نوين,780,12928371,17193377258,1297,1335,1335,38,2.93,1330,33,2.54,1303,1335
آريان,سرمايه گذاري پارس آريان,778,9361119,66567070410,7090,7020,7210,120,1.69,7100,10,0.14,7020,7250
سمايه,بانك سرمايه,777,8775950,32283460952,3768,3656,3715,-53,-1.41,3679,-89,-2.36,3655,3800
خديزل,بهمن  ديزل,775,18458268,203752488320,10580,10580,11100,520,4.91,11040,460,4.35,10500,11100
غمينو,شركت صنايع غذايي مينو شرق,772,8787435,53642798570,6000,6000,6040,40,0.67,6100,100,1.67,5900,6360
فولاژ,فولاد آلياژي ايران,770,24552037,225448368000,9210,8960,9300,90,0.98,9180,-30,-0.33,8960,9390
كامياب,صندوق س. كامياب آشنا-د,769,18941032,229800908621,12119,12133,12133,14,0.12,12132,13,0.11,12132,12134
سدور,سيمان‌ دورود,768,10792722,81785375530,7230,7430,7580,350,4.84,7580,350,4.84,7300,7590
ستران,سيمان‌ تهران‌,764,1587947,42844733600,26710,26310,27000,290,1.09,26980,270,1.01,25150,27990
هرمز,فولاد هرمزگان جنوب,762,3491464,57686645890,16600,16890,16100,-500,-3.01,16560,-40,-0.24,16100,16890
تسه9904,امتياز تسهيلات مسكن تير99,760,8352,10503619092,1259069,1200004,1284111,25042,1.99,1257617,-1452,-0.12,1200001,1300000
سنير,سيمان‌ سفيد ني‌ريز,759,4120293,174135463520,40260,42270,42270,2010,4.99,42260,2000,4.97,41500,42270
غدشت,دشت‌ مرغاب‌,758,3185838,57743500040,17350,17340,18210,860,4.96,18130,780,4.5,17130,18210
پلاسك,پلاسكوكار,752,14141259,44330745711,3061,3100,3200,139,4.54,3135,74,2.42,3001,3214
سهرمز,سيمان‌هرمزگان‌,746,1772208,41451222920,22460,22800,23560,1100,4.9,23390,930,4.14,22500,23580
وسپه,سرمايه‌گذاري‌ سپه‌,743,4336394,38712431570,8960,8860,9000,40,0.45,8930,-30,-0.33,8860,9000
خلنت,لنت‌ ترمزايران‌,741,529386,18996332110,34890,35890,35570,680,1.95,35880,990,2.84,35000,36530
كبافق,معادن‌ بافق‌,741,949348,35122614890,36470,35160,37300,830,2.28,37000,530,1.45,35160,37560
فنفت,صنايع تجهيزات نفت,736,7260672,237028041550,31700,32650,32650,950,3,32650,950,3,32050,32650
رنيك,جنرال مكانيك,735,2937386,40997109600,14160,13900,13920,-240,-1.69,13960,-200,-1.41,13670,14240
حتايد,تايدواترخاورميانه,734,6735452,39107974680,5810,5810,5850,40,0.69,5810,0,0,5700,5930
زمگسا,كشاورزي‌ ودامپروي‌ مگسال‌,733,1811171,48908863010,25820,26600,27100,1280,4.96,27000,1180,4.57,25900,27110
ريشمك,توليد و صادرات ريشمك,729,928869,26172343300,26800,27500,27700,900,3.36,28200,1400,5.22,26850,28400
فسپا,گروه‌صنعتي‌سپاهان‌,727,1534853,24593858780,15670,15990,15960,290,1.85,16020,350,2.23,15620,16230
شكلر,نيروكلر,717,973741,48788626670,49040,48130,49500,460,0.94,50100,1060,2.16,48130,51970
غنوش,نوش‌ مازندران‌,711,6126435,72927908780,11360,11850,11920,560,4.93,11900,540,4.75,11690,11920
كهمدا,شيشه‌ همدان‌,710,4630854,59244497850,12760,12300,12900,140,1.1,12790,30,0.24,12300,13100
قشكر,شكرشاهرود,709,11627769,28351729650,2407,2440,2398,-9,-0.37,2438,31,1.29,2380,2499
ضسپا3016,اختيارخ خساپا-2500-1401/03/25,702,39293,545577000,16,16,14,-2,-12.5,14,-2,-12.5,10,19
زشگزا,شير و گوشت زاگرس شهركرد,700,4927821,33723744870,6630,6550,6840,210,3.17,6840,210,3.17,6550,7010
تبرك,گروه كارخانجات صنعتي تبرك,698,3642984,35019237800,9210,9130,9580,370,4.02,9610,400,4.34,9120,9670
بجهرم,توسعه مولد نيروگاهي جهرم,695,21141186,53043235674,2390,2509,2509,119,4.98,2509,119,4.98,2509,2509
فولاي,صنايع فولاد آلياژي يزد,690,3858294,36872365350,9510,9500,9600,90,0.95,9560,50,0.53,9300,9710
ساوه,سيمان ساوه,690,389657,19800021950,50200,51350,50200,0,0,50800,600,1.2,49900,51600
بشهاب,لامپ‌  پارس‌ شهاب‌,687,197644,18671910530,93420,95980,94840,1420,1.52,94470,1050,1.12,93000,97000
غگرجي,بيسكويت‌  گرجي‌,676,10466514,19892675643,1871,1898,1903,32,1.71,1901,30,1.6,1863,1950
خكار,ايركا پارت صنعت,673,8798343,24355237175,2712,2799,2796,84,3.1,2768,56,2.06,2665,2800
هم وزن,صندوق س. شاخصي كيان-س,667,4657816,46578160000,10000,10000,10000,0,0,10000,0,0,10000,10000
سفاسي,شركت فارسيت اهواز,665,5931296,18602121434,3231,3135,3135,-96,-2.97,3136,-95,-2.94,3135,3190
وملل,اعتباري ملل,663,5524150,42543780960,7720,7710,7720,0,0,7700,-20,-0.26,7510,7910
خشرق,الكتريك‌ خودرو شرق‌,662,2593067,38059271270,14750,15000,14700,-50,-0.34,14680,-70,-0.47,14400,15000
لسرما,سرما آفرين‌,660,1292971,34105451840,25920,25660,26630,710,2.74,26380,460,1.77,25000,26900
تاپكيش,تجارت الكترونيك پارسيان كيش,659,1682627,23374241710,13920,14090,13780,-140,-1.01,13890,-30,-0.22,13720,14290
پارسان,گسترش نفت و گاز پارسيان,658,3970588,119978344140,30220,30180,30350,130,0.43,30220,0,0,30030,30350
پرديس,سرمايه گذاري پرديس,657,13981686,45239670610,3086,3150,3270,184,5.96,3236,150,4.86,3130,3271
سرچشمه,سرمايه گذاري مس سرچشمه,651,10793205,49065444787,4501,4596,4505,4,0.09,4546,45,1,4458,4620
شپتروح,ح . پتروشيمي آبادان,649,23388938,25086621918,1043,1017,1074,31,2.97,1073,30,2.88,1017,1074
غشصفا,شيرپاستوريزه‌پگاه‌اصفهان‌,648,1273895,25766466010,19930,20470,20060,130,0.65,20230,300,1.51,19850,20790
فپنتا,سپنتا,640,44426,29395251430,666190,650000,649990,-16200,-2.43,661670,-4520,-0.68,641140,677740
زقيام,كشت و دام قيام اصفهان,638,15115742,41348681613,2596,2742,2751,155,5.97,2735,139,5.35,2658,2751
شبهرن,نفت‌ بهران‌,638,2557936,36952458340,14520,14850,14510,-10,-0.07,14480,-40,-0.28,14040,14850
فلامي,لاميران‌,636,1819709,35036673860,18730,18100,19660,930,4.97,19250,520,2.78,18100,19660
غالبر,لبنيات‌ كالبر,636,2012021,22486236340,11070,11160,11080,10,0.09,11180,110,0.99,10910,11450
غفارس,شير پاستوريزه پگاه فارس,634,5509139,34416345450,5970,6100,6260,290,4.86,6250,280,4.69,6100,6260
تاصيكو,سرمايه گذاري صدرتامين,630,12282797,132357446850,10770,10510,10780,10,0.09,10780,10,0.09,10510,10880
شبصير,توليدات پتروشيمي قائد بصير,622,483388,56389422400,115650,116400,117100,1450,1.25,116650,1000,0.86,114900,117650
سيدكو,سرمايه گذاري توسعه صنايع سيمان,620,7131381,57955521980,7960,7970,8270,310,3.89,8130,170,2.14,7910,8270
شگل,گلتاش‌,617,3646603,21947284690,6200,6240,6010,-190,-3.06,6020,-180,-2.9,5850,6250
دارو,كارخانجات‌داروپخش‌,611,1777773,55221550590,30580,31400,31310,730,2.39,31060,480,1.57,30330,31890
فخاس,فولاد خراسان,610,1559732,33488930470,22020,21380,21420,-600,-2.72,21820,-200,-0.91,20970,22000
شفن,پتروشيمي فناوران,606,1262467,15573262370,12220,12330,12250,30,0.25,12240,20,0.16,12200,12490
سغرب,سيمان‌غرب‌,606,2067705,40483808120,19170,19050,19500,330,1.72,19580,410,2.14,19000,20100
ساروم,سيمان‌اروميه‌,604,969268,27510611830,27980,28590,29150,1170,4.18,28380,400,1.43,27320,29300
دامين,داروسازي‌ امين‌,603,7129590,24538725241,3380,3301,3484,104,3.08,3442,62,1.83,3301,3550
سحرخيز,صندوق س. گروه زعفران سحرخيز,599,1290214,25827271956,19630,19611,20389,759,3.87,20018,388,1.98,19611,20389
فسازان,غلتك سازان سپاهان,597,4420785,23901540030,5550,5400,5380,-170,-3.06,5410,-140,-2.52,5340,5620
غپاك,لبنيات‌ پاك‌,597,1972622,24220805280,11870,12240,12280,410,3.45,12280,410,3.45,11880,12440
كساوه,صنايع‌ كاشي‌ و سراميك‌ سينا,587,659185,32898209960,49670,50500,50500,830,1.67,49910,240,0.48,48250,50510
وهور,مديريت انرژي اميد  تابان هور,586,31169480,47377609600,1448,1520,1520,72,4.97,1520,72,4.97,1520,1520
زملارد,كشاورزي و دامپروري ملارد شير,586,732297,10354679580,13470,14140,14140,670,4.97,13910,440,3.27,14140,14140
شكبير,پتروشيمي اميركبير,586,1398392,127538370300,94000,91200,91200,-2800,-2.98,91200,-2800,-2.98,91200,92500
حاريا,كشتيراني آريا,583,3359145,18641923440,5640,5570,5590,-50,-0.89,5550,-90,-1.6,5530,5700
وصنا,گروه‌صنايع‌بهشهرايران‌,583,7517201,26076634208,3354,3317,3434,80,2.39,3469,115,3.43,3317,3539
وحكمت,بيمه حكمت صبا,582,18881001,27290182074,1486,1444,1445,-41,-2.76,1445,-41,-2.76,1442,1490
فنوال,نورد آلومينيوم‌,581,2098453,69506225050,32060,33200,33560,1500,4.68,33120,1060,3.31,32510,33770
بكام,كارخانجات توليدي شهيد قندي,580,9276991,17712821587,1882,1910,1915,33,1.75,1909,27,1.43,1861,1930
چافست,افست‌,578,5835061,29188802270,4850,4990,5090,240,4.95,5000,150,3.09,4690,5090
درسا,صندوق سرمايه گذاري درسا - سهام,577,10000684,100006840000,10000,10000,10000,0,0,10000,0,0,10000,10000
وخاور,بانك خاورميانه,577,12318344,73078394420,5970,5830,5970,0,0,5930,-40,-0.67,5800,6030
اطلس,صندوق س.توسعه اطلس مفيد-س,577,211685,58726443829,275535,275570,278994,3459,1.26,277424,1889,0.69,275570,279895
حپترو,حمل و نقل پتروشيمي( سهامي عام,573,1577620,39949223710,24490,23570,25710,1220,4.98,25320,830,3.39,23570,25710
دروز,داروسازي‌ روزدارو,570,935644,24188978050,25940,25040,25990,50,0.19,25850,-90,-0.35,25030,26460
وتوسم,سرمايه‌گذاري‌توسعه‌ملي‌,569,7375794,33277115035,4531,4531,4557,26,0.57,4512,-19,-0.42,4492,4630
شكام,صنايع شيميايي كيمياگران امروز,567,1444381,48736871950,33800,34400,33750,-50,-0.15,33750,-50,-0.15,33400,34400
حبندر,دريايي و کشتيراني خط دريابندر,564,1367444,50728666800,36100,37150,37150,1050,2.91,37100,1000,2.77,36200,37150
ونفت,سرمايه‌گذاري‌ صنعت‌ نفت‌,563,5782293,25388371153,4319,4396,4388,69,1.6,4391,72,1.67,4340,4480
سكارون,سيمان كارون,561,476106,24829396200,51500,50050,52200,700,1.36,52150,650,1.26,50050,53000
كلوند,كاشي‌ الوند,556,5101894,129688853530,24250,24800,25460,1210,4.99,25420,1170,4.82,24130,25460
ومهان,گروه توسعه مالي مهر آيندگان,554,8544601,48609805880,5620,5800,5620,0,0,5670,50,0.89,5620,5800
بخاور,بيمه زندگي خاورميانه,551,6864457,17465504273,2564,2594,2544,-20,-0.78,2544,-20,-0.78,2500,2635
ختراك,ريخته‌گري‌ تراكتورسازي‌ ايران‌,550,7701945,51524867030,6450,6220,6770,320,4.96,6690,240,3.72,6220,6770
هامرز,صندوق س اعتماد هامرز-ثابت,550,27007189,273129593195,10108,10113,10114,6,0.06,10113,5,0.05,10113,10114
وثنو,سرمايه گذاري ساختماني نوين,547,6717183,16156199481,2377,2440,2380,3,0.13,2405,28,1.18,2360,2447
فردا,صندوق س آواي فرداي زاگرس-ثابت,547,30620006,401825783073,13115,13124,13123,8,0.06,13123,8,0.06,13122,13125
وبوعلي,سرمايه‌گذاري‌بوعلي‌,546,5248359,27464328790,5210,5100,5260,50,0.96,5230,20,0.38,5100,5300
وايران,ليزينگ ايرانيان,546,9572834,26439308803,2626,2716,2783,157,5.98,2762,136,5.18,2600,2783
فن آوا,گروه فن آوا,538,3235003,26910693330,8440,8220,8240,-200,-2.37,8320,-120,-1.42,8190,8570
ثزاگرس,سرمايه گذاري توسعه عمران زاگرس,538,739000,24505941100,33300,33700,33200,-100,-0.3,33150,-150,-0.45,32800,33700
تسه0011,امتيازتسهيلات مسكن بهمن 1400,537,6255,7355822442,1172564,1162010,1195000,22436,1.91,1175991,3427,0.29,1137000,1231192
لپيام,گسترش صنايع پيام,537,1569220,39143045100,24250,24950,24950,700,2.89,24950,700,2.89,24300,24950
ثنام,س ساختماني ب نام آوران مهندسي,537,2745199,16174312220,5970,5820,5960,-10,-0.17,5890,-80,-1.34,5800,6070
كتوكا,توليدي و خدمات صنايع نسوز توكا,529,2207577,19527828370,8670,8720,9000,330,3.81,8850,180,2.08,8500,9090
حآفرين,ريل پرداز نو آفرين,529,3900528,14944474569,3725,3725,3860,135,3.62,3831,106,2.85,3725,3865
حريل,ريل پردازسير,527,6467897,18413185832,2804,2810,2857,53,1.89,2847,43,1.53,2754,2890
وبيمه,سرمايه‌ گذاري‌ صنعت‌ بيمه‌,525,8884442,15258925723,1714,1714,1756,42,2.45,1717,3,0.18,1681,1769
كوثر,بيمه كوثر,522,8026147,32329451402,4078,4025,4007,-71,-1.74,4028,-50,-1.23,3986,4086
لخانه,لوازم‌ خانگي‌ پارس‌,521,1764000,34066645660,18860,18860,19410,550,2.92,19310,450,2.39,18500,19420
اتكام,بيمه اتكايي امين,517,5132232,22673011470,4440,4500,4400,-40,-0.9,4418,-22,-0.5,4340,4570
لخزر,پارس‌ خزر,512,84399,10939737250,128470,131950,128700,230,0.18,129300,830,0.65,127600,131950
شرانل,نفت ايرانول,511,751761,40671765200,53650,53150,54100,450,0.84,54050,400,0.75,53150,54700
جم,پتروشيمي جم,511,3258315,153766847170,47270,46860,47200,-70,-0.15,47190,-80,-0.17,46860,47880
غديس,پاكديس,509,2425081,30235926050,12260,12100,12480,220,1.79,12470,210,1.71,12100,12700
ولغدر,ليزينگ‌خودروغدير,507,2117309,24247010700,11420,11980,11490,70,0.61,11450,30,0.26,11110,11980
عيار,صندوق طلاي عيار مفيد,507,1086899,39654605891,36674,36674,36329,-345,-0.94,36484,-190,-0.52,36276,36674
ضخود4012,اختيارخ خودرو-2200-1401/04/08,506,29449,5073481000,173,175,180,7,4.05,172,-1,-0.58,165,190
حتوكا,حمل‌ونقل‌توكا,504,1658617,27464901380,16010,15300,16530,520,3.25,16560,550,3.44,15300,16810
دلر,داروسازي‌ اكسير,504,1109968,50969856630,45300,45000,46050,750,1.66,45920,620,1.37,45000,46300
وآفر,سرمايه گذاري ارزش آفرينان,503,4185487,128711344500,31650,30750,30750,-900,-2.84,30750,-900,-2.84,30750,31400
كاذر,فرآورده‌هاي‌نسوزآذر,503,1931914,27485386140,14320,13700,14370,50,0.35,14230,-90,-0.63,13700,14730
كپشير,پشم‌شيشه‌ايران‌,500,2445443,28725145000,11340,11590,11900,560,4.94,11750,410,3.62,11110,11900
حفارس,حمل و نقل بين المللي خليج فارس,500,4475529,41443090950,8960,9040,9230,270,3.01,9260,300,3.35,9040,9380
تماوند,تامين سرمايه دماوند,500,5801651,30436949730,5270,5270,5200,-70,-1.33,5250,-20,-0.38,5120,5440
باران,بيمه زندگي باران,497,10067269,35678469659,3460,3361,3563,103,2.98,3544,84,2.43,3361,3563
ماني,صندوق س. با درآمد ثابت ماني,496,11164450,131124792285,11738,11744,11745,7,0.06,11745,7,0.06,11744,11746
تكمبا,كمباين‌ سازي‌ ايران‌,495,6225307,28102171306,4392,4560,4650,258,5.87,4514,122,2.78,4210,4650
آسيا,بيمه آسيا,494,8264828,15372708841,1847,1890,1860,13,0.7,1858,11,0.6,1846,1890
چفيبر,فيبر ايران‌,489,2979816,19030137480,6150,6250,6430,280,4.55,6390,240,3.9,6250,6450
شپترو,پتروشيمي آبادان,486,14789193,33526536376,2205,2200,2271,66,2.99,2267,62,2.81,2200,2271
غشوكو,شوكو پارس,484,2947592,25809840520,8930,8710,9000,70,0.78,8760,-170,-1.9,8670,9050
والبر,سرمايه‌ گذاري‌ البرز(هلدينگ‌,481,6932933,51777625310,7060,7150,7480,420,5.95,7470,410,5.81,7150,7480
دفرا,فرآورده‌هاي‌ تزريقي‌ ايران‌,476,1135114,20889886450,18260,18430,18410,150,0.82,18400,140,0.77,18300,18490
غگلستا,شير پاستوريزه پگاه گلستان,476,2093866,26104513160,12030,12440,12410,380,3.16,12470,440,3.66,12310,12600
كمرجان,بازرگاني و توليدي مرجان كار,469,2401708,14382426420,5850,5980,6030,180,3.08,5990,140,2.39,5810,6150
تكشا,گسترش‌صنايع‌وخدمات‌كشاورزي‌,468,529703,19577435550,37630,37990,37060,-570,-1.51,36960,-670,-1.78,36010,37990
فغدير,آهن و فولاد غدير ايرانيان,467,300000000,5571563392622,1000,25001,17150,16150,1615,18572,17572,1757.2,17150,25001
وبشهر,توسعه‌ صنايع‌ بهشهر(هلدينگ,467,4906012,42819670630,8510,8600,8740,230,2.7,8690,180,2.12,8600,8960
فاذر,صنايع‌ آذرآب‌,465,38257477,43422236395,1081,1135,1135,54,5,1135,54,5,1135,1135
غبهنوش,بهنوش‌ ايران‌,465,369913,21786232920,57110,56580,58480,1370,2.4,58900,1790,3.13,56580,59800
بپاس,بيمه پاسارگاد,463,2675305,133122770600,49700,49750,49750,50,0.1,49750,50,0.1,49700,49850
رانفور,خدمات‌انفورماتيك‌,462,5212404,22519976302,4303,4360,4340,37,0.86,4309,6,0.14,4254,4360
شفارا,پتروشيمي فارابي,459,2866016,16007223250,5680,5690,5540,-140,-2.46,5590,-90,-1.58,5510,5770
وهنر,گروه توسعه هنر ايران,458,5505357,13443000732,2397,2429,2430,33,1.38,2442,45,1.88,2366,2468
كسعدي,كاشي‌ سعدي‌,457,2326471,20965183790,9000,9080,9040,40,0.44,9010,10,0.11,8860,9220
وسكاب,س.ص.بازنشستگي كاركنان بانكها,456,5845053,17528777929,2950,2924,3042,92,3.12,2999,49,1.66,2923,3042
تكنار,مجتمع معادن مس تكنار,455,414407,25077865800,59700,61400,61000,1300,2.18,60500,800,1.34,58600,61450
كگهر,سنگ آهن گهرزمين,452,1168940,58435072400,49900,50200,50150,250,0.5,49950,50,0.1,49450,50700
ثباغ,شهر سازي و خانه سازي باغميشه,449,2199286,18825868980,8350,8470,8500,150,1.8,8560,210,2.51,8220,8850
تپولا,مهندسي مرآت پولاد,447,1631829,23358712670,14730,14330,14290,-440,-2.99,14310,-420,-2.85,14290,14980
سفارود,كارخانه فارسيت درود,447,2023154,13142861100,6430,6310,6490,60,0.93,6500,70,1.09,6310,6550
كروي,توسعه‌ معادن‌ روي‌ ايران‌,446,1436989,37446257100,25860,26680,26130,270,1.04,26060,200,0.77,25730,26680
دزهراوي,داروسازي‌زهراوي‌,445,3520262,18010231770,5040,5270,5140,100,1.98,5120,80,1.59,5030,5270
ركيش,كارت اعتباري ايران كيش,443,2953134,15215453950,5080,5080,5110,30,0.59,5150,70,1.38,5030,5260
قمرو,قند مرودشت‌,443,1191804,32644130350,26470,26030,27790,1320,4.99,27390,920,3.48,26030,27790
قشير,قند شيروان قوچان و بجنورد,443,2557741,18028855740,6900,6890,7010,110,1.59,7050,150,2.17,6660,7170
سخاش,سيمان‌خاش‌,437,265149,17316082060,65550,65550,64600,-950,-1.45,65310,-240,-0.37,63920,66980
خراسان,پتروشيمي خراسان,434,433360,57228290400,132110,130100,132160,50,0.04,132080,-30,-0.02,130100,133740
هجرت,پخش هجرت,434,867218,27452710700,31650,30900,31800,150,0.47,31650,0,0,30900,32450
ولانا,شركت ليزينگ آريا دانا,433,2116569,31191031360,14430,14780,14860,430,2.98,14740,310,2.15,14400,14860
سبهان,سيمان‌ بهبهان‌,433,458066,21519772250,47310,48340,46980,-330,-0.7,46980,-330,-0.7,45020,48340
سكه0312پ01,تمام سكه طرح جديد0312 رفاه,430,231300,336006629400,1458658,1453200,1447001,-11657,-0.8,1452687,-5971,-0.41,1446000,1458000
كسرام,پارس‌ سرام‌,430,8062477,51289962970,6070,6040,6370,300,4.94,6360,290,4.78,6040,6370
گكوثر,هتل پارسيان كوثر اصفهان,430,9739816,16149129164,1641,1585,1655,14,0.85,1658,17,1.04,1585,1701
فراز,صندوق س.سهام فراز داريك-س,429,2404319,36966461800,15347,15360,15400,53,0.35,15375,28,0.18,15359,15700
پلاست,كارخانجات توليدي پلاستيران,427,1483700,24194852280,16720,17200,16220,-500,-2.99,16310,-410,-2.45,16220,17210
آساميد,صندوق س.مشترك آسمان اميد -د,426,9891770,147300855290,14883,14900,14898,15,0.1,14891,8,0.05,14890,14900
فالوم,آلومتك‌,426,1417858,20713486560,14290,14500,14710,420,2.94,14610,320,2.24,14020,14710
غشهد,شهد ايران ‌,425,3627278,21772565390,5730,5940,6010,280,4.89,6000,270,4.71,5770,6010
حسينا,توسعه خدمات دريايي وبندري سينا,424,436350,23237692600,54350,53750,53350,-1000,-1.84,53250,-1100,-2.02,52800,54400
كارين,صندوق س نگين سامان-ثابت,420,16060998,161165737814,10020,10029,10039,19,0.19,10035,15,0.15,10025,10039
سصوفي,سيمان‌ صوفيان‌,420,1129554,21211272980,18910,19010,18800,-110,-0.58,18780,-130,-0.69,18300,19180
فروس,فروسيليس‌ ايران‌,420,2392416,17322741530,7140,7320,7210,70,0.98,7240,100,1.4,7150,7320
تنوين,تامين سرمايه نوين,419,18945985,85313577005,4494,4546,4441,-53,-1.18,4503,9,0.2,4365,4570
قلرست,قند لرستان‌,417,1372293,33393454590,23250,23990,24410,1160,4.99,24330,1080,4.65,23430,24410
شدوص,دوده‌ صنعتي‌ پارس‌,416,3823513,49494243250,12360,12800,12970,610,4.94,12940,580,4.69,12640,12970
دلقما,دارويي‌ لقمان‌,414,6008928,12696827768,2079,2150,2107,28,1.35,2109,30,1.44,2084,2160
پكوير,كوير تاير,413,4443070,24244762970,5320,5240,5550,230,4.32,5460,140,2.63,5240,5580
شزنگ,تجهيزنيروي‌زنگان‌,413,324234,28028576000,83950,86400,86450,2500,2.98,86450,2500,2.98,85350,86450
واتي,سرمايه‌ گذاري‌ آتيه‌ دماوند,410,14342439,158662074780,10460,11080,11080,620,5.93,11060,600,5.74,10160,11080
خوساز,محورسازان‌ايران‌خودرو,409,2553882,19737519790,7780,7790,7740,-40,-0.51,7730,-50,-0.64,7580,7930
دكوثر,داروسازي‌ كوثر,408,4057215,14430113214,3500,3422,3555,55,1.57,3556,56,1.6,3422,3608
قيستو,شركت قند بيستون,406,2529621,59777966200,24300,23600,23600,-700,-2.88,23650,-650,-2.67,23600,24300
وبهمن,سرمايه‌گذاري‌بهمن‌,406,1228206,20510154330,15860,16600,16810,950,5.99,16700,840,5.3,15200,16810
مدير,ص.س.مديريت ثروت ص.بازنشستگي-س,404,2826605,31699260825,11239,11149,11269,30,0.27,11215,-24,-0.21,11149,11286
فجام,جام‌دارو,403,5061394,24802892086,4726,4713,4961,235,4.97,4900,174,3.68,4713,4962
ارزش,صندوق س ارزش آفرين بيدار-سهام,402,7374952,82895891840,11120,11120,11270,150,1.35,11240,120,1.08,11110,11310
قصفها,قنداصفهان‌,402,283355,28326924200,96450,93500,100000,3550,3.68,99970,3520,3.65,93500,101270
پكرمان,گروه‌ صنعتي‌ بارز,399,2563892,43830679260,17040,17000,17450,410,2.41,17100,60,0.35,16900,17600
سكرما,سيمان‌ كرمان‌,398,1785481,23746740680,13500,13690,13640,140,1.04,13300,-200,-1.48,12920,13690
ثاصفا,شركت‌ ساختمان‌ اصفهان‌,397,1492074,17308878980,11940,11590,11590,-350,-2.93,11600,-340,-2.85,11590,11960
اتكاي,بيمه اتكايي ايرانيان,396,8248953,114063434940,13740,13740,13840,100,0.73,13830,90,0.66,13740,13930
واحيا,م .صنايع و معادن احياء سپاهان,395,2516006,49624555300,19580,19580,19650,70,0.36,19690,110,0.56,19580,20000
وليز,ليزينگ‌ايران‌,391,5301023,9793015021,1860,1806,1800,-60,-3.23,1852,-8,-0.43,1792,1947
دتوزيع,توزيع دارو پخش,385,1065145,37735560900,34950,35250,36150,1200,3.43,35450,500,1.43,34750,36500
غپآذر,شير پگاه آذربايجان شرقي,384,535262,20270673400,36600,38750,37300,700,1.91,37850,1250,3.42,37100,38750
وسين,بيمه سينا,383,11785717,28782476936,2516,2441,2441,-75,-2.98,2442,-74,-2.94,2441,2478
بكهنوج,توليد برق ماهتاب كهنوج,381,16530776,21175473056,1220,1281,1281,61,5,1281,61,5,1280,1281
جهرم,پتروشيمي جهرم,375,9494344,8203264996,862,845,858,-4,-0.46,864,2,0.23,845,882
شتوكا,توكا رنگ فولاد سپاهان,374,899107,15864669350,17460,18190,17700,240,1.37,17640,180,1.03,17390,18190
گوهر,صندوق سكه طلاي كيان,366,280137,20134305493,72407,72000,71893,-514,-0.71,71873,-534,-0.74,71503,72000
خفنر,فنرسازي‌خاور,364,4155065,27471076050,6330,6480,6640,310,4.9,6610,280,4.42,6260,6640
سنوين,سرمايه گذاري اقتصاد نوين,361,2917430,17632638630,6220,6040,6040,-180,-2.89,6040,-180,-2.89,6040,6160
ولبهمن,شركت بهمن ليزينگ,361,4333527,16298678584,3580,3540,3790,210,5.87,3761,181,5.06,3540,3794
كپرور,فرآوري زغال سنگ پروده طبس,360,1071300,11786829000,10820,10650,10940,120,1.11,11000,180,1.66,10650,11150
هامرز2,صندوق س اعتماد هامرز-ثابت,360,36000000,36000000,10108,1,1,-10107,-99.99,1,-10107,-99.99,1,1
توريل,توكاريل,357,1332664,12124294530,9000,9360,9000,0,0,9080,80,0.89,8880,9360
ونيرو,سرمايه‌گذاري‌نيرو,357,17658983,54601575436,2917,3092,3092,175,6,3092,175,6,3092,3092
زيتون,صندوق س زيتون نماد پايا- مختلط,356,3398470,42180122090,12400,12490,12430,30,0.24,12410,10,0.08,12380,12490
كشرق,صنعتي و معدني شمال شرق شاهرود,356,262456,25751896500,98550,98950,98550,0,0,98100,-450,-0.46,94000,100000
وامير,گروه صنعتي و معدني امير,356,19361,7398732750,382550,373500,386500,3950,1.03,382300,-250,-0.07,373350,389900
سلام,صندوق س سلام فارابي-سهام,354,1903071,19033013290,10000,10010,10010,10,0.1,10000,0,0,10000,10020
ومعلم,بيمه معلم,353,4291463,9972881481,2291,2289,2301,10,0.44,2312,21,0.92,2270,2382
تسه0010,امتيازتسهيلات مسكن دي1400,351,3598,4260368299,1188931,1129490,1191002,2071,0.17,1184093,-4838,-0.41,1129490,1248377
وشهر,بانك شهر,348,3453724,15635553763,4590,4460,4510,-80,-1.74,4555,-35,-0.76,4460,4600
مداران,داده‌پردازي‌ايران‌,347,1910323,39653696900,19860,20300,20850,990,4.98,20760,900,4.53,19860,20850
قهكمت,قندهكمتان‌,344,3170835,23067041640,7000,7340,7220,220,3.14,7270,270,3.86,7010,7350
داسوه,داروسازي‌ اسوه‌,344,722880,35901386790,47600,48690,49980,2380,5,49660,2060,4.33,48000,49980
اپرداز,آتيه داده پرداز,343,1135665,15862725930,13700,13940,13990,290,2.12,13970,270,1.97,13620,14170
كقزوي,شيشه‌ قزوين‌,342,4256716,68063828840,15530,15990,15990,460,2.96,15990,460,2.96,15970,15990
داريك,صندوق س.اعتماد داريك-د,341,4810951,61025047991,12676,12678,12685,9,0.07,12685,9,0.07,12670,13942
وپاسار,بانك  پاسارگاد,339,12052879,107997868080,8960,8960,8970,10,0.11,8960,0,0,8950,8970
پرداخت,به پرداخت ملت,339,747189,17336527350,22760,23670,22950,190,0.83,23040,280,1.23,22840,23670
ضهرم6002,اختيارخ اهرم-12000-1401/06/30,338,23593,735564440,2925,3196,3000,75,2.56,3118,193,6.6,2886,3210
اوصتا,صندوق انديشه ورزان صباتامين -د,337,11988598,272584380855,22722,22737,22737,15,0.07,22737,15,0.07,22736,22737
قزوين,كارخانجات‌ قند قزوين‌,336,2311163,12368178560,5230,5370,5390,160,3.06,5330,100,1.91,5220,5400
دكپسول,توليد ژلاتين كپسول ايران,336,668916,26293901500,38850,38450,39800,950,2.45,39300,450,1.16,38350,40100
شنفت,نفت‌ پارس‌,335,1647667,14688424340,8920,9070,8900,-20,-0.22,8920,0,0,8870,9070
تسه0009,امتيازتسهيلات مسكن آذر 1400,333,4945,5798300238,1178401,1125000,1210000,31599,2.68,1172558,-5843,-0.5,1125000,1237321
دشيمي,شيمي‌ داروئي‌ داروپخش‌,332,1564614,42010861650,26920,26150,26660,-260,-0.97,26850,-70,-0.26,26150,27300
سمازن,سيمان‌مازندران‌,332,1206497,13918117780,11450,11400,11800,350,3.06,11530,80,0.7,11300,11800
تيپيكو,سرمايه گذاري دارويي تامين,332,3693692,81872043490,21710,22050,22190,480,2.21,22100,390,1.8,21810,22850
فايرا,آلومينيوم‌ايران‌,330,1304218,25945126730,19810,19480,19890,80,0.4,19840,30,0.15,19460,20190
شيراز,پتروشيمي‌شيراز,329,1104037,85954162340,77880,77520,77840,-40,-0.05,77860,-20,-0.03,77520,79270
دسبحا,گروه دارويي سبحان,327,902283,17046965250,19110,18770,19000,-110,-0.58,18960,-150,-0.78,18500,19480
ولصنم,ليزينگ‌صنعت‌ومعدن‌,327,2574386,7208778104,2703,2860,2799,96,3.55,2751,48,1.78,2720,2860
معيار ,سرمايه گذاري معيار صنعت پارس,325,572636,43941552250,76250,76300,78500,2250,2.95,76750,500,0.66,74000,78500
سپيدما,صندوق س. سپيد دماوند-د,324,8684245,109723601692,12629,12639,12635,6,0.05,12635,6,0.05,12634,12639
واميد,گروه مديريت سرمايه گذاري اميد,314,3640152,53934836390,14760,14430,14820,60,0.41,14790,30,0.2,14430,15090
چكاوه,صنايع‌كاغذسازي‌كاوه‌,313,1965682,15056752050,7440,7530,7690,250,3.36,7660,220,2.96,7530,7750
زعف0110پ20,زعفران0110نگين وحدت جام(پ),313,890619,362840957407,389698,390000,401000,11302,2.9,407403,17705,4.54,390000,409170
مرقام,ايران‌ارقام‌,313,2084815,24194159780,11280,11280,11840,560,4.96,11600,320,2.84,11110,11840
شخارك,پتروشيمي‌ خارك‌,311,333405,15789103300,47360,48720,47030,-330,-0.7,47360,0,0,47000,48720
غگلپا,شير پاستوريزه پگاه گلپايگان,310,278440,14115512500,50200,50550,50900,700,1.39,50700,500,1,50000,51700
كطبس,ذغال‌سنگ‌ نگين‌ ط‌بس‌,307,638063,13080971620,19800,20320,20390,590,2.98,20410,610,3.08,19850,20790
سكرد,سيمان كردستان,306,5465343,57550061790,10030,10530,10530,500,4.99,10530,500,4.99,10530,10530
رتاپ,تجارت الكترونيك  پارسيان,304,1231727,6223008890,5000,4950,5090,90,1.8,5020,20,0.4,4950,5120
حپارسا,توسعه حمل و نقل ريلي پارسيان,301,653801,26102368550,38400,37650,40700,2300,5.99,39900,1500,3.91,37650,40700
ثشرق,سرمايه گذاري مسكن شمال شرق,300,4668220,17832365512,3815,3845,3823,8,0.21,3820,5,0.13,3712,3936
شمواد,توليد مواداوليه الياف مصنوعي,300,161834,11825035950,73400,74000,72600,-800,-1.09,73050,-350,-0.48,71950,74300
شساخت,مهندسي و ساختمان صنايع نفت,299,538740,24358130550,44650,43350,45950,1300,2.91,44950,300,0.67,43350,45950
ثجوان,تامين مسكن جوانان,298,2364789,10331330703,4391,4263,4341,-50,-1.14,4369,-22,-0.5,4263,4430
داوه,داروسازي آوه سينا,295,1218412,9753226950,7900,8090,8010,110,1.39,7970,70,0.89,7840,8120
وايرا,سرمايه گذاري صنايع ايران,294,4981692,10408625282,2137,2073,2168,31,1.45,2089,-48,-2.25,2073,2183
خمحور,توليدمحورخودرو,292,3185254,8353952209,2613,2650,2636,23,0.88,2619,6,0.23,2578,2692
ثتوسا,س.توسعه و عمران استان اردبيل,292,518418,7746998510,14740,14310,15000,260,1.76,14940,200,1.36,14300,15170
نهال,صندوق س. طلاي سرخ نوويرا,291,1218214,25620604360,20847,21195,21001,154,0.74,21031,184,0.88,20950,21287
بنيرو,نيروترانس‌,290,10010703,24863089954,2475,2460,2510,35,1.41,2484,9,0.36,2452,2550
لابسا,آبسال‌,287,4840917,37362984890,7370,7520,7730,360,4.88,7720,350,4.75,7520,7730
لوتوس,تامين سرمايه لوتوس پارسيان,281,2713823,19023511770,7120,6970,7080,-40,-0.56,7070,-50,-0.7,6960,7130
بالبر,كابل‌ البرز,280,933041,32887468830,33710,35240,35390,1680,4.98,35250,1540,4.57,34400,35390
فنرژي,گسترش صنايع انرژي آذرآب,279,1943166,15698176500,7990,7990,8140,150,1.88,8080,90,1.13,7950,8140
غناب,روغن‌ نباتي‌ ناب,279,70848,12803417350,183950,184950,180300,-3650,-1.98,180700,-3250,-1.77,180300,184950
تايرا,تراكتورسازي‌ايران‌,279,621407,10784072760,17180,17060,17410,230,1.34,17260,80,0.47,17060,17890
سخاشح,ح . سيمان‌خاش‌,278,245476,12922986640,52340,52010,52450,110,0.21,52640,300,0.57,52000,53390
شفا,سرمايه گذاري شفادارو,276,756156,11944501450,15410,15370,15900,490,3.18,15680,270,1.75,15370,16160
دابور,داروسازي‌ ابوريحان‌,275,909603,22093320420,24290,23830,24410,120,0.49,24290,0,0,23830,24540
كهرام,توليدي گرانيت بهسرام,272,146297,8237019150,56900,55800,56700,-200,-0.35,56300,-600,-1.05,55800,58000
كمنگنز,معادن‌منگنزايران‌,272,626804,10368776130,16540,16100,16550,10,0.06,16540,0,0,16100,16760
ثامان,سامان‌ گستراصفهان‌,271,1304447,19384643550,14850,15100,14890,40,0.27,14860,10,0.07,14510,15200
وتوس,توسعه‌شهري‌توس‌گستر,271,3397983,27366863010,8050,7760,8080,30,0.37,8050,0,0,7760,8190
بميلا,توسعه سرمايه گذاري ميلاد پارس,271,6537701,77249858010,11480,11820,11820,340,2.96,11820,340,2.96,11600,11820
كي بي سي,شركت كي بي سي,268,968500,12388976260,12490,12890,12980,490,3.92,12790,300,2.4,12230,13050
گوهران,سرمايه گذاري توسعه گوهران اميد,267,1849528,10448090600,5690,5710,5650,-40,-0.7,5660,-30,-0.53,5550,5750
سقاين,سيمان‌ قائن‌,267,297781,14003559820,46020,47940,45920,-100,-0.22,46950,930,2.02,45660,48290
زر,صندوق س.پشتوانه سكه طلاي زر,266,239918,15001668184,62338,62021,62425,87,0.14,62528,190,0.3,62021,62800
تسه0008,امتيازتسهيلات مسكن آبان1400,266,3143,3721027507,1175723,1117000,1234509,58786,5,1183909,8186,0.7,1117000,1234509
ياقوت,صندوق س ياقوت آگاه-ثابت,266,1703949,25324118715,14851,14858,14859,8,0.05,14862,11,0.07,14858,14865
سارومح,ح . سيمان‌اروميه‌,265,428891,10703988510,25010,25480,25400,390,1.56,24960,-50,-0.2,24780,25700
ولملت,واسپاري ملت,262,3034745,12657557175,3951,4058,4188,237,6,4121,170,4.3,4058,4188
ضهرم6000,اختيارخ اهرم-10000-1401/06/30,259,15397,720094660,5055,4500,4678,-377,-7.46,4677,-378,-7.48,4673,4750
وآرين,شركت توسعه اقتصادي آرين,258,9289331,11670083246,1221,1257,1257,36,2.95,1256,35,2.87,1235,1257
وكادو,تكادو,257,1086290,19959336100,18380,17900,18260,-120,-0.65,18370,-10,-0.05,17900,18880
تپمپي,پمپ‌ سازي‌ ايران‌,252,585106,10590855170,18000,17720,18020,20,0.11,18080,80,0.44,17720,18410
غمهرا,توليدي‌مهرام‌,251,962795,11821917000,11890,12280,12330,440,3.7,12220,330,2.78,11920,12480
سپر,صندوق س سپر سرمايه بيدار- ثابت,251,4683989,68129632881,14528,14547,14547,19,0.13,14545,17,0.12,14544,14547
تسه9905,امتياز تسهيلات مسكن مرداد99,249,2258,2955855485,1286312,1310000,1329999,43687,3.4,1309059,22747,1.77,1224000,1350626
دفارا,داروسازي‌ فارابي‌,247,516500,6897434040,13300,13490,13360,60,0.45,13330,30,0.23,13170,13590
ثعمرا,عمران و توسعه شاهد,245,1163183,8960310880,7460,7590,7700,240,3.22,7610,150,2.01,7590,7780
ساراب,سيمان‌ داراب‌,245,660506,11023192370,16410,16140,16850,440,2.68,16640,230,1.4,15910,16860
شرنگي,شيميايي رنگين,245,20717,7014358500,338800,334000,339500,700,0.21,338700,-100,-0.03,329950,343400
بايكا,كارخانجات كابلسازي ‌ايران‌,243,378581,5931007730,15610,16040,15990,380,2.43,15650,40,0.26,15200,16040
واعتبار,سرمايه گذاري اعتبار ايران,243,1968900,5964221550,3088,3140,2996,-92,-2.98,3063,-25,-0.81,2943,3140
اوان,مبين وان كيش,243,2082330,24237983920,11020,10890,11680,660,5.99,11640,620,5.63,10610,11680
كاريس,صندوق س.سپند كاريزما-س,242,883382,13643207269,15166,15450,15483,317,2.09,15444,278,1.83,15315,15500
وصندوق,سرمايه‌گذاري‌صندوق‌بازنشستگي‌,241,1860371,27226252510,14630,14850,14620,-10,-0.07,14630,0,0,14560,14890
سخزر,سيمان‌ خزر,239,724244,17937566030,24210,24670,24700,490,2.02,24770,560,2.31,23300,25300
وپترو,سرمايه‌گذاري صنايع پتروشيمي‌,239,1141560,12745879980,11010,10850,11200,190,1.73,11150,140,1.27,10850,11380
نمرينو,ايران‌ مرينوس‌,236,58297,5066612340,85280,84000,87300,2020,2.37,85880,600,0.7,84000,88390
ضستا7003,اختيارخ شستا-1000-1401/07/17,232,12326,2088052000,169,170,166,-3,-1.78,169,0,0,162,175
دماوند,توليد نيروي برق دماوند,231,1889858,41104411500,20750,21750,21750,1000,4.82,21600,850,4.1,21750,21750
ضخود4014,اختيارخ خودرو-2600-1401/04/08,231,11154,375402000,42,41,37,-5,-11.9,34,-8,-19.05,30,45
تسه0006,امتيازتسهيلات مسكن شهريور1400,231,3614,4300535863,1180261,1162000,1220000,39739,3.37,1189966,9705,0.82,1121248,1239274
فاما,صنعتي‌ آما,230,671650,6172031340,9160,9080,9130,-30,-0.33,9170,10,0.11,9000,9550
حشكوه,دليجان طلايي شكوه پارس,228,3329051,8339399409,2546,2503,2525,-21,-0.82,2511,-35,-1.37,2475,2568
گنجينه,صندوق س. گنجينه داريوش-د,225,18072590,182621075357,10101,10102,10105,4,0.04,10105,4,0.04,10070,10105
دحاوي,الحاوي,223,1812945,10748915190,5980,6090,5910,-70,-1.17,5930,-50,-0.84,5860,6090
تسه9906,امتياز تسهيلات مسكن شهريور99,221,1982,2579818187,1300768,1355555,1321112,20344,1.56,1301624,856,0.07,1235750,1359999
ضخود4013,اختيارخ خودرو-2400-1401/04/08,221,10499,733716000,85,76,77,-8,-9.41,70,-15,-17.65,66,88
سخواف,سيمان مجد خواف,220,1617937,14622882570,8780,9040,9040,260,2.96,9040,260,2.96,8920,9040
سباقر,سيمان باقران,220,1279386,17750112880,13690,13520,13940,250,1.83,13870,180,1.31,13510,14100
ارفع,شركت آهن و فولاد ارفع,219,672081,9288364980,14060,13430,13740,-320,-2.28,14030,-30,-0.21,13420,14240
تصميم,صندوق س با درآمد ثابت تصميم,219,1807565,35928807495,19845,19860,19876,31,0.16,19877,32,0.16,19859,19920
پاسا,ايران‌ياساتايرورابر,218,1330568,17690378350,12720,13090,13350,630,4.95,13300,580,4.56,12950,13350
ثنظام,س. ساختماني نظام مهندسي ايران,214,505214,8549282060,17300,17750,16790,-510,-2.95,16920,-380,-2.2,16790,17750
يارا,صندوق س. آريا-د,213,10494297,112803018453,10742,10748,10749,7,0.07,10749,7,0.07,10748,10750
وتعاون,بيمه تعاون,212,3112257,4561981788,1472,1460,1495,23,1.56,1470,-2,-0.14,1429,1539
نتوس,پشم‌ بافي‌ توس,212,1099317,11312711270,10600,10290,10290,-310,-2.92,10290,-310,-2.92,10290,10440
شصفها,پتروشيمي‌ اصفهان‌,212,383798,39524405900,101000,103000,103000,2000,1.98,103000,2000,1.98,101900,103000
تسه9908,امتياز تسهيلات مسكن آبان99,211,2657,3099530051,1165722,1108000,1193000,27278,2.34,1166552,830,0.07,1108000,1224008
آساس,صندوق س.آسمان آرماني سهام-س,211,64576,13620786060,209510,207510,212550,3040,1.45,210926,1416,0.68,207510,213000
سبجنو,سيمان‌ بجنورد,210,234938,10044615580,41870,42780,43220,1350,3.22,42460,590,1.41,42000,43350
تسه0002,امتيازتسهيلاتمسكن ارديبهشت1400,209,2323,2734648819,1221244,1160182,1200001,-21243,-1.74,1177206,-44038,-3.61,1160182,1282306
سيلام,سيمان‌ ايلام‌,207,1223284,9363280310,7540,7300,7460,-80,-1.06,7620,80,1.06,7260,7900
مثقال,صندوق س.پشتوانه طلاي زرين آگاه,204,424669,4809653497,11322,11310,11302,-20,-0.18,11326,4,0.04,11301,11353
تسه0007,امتيازتسهيلات مسكن مهر1400,202,1465,1733083000,1169837,1144540,1228328,58491,5,1182992,13155,1.12,1144540,1228328
فوكا,فولاد كاويان,202,7051234,110422324440,15210,15660,15660,450,2.96,15660,450,2.96,15660,15660
وكار,بانك‌ كارآفرين‌,201,7397644,24573173880,3337,3338,3347,10,0.3,3330,-7,-0.21,3270,3359
دتماد,توليدمواداوليه‌داروپخش‌,199,247767,10349942820,41560,41300,42090,530,1.28,41710,150,0.36,41010,43200
دكيمي,كيميدارو,197,286009,6008337570,20580,20610,20870,290,1.41,20760,180,0.87,20600,21270
وملت,سرمايه گذاري ملت,194,2242376,5175079706,2338,2384,2328,-10,-0.43,2308,-30,-1.28,2292,2384
واحصا,احياء صنايع خراسان,193,481040,51928268000,104850,107950,107950,3100,2.96,107950,3100,2.96,107950,107950
ثقزوي,شركت عمران و سازندگي قزوين,193,1088276,14996443280,13380,13780,13780,400,2.99,13780,400,2.99,13780,13780
فكمند,گسترش قطعه سازي كمند,193,1049501,24919873250,23100,22750,23750,650,2.81,23750,650,2.81,22750,23750
قشهد,شهد,191,716082,10513725860,14200,14420,14830,630,4.44,14560,360,2.54,14120,14840
حرهشا,رهشاد سپاهان (سهامي عام,191,123267,11441349350,93900,91100,95400,1500,1.6,92800,-1100,-1.17,91100,96350
ما,بيمه  ما,188,1590166,7768136900,4890,4990,4890,0,0,4890,0,0,4850,4990
وارس,سرمايه گذاري ارس صبا,181,1277698,22104643240,17020,17020,17200,180,1.06,17300,280,1.65,16720,17530
درازك,دارويي‌ رازك‌,181,456418,7640982000,16310,16500,16630,320,1.96,16540,230,1.41,16350,17120
كاردان,صندوق س تجارت شاخصي كاردان,179,55912,12586021490,223350,229980,226340,2990,1.34,225100,1750,0.78,224070,229980
پارتا,مجتمع‌صنعتي‌آرتاويل‌تاير,179,370270,6705412510,18080,18250,17890,-190,-1.05,18090,10,0.06,17700,18620
ساربيل,سيمان آرتا اردبيل,176,197769,6065733860,29660,29990,30130,470,1.58,30070,410,1.38,29200,31120
بزاگرس,نيروگاه زاگرس كوثر,176,3499260,18035186040,4909,5154,5154,245,4.99,5154,245,4.99,5154,5154
كيان2,صندوق س. با درآمد ثابت كيان,175,17500000,17500000,34972,1,1,-34971,-100,1,-34971,-100,1,1
غپونه,نوش پونه مشهد,175,1217816,18920085590,15100,15550,15550,450,2.98,15540,440,2.91,15240,15550
فاهواز,نورد و لوله اهواز,173,2823808,15417581970,5490,5410,5440,-50,-0.91,5460,-30,-0.55,5400,5500
سرود,سيمان‌شاهرود,172,949857,20494446710,21090,21100,21600,510,2.42,21580,490,2.32,21100,21800
اخزا002,اسنادخزانه-م2بودجه00-031024,171,230600,133662798000,578800,578800,580830,2030,0.35,579630,830,0.14,578500,580830
سجام,مجتمع سيمان غرب آسيا,170,1674812,4220034935,2535,2496,2500,-35,-1.38,2528,-7,-0.28,2461,2587
حخزر,كشتيراني درياي خزر,169,400768,7202470030,17460,16750,18330,870,4.98,17710,250,1.43,16750,18330
اميد,تامين سرمايه اميد,169,661483,3841617560,5840,5870,5850,10,0.17,5840,0,0,5710,5940
آرمان,بيمه آرمان,168,2960133,13063860586,4286,4414,4414,128,2.99,4413,127,2.96,4322,4414
سفانو,سيمان فارس نو,164,248299,8494091600,33900,33900,34170,270,0.8,34080,180,0.53,33570,35350
بسويچ,پارس‌سويچ‌,161,279929,4612048490,16040,15980,16180,140,0.87,16170,130,0.81,15820,16800
سغدير,توسعه سرمايه و صنعت غدير,159,742262,9795692230,13150,13450,13160,10,0.08,13180,30,0.23,13000,13800
شپاس,نفت پاسارگاد,159,287275,5307487440,18390,18500,18790,400,2.18,18420,30,0.16,18010,18800
قنقش,قند نقش جهان,156,189310,22884532450,120050,118500,121400,1350,1.12,120900,850,0.71,117650,122450
كساپا,سايپاشيشه‌,156,894805,14936975810,15950,16000,16740,790,4.95,16690,740,4.64,16000,16740
داراب,پتروشيمي داراب,155,3850336,3692114080,936,915,964,28,2.99,945,9,0.96,915,964
فبيرا,بسته‌ بندي‌ ايران‌,155,1940655,3121924945,1638,1645,1606,-32,-1.95,1618,-20,-1.22,1606,1650
فسا,پتروشيمي فسا,154,2938614,2700720184,923,900,919,-4,-0.43,922,-1,-0.11,897,939
ضشنا8014,اختيارخ شپنا-5850-1401/08/29,154,2953,3730498000,1148,1200,1359,211,18.38,1263,115,10.02,1150,1373
وتوشه,سرمايه‌ گذاري‌ پارس‌ توشه‌,153,1080524,7063794260,6630,6450,6560,-70,-1.06,6580,-50,-0.75,6400,6730
آوا,صندوق س.سهام آواي معيار-س,149,643932,5550577130,8609,8691,8670,61,0.71,8620,11,0.13,8581,8691
فافق,صنايع مس افق كرمان,149,3335682,16408265260,4790,4800,4930,140,2.92,4920,130,2.71,4800,4930
خپويش,سازه‌ پويش‌,147,1244301,17669074200,13530,14200,14200,670,4.95,14200,670,4.95,14200,14200
فمراد,آلومراد,147,721472,20035277440,26450,27770,27770,1320,4.99,27770,1320,4.99,27770,27770
خبازرس,بازرسي مهندسي و صنعتي ايران,147,226207,3845020900,16900,16880,16890,-10,-0.06,16940,40,0.24,16820,17300
ثغرب,شركت سرمايه گذاري مسكن شمالغرب,146,2930536,15710603496,5058,5361,5361,303,5.99,5322,264,5.22,5361,5361
زعف0110پ11,زعفران0110نگين سحرخيز(پ),145,151192,59149815437,389241,390001,398595,9354,2.4,391223,1982,0.51,390000,398595
خاتم,صندوق س خاتم ايساتيس پويا-ثابت,142,2151745,29158898654,13540,13552,13550,10,0.07,13551,11,0.08,13550,13552
دسينا,داروسازي‌ سينا,141,351568,8855013090,25300,25010,25340,40,0.16,25230,-70,-0.28,24710,25560
تسه0005,امتيازتسهيلات مسكن مرداد 1400,140,1395,1681743454,1173562,1114884,1232240,58678,5,1205551,31989,2.73,1114884,1232240
خكرمان,سرمايه گذاري آرمان گستر پاريز,139,6081762,21407802240,3418,3520,3520,102,2.98,3520,102,2.98,3520,3520
رتكو,كنترل‌خوردگي‌تكين‌كو,139,1072496,9215106890,8540,8680,8700,160,1.87,8570,30,0.35,8380,8700
گپارس,امور رفاهي كارگزاران پارس,138,117737,14004716150,115500,118950,118950,3450,2.99,118950,3450,2.99,118900,118950
تسه9912,امتياز تسهيلات مسكن اسفند99,136,839,980011091,1168535,1112001,1182501,13966,1.2,1168070,-465,-0.04,1112001,1222400
دعبيد,لابراتوارداروسازي‌  دكترعبيدي‌,136,267863,6500784610,24200,24320,24200,0,0,24210,10,0.04,23830,24380
تسه0001,امتيازتسهيلات مسكن فروردين1400,136,1052,1262456783,1217493,1156619,1200000,-17493,-1.44,1200054,-17439,-1.43,1156619,1278367
تسه9907,امتياز تسهيلات مسكن مهر99,135,560,715451028,1262310,1210000,1325425,63115,5,1277591,15281,1.21,1210000,1325425
ساذري,آذريت‌,134,1162612,6912446320,5780,5920,5950,170,2.94,5950,170,2.94,5860,5950
ضهرم6001,اختيارخ اهرم-11000-1401/06/30,133,10801,422392000,4513,3339,3900,-613,-13.58,3911,-602,-13.34,3600,4000
تسه0004,امتيازتسهيلات مسكن تير1400,130,1257,1493997436,1168401,1170000,1192500,24099,2.06,1188542,20141,1.72,1170000,1226821
سهگمت,سيمان‌هگمتان‌,130,210984,5390652320,24890,24500,25250,360,1.45,25170,280,1.12,24500,26370
تشتاد,صنايع توليدي اشتاد ايران‌,127,1774419,10681820100,5850,6020,6020,170,2.91,6010,160,2.74,6000,6020
بساما,بيمه سامان,127,1088444,13124640070,11950,12000,12050,100,0.84,12010,60,0.5,11950,12250
تسه9911,امتياز تسهيلات مسكن بهمن99,126,786,930650349,1189753,1130266,1210000,20247,1.7,1184033,-5720,-0.48,1130266,1249240
ويسا,سرمايه گذاري ايساتيس پويا,126,628582,4143422480,6550,6410,6600,50,0.76,6570,20,0.31,6410,6720
تسه0003,امتيازتسهيلات مسكن خرداد1400,125,958,1123121922,1181565,1122487,1200015,18450,1.56,1172361,-9204,-0.78,1122487,1240643
سپ,پرداخت الكترونيك سامان كيش,124,189128,4268227730,22300,23000,22360,60,0.27,22320,20,0.09,22140,23150
دشيري,شيرين دارو,124,64523,6374413950,99250,102100,100400,1150,1.16,98950,-300,-0.3,97100,102100
ضستا7005,اختيارخ شستا-1200-1401/07/17,123,5841,405753000,70,74,70,0,0,69,-1,-1.43,66,74
ولقمان,سرمايه گذاري لقمان,123,449812,2334524280,5039,5190,5190,151,3,5070,31,0.62,5190,5190
وبازار,صندوق س شاخصي بازارآشنا,123,367452,4958686670,13390,13500,13700,310,2.32,13490,100,0.75,13370,13720
تسه9910,امتياز تسهيلات مسكن دي99,118,733,849798255,1148166,1102020,1190000,41834,3.64,1159343,11177,0.97,1102020,1205574
دپارس,پارس‌ دارو,117,166343,5195709190,31350,30710,31430,80,0.26,31310,-40,-0.13,30710,31700
انار,صندوق س.انارنماد ارزش-درسهام,116,180128,2020668820,11170,11460,11170,0,0,11220,50,0.45,11170,11460
تسه9909,امتياز تسهيلات مسكن آذر99,115,572,661641953,1175848,1117056,1172000,-3848,-0.33,1156717,-19131,-1.63,1117056,1234640
شفنح,ح . پتروشيمي فناوران,115,414216,4499650880,8310,11000,10700,2390,28.76,10860,2550,30.69,10700,11000
مارون,پتروشيمي مارون,112,99062,18904435200,190800,190050,190000,-800,-0.42,190800,0,0,190000,193000
كاسپين,داروسازي كاسپين تامين,111,149916,3426842500,22600,22300,23050,450,1.99,22650,50,0.22,22300,23300
وحافظ,بيمه حافظ,111,2163083,23512712210,10560,10870,10870,310,2.94,10870,310,2.94,10870,10870
ومشان,س. فني و مهندسي مشانير,109,50476,3016935550,60700,58900,60000,-700,-1.15,60250,-450,-0.74,58900,61650
بمپنا,توليد برق عسلويه  مپنا,108,2131584,16306617600,7290,7650,7650,360,4.94,7540,250,3.43,7650,7650
وپخش,داروپخش‌ (هلدينگ‌,108,483148,16516960870,34000,34100,34220,220,0.65,34060,60,0.18,34000,34870
ثعتما,س. ساختماني اعتماد گستر,104,249559,3793296800,15670,15200,15200,-470,-3,15480,-190,-1.21,15200,15200
كهربا,صندوق س.پشتوانه سكه طلا كهربا,103,1576287,19487553420,12402,12380,12300,-102,-0.82,12363,-39,-0.31,12296,12399
كگاز,شيشه‌ و گاز,101,144147,2364781730,16260,16950,16260,0,0,16280,20,0.12,16110,16950
پكويرح,ح. كوير تاير,95,3418981,13730668880,4000,4000,4080,80,2,4016,16,0.4,4000,4480
زرين,صندوق س. سهام زرين كوروش-س,95,246348,3347681473,13633,13749,13635,2,0.01,13589,-44,-0.32,13503,13749
كابگن,توليدي و صنعتي آبگينه‌,93,403159,3522257210,8700,8620,8780,80,0.92,8740,40,0.46,8620,8780
اخزا010,اسناد خزانه-م10بودجه00-031115,88,261900,150059816600,573234,572000,574470,1236,0.22,572966,-268,-0.05,572000,574470
ضستا7004,اختيارخ شستا-1100-1401/07/17,84,5774,609560000,104,105,105,1,0.96,106,2,1.92,100,109
ضخود3058,اختيارخ خودرو-2500-1401/03/04,82,5934,5934000,1,1,1,0,0,1,0,0,1,1
خفناور,مهندسي صنعتي روان فن آور,82,343294,12461572200,35250,36300,36300,1050,2.98,36300,1050,2.98,36300,36300
ساروج,بين المللي ساروج بوشهر,81,228813,3834125540,16880,16930,16870,-10,-0.06,16850,-30,-0.18,16390,17120
زكشت,كشاورزي مكانيزه اصفهان كشت,80,1295411,32903439400,24000,25400,25400,1400,5.83,25400,1400,5.83,25400,25400
وزمين,بانك ايران زمين,78,216297,2048672590,9660,9470,9470,-190,-1.97,9630,-30,-0.31,9470,9630
فبستم,صنايع ‌بسته‌بندي‌ مشهد,77,300303,5795847900,18740,19300,19300,560,2.99,19050,310,1.65,19300,19300
الماس,صندوق س.امين تدبيرگران فردا-س,76,8397,1058880433,122983,124460,128469,5486,4.46,126102,3119,2.54,124460,128960
سيستم,همكاران سيستم,75,748069,4707896820,6220,6430,6350,130,2.09,6230,10,0.16,6200,6430
قپيرا,فرآورده‌هاي‌غدايي‌وقندپيرانشهر,75,505818,4312341870,8570,8560,8630,60,0.7,8560,-10,-0.12,8400,8660
صنم,ص.س.صندوق در صندوق صنم,72,755157,8685109792,11422,11430,11549,127,1.11,11501,79,0.69,11430,11550
تداوم,صندوق تداوم اطمينان تمدن-ثابت,71,1529537,15464256669,10104,10110,10111,7,0.07,10110,6,0.06,10109,10111
ضخود4015,اختيارخ خودرو-2800-1401/04/08,71,4179,79429000,22,10,19,-3,-13.64,19,-3,-13.64,10,22
ضذوب3001,اختيارخ ذوب-2500-1401/03/04,71,1424,302801000,205,200,233,28,13.66,213,8,3.9,170,268
فيروزه,صندوق شاخص30 شركت فيروزه- سهام,71,32646,6419543780,195740,196660,197760,2020,1.03,196640,900,0.46,196470,198000
وآفري,بيمه كارآفرين,70,1330568,5069500683,3767,3767,3781,14,0.37,3782,15,0.4,3767,3869
ضشنا8013,اختيارخ شپنا-5350-1401/08/29,70,575,833600000,1325,1430,1500,175,13.21,1450,125,9.43,1335,1528
ماني2,صندوق س. با درآمد ثابت ماني,70,7000000,7000000,11738,1,1,-11737,-99.99,1,-11737,-99.99,1,1
اخزا001,اسنادخزانه-م1بودجه00-030821,66,189100,113806209000,600500,600800,604000,3500,0.58,601830,1330,0.22,600000,604000
خريختح,ح . صنايع‌ريخته‌گري‌ايران‌,65,4544290,9090580000,2000,2200,2000,0,0,2000,0,0,2000,2200
سمتاز,سيمان ممتازان كرمان,65,192314,3816465210,19840,19770,19780,-60,-0.3,19840,0,0,19690,20000
سكه0211پ02,تمام سكه طرح جديد0211ملت,65,9000,13071049300,1458968,1454000,1450000,-8968,-0.61,1452339,-6629,-0.45,1441000,1459000
شپارس,بين‌ المللي‌ محصولات‌  پارس‌,62,435184,2493604320,5460,5730,5730,270,4.95,5500,40,0.73,5730,5730
رماس,صندوق س.راهبرد ممتازابن سينا-س,61,111530,1400856221,12566,12969,12698,132,1.05,12560,-6,-0.05,12441,12969
نگين,ص.س. زمين و ساختمان نگين شهرري,60,46078,2903025800,53380,64300,64240,10860,20.34,63000,9620,18.02,62400,64300
وثوق,سرمايه گذاري وثوق امين,60,443897,3924049480,8590,8840,8840,250,2.91,8680,90,1.05,8840,8840
وسنا,سرمايه گذاري نيروگاهي ايران,59,1402000,14847180000,10290,10590,10590,300,2.92,10590,300,2.92,10590,10590
اخزا0022,اسنادخزانه-م2بودجه00-031024,59,2375,1373823860,578800,578500,579020,220,0.04,578450,-350,-0.06,578010,579200
وامين,س. امين توان آفرين ساز,58,164673,1883702890,11400,11450,11450,50,0.44,11400,0,0,11400,11460
اخزا005,اسنادخزانه-م5بودجه00-030626,57,186600,116040142000,619910,619990,621000,1090,0.18,621870,1960,0.32,619400,623000
اخزا006,اسنادخزانه-م6بودجه00-030723,57,111800,68313117000,609800,609510,612930,3130,0.51,611030,1230,0.2,609510,612930
شليا,شركت مواد ويژه ليا,56,143603,4379891500,29650,30500,30500,850,2.87,30000,350,1.18,30500,30500
پلوله,گازلوله‌,55,191838,5006971800,25350,26100,26100,750,2.96,25700,350,1.38,26100,26100
سايرا,ايرانيت‌,55,61117,1789097600,29200,29200,29150,-50,-0.17,29250,50,0.17,28650,29700
اخزا009,اسناد خزانه-م9بودجه00-031101,54,198000,115013129000,576150,576100,581000,4850,0.84,580870,4720,0.82,576100,581000
سكه0111پ05,تمام سكه طرح جديد0111آينده,54,43000,62443601200,1457898,1456000,1445001,-12897,-0.88,1452177,-5721,-0.39,1445000,1456000
ضخود4017,اختيارخ خودرو-3250-1401/04/08,53,2303,22523000,14,13,10,-4,-28.57,10,-4,-28.57,8,13
آينده,بازرگاني آينده سازان بهشت پارس,53,282407,3541383780,12920,12540,12540,-380,-2.94,12780,-140,-1.08,12540,12540
كمينا,شيشه سازي مينا,52,1084552,11843307840,10610,10920,10920,310,2.92,10920,310,2.92,10920,10920
طهرم6005,اختيارف اهرم-15000-1401/06/30,51,4500,90000000,1,2000,2000,1999,199900,2000,1999,199900,2000,2000
عيار2,صندوق طلاي عيار مفيد,50,500000,500000,36674,1,1,-36673,-100,1,-36673,-100,1,1
سكه0110پ04,تمام سكه طرح جديد 0110 صادرات,46,15300,22241573600,1459260,1450000,1445100,-14160,-0.97,1453698,-5562,-0.38,1445000,1455000
آتيمس,صندوق س.آرمان آتيه درخشان مس-س,45,19538,3974930869,203511,206486,203866,355,0.17,203446,-65,-0.03,202001,206735
نيرو,نيرو سرمايه,44,418486,11278197700,26200,26950,26950,750,2.86,26950,750,2.86,26950,26950
طخود3058,اختيارف خودرو-2500-1401/03/04,44,2084,505985000,239,260,240,1,0.42,243,4,1.67,240,265
برن0104پ01,برنج طارم0104تجارت مازندران(پ),44,1104,982291930,847809,889900,890199,42390,5,889757,41948,4.95,860000,890199
ارمغان,ص سرمايه گذاري ارمغان ايرانيان,40,540066,5458905562,10107,10101,10114,7,0.07,10108,1,0.01,10101,10114
دارا,صندوق س. دارا الگوريتم-د,40,800885,8026078325,10017,10022,10022,5,0.05,10022,5,0.05,10021,10022
زعف0110پ18,زعفران0110نگين بهرامن(پ),39,48524,18940348115,389815,390000,394600,4785,1.23,390329,514,0.13,390000,394799
اراد50,مرابحه عام دولت5-ش.خ0302,38,804400,804400000000,1000000,1000000,1000000,0,0,1000000,0,0,1000000,1000000
ضجار7048,اختيارخ وتجارت-1780-1401/07/20,38,2426,1451010000,639,640,600,-39,-6.1,598,-41,-6.42,590,640
داريوش,صندوق س. ثروت داريوش -س,37,227931,2568924268,11247,11222,11300,53,0.47,11271,24,0.21,11220,11300
ضسپا8057,اختيارخ خساپا-3000-1401/08/25,37,2488,213494000,98,100,90,-8,-8.16,86,-12,-12.24,72,100
شستان,پتروشيمي گلستان,37,130540,547484760,4112,4194,4194,82,1.99,4120,8,0.19,4194,4194
ضپلا4006,اختيارخ پالايش-80000-01/04/29,36,1429,71450000,5000,5000,5000,0,0,5000,0,0,5000,5000
پلاستح,ح.كارخانجات توليدي پلاستيران,36,91995,1086089450,12540,12100,11790,-750,-5.98,11810,-730,-5.82,11790,12100
مرواريد,صندوق س. مرواريد بها بازار-س,35,133209,1333846776,10037,10010,10021,-16,-0.16,10013,-24,-0.24,10000,10055
اخزا910,اسنادخزانه-م10بودجه99-020807,35,84600,63530704000,750910,750910,753300,2390,0.32,750950,40,0.01,750770,753580
اخزا004,اسنادخزانه-م4بودجه00-030522,35,81600,51622019000,631780,631500,633030,1250,0.2,632620,840,0.13,631500,634010
وثخوز,سرمايه گذاري و توسعه خوزستان,34,42647,1445107350,33800,33850,34000,200,0.59,33800,0,0,33000,34200
كصدف,كاشي صدف سرام استقلال آباده,34,193694,7428164900,37250,38350,38350,1100,2.95,38000,750,2.01,38350,38350
كايتا,ايتالران‌,34,25709,1000080100,37800,38900,38900,1100,2.91,37900,100,0.26,38900,38900
اخزا0052,اسنادخزانه-م5بودجه00-030626,34,1069,661840650,619910,618000,620210,300,0.05,619120,-790,-0.13,618000,622000
سكه0112پ03,تمام سكه طرح جديد0112سامان,32,3800,5520471400,1458215,1450011,1447006,-11209,-0.77,1452756,-5459,-0.37,1447006,1458000
وسرمد,بيمه  سرمد,32,1455998,4367994000,3092,3000,3000,-92,-2.98,3049,-43,-1.39,3000,3000
افق ملت,صندوق س در سهام افق ملت,31,10734,1681572430,156010,157000,156260,250,0.16,156660,650,0.42,156010,157010
پاداش,صندوق س. ارزش پاداش-د,30,1052583,10738477195,10197,10202,10203,6,0.06,10202,5,0.05,10202,10203
وپسا,س. پتروشيمي ساختمان  خليج فارس,30,207289,461839892,2296,2228,2228,-68,-2.96,2293,-3,-0.13,2228,2228
آكورد2,صندوق س. آرمان آتي كوثر-د,29,2900000,2900000,38869,1,1,-38868,-100,1,-38868,-100,1,1
وآتوس,توسعه س. كشاورزي آرين توسكا,29,79168,2066284800,25350,26100,26100,750,2.96,25550,200,0.79,26100,26100
اخزا003,اسنادخزانه-م3بودجه00-030418,29,99200,64031360000,645480,645600,645580,100,0.02,645480,0,0,644230,646900
فردا2,صندوق س آواي فرداي زاگرس-ثابت,27,27000000,27000000,13115,1,1,-13114,-99.99,1,-13114,-99.99,1,1
ضخود5005,اختيارخ خودرو-2400-1401/05/12,26,1312,197975000,147,160,150,3,2.04,151,4,2.72,150,190
ضترا3015,اختيارخ شتران-5000-1401/03/08,26,478,215010000,301,400,540,239,79.4,450,149,49.5,340,540
فلات,گروه صنايع معادن فلات ايرانيان,25,553091,5779800950,10150,10450,10450,300,2.96,10320,170,1.67,10450,10450
ضخود4010,اختيارخ خودرو-1900-1401/04/08,23,500,200000000,423,400,400,-23,-5.44,400,-23,-5.44,400,400
قاروم,قند اروميه,23,11621,2235880400,198300,192400,192400,-5900,-2.98,197300,-1000,-0.5,192400,192400
يارا2,صندوق س. آريا-د,23,23000000,23000000,10742,1,1,-10741,-99.99,1,-10741,-99.99,1,1
ضستر3007,اختيارخ خگستر-4000-1401/03/22,23,649,68084000,148,150,120,-28,-18.92,105,-43,-29.05,100,150
صنوين,صندوق سرمايه‌گذاري صنوين-مختلط,23,6047,752236490,124350,124400,124190,-160,-0.13,124400,50,0.04,124190,124500
زعف0110پ19,زعفران0110نگين تروند قاينات(پ),23,36233,14553697000,402759,401000,402500,-259,-0.06,401670,-1089,-0.27,401000,409000
ضستر3006,اختيارخ خگستر-3750-1401/03/22,21,856,253956000,350,289,320,-30,-8.57,297,-53,-15.14,210,320
ضستا7002,اختيارخ شستا-900-1401/07/17,20,1230,285176000,231,230,230,-1,-0.43,232,1,0.43,225,244
ثروتم,صندوق س. ثروت آفرين پارسيان-س,20,23590,2303351110,96852,97373,97999,1147,1.18,97641,789,0.81,97037,98070
ضسپا3013,اختيارخ خساپا-1600-1401/03/25,20,972,456897000,479,577,470,-9,-1.88,470,-9,-1.88,469,577
ضذوب3000,اختيارخ ذوب-2000-1401/03/04,19,511,362887000,688,701,736,48,6.98,710,22,3.2,700,743
اخزا903,اسنادخزانه-م3بودجه99-011110,19,8200,7155363000,871990,871000,876000,4010,0.46,872610,620,0.07,871000,876000
اخزا007,اسنادخزانه-م7بودجه00-030912,19,107300,63806924000,593260,593010,595000,1740,0.29,594660,1400,0.24,593010,595000
اخزا0102,اسناد خزانه-م10بودجه00-031115,18,1025,576257220,573234,544590,572010,-1224,-0.21,562200,-11034,-1.92,544590,572860
ثمين,صندوق س. ثروت افزون ثمين-س,18,32564,391026968,12116,12030,12000,-116,-0.96,12008,-108,-0.89,11953,12149
ضذوب3002,اختيارخ ذوب-3000-1401/03/04,18,755,755000,3,1,1,-2,-66.67,1,-2,-66.67,1,1
ضسپا3017,اختيارخ خساپا-3000-1401/03/25,18,1150,2525000,3,2,2,-1,-33.33,2,-1,-33.33,1,5
رشد,صندوق س.رشد پايدار آبان-د,17,54404,554244998,10000,10193,10181,181,1.81,10188,188,1.88,10181,10195
ضسپا8052,اختيارخ خساپا-2000-1401/08/25,17,1092,394892000,370,370,360,-10,-2.7,362,-8,-2.16,346,380
اخزا008,اسنادخزانه-م8بودجه00-030919,17,31400,18568764000,590530,591000,591580,1050,0.18,591360,830,0.14,591000,591600
اخزا0042,اسنادخزانه-م4بودجه00-030522,17,798,503495430,631780,630900,630910,-870,-0.14,630950,-830,-0.13,630810,631700
ولتجار,واسپاري تجار ايرانيان,17,173512,498152952,2788,2871,2871,83,2.98,2792,4,0.14,2871,2871
ويستا,صندوق س. ويستا -س,17,121974,1564477948,12768,12702,12830,62,0.49,12826,58,0.45,12702,12949
آسام,صندوق س.آرمان سپهر آشنا-م,15,158490,2306120910,14549,14550,14698,149,1.02,14551,2,0.01,14530,14699
ضخود3059,اختيارخ خودرو-3000-1401/03/04,15,619,619000,1,1,1,0,0,1,0,0,1,1
كباده,توليد خاك نسوزاستقلال آباده,15,45522,873567180,18640,19190,19190,550,2.95,19190,550,2.95,19190,19190
ضستر3005,اختيارخ خگستر-3500-1401/03/22,15,886,384400000,337,1000,430,93,27.6,434,97,28.78,430,1000
خعمرا,توسعه و عمران شهرستان نائين,14,32611,319913910,9530,9810,9810,280,2.94,9540,10,0.1,9810,9810
طخود4012,اختيارف خودرو-2200-1401/04/08,14,687,41170000,60,60,60,0,0,60,0,0,59,60
تكنو,تكنوتار,14,64282,477615260,7080,7430,7430,350,4.94,7090,10,0.14,7430,7430
اخزا909,اسنادخزانه-م9بودجه99-020316,14,58000,47140849000,813940,812680,813980,40,0,812770,-1170,-0.14,812680,813980
ضشنا8009,اختيارخ شپنا-3350-1401/08/29,14,164,520770000,3300,3200,3200,-100,-3.03,3175,-125,-3.79,3160,3200
ضسپا8051,اختيارخ خساپا-1900-1401/08/25,13,1150,494000000,440,420,430,-10,-2.27,430,-10,-2.27,420,450
ضخود5006,اختيارخ خودرو-2600-1401/05/12,13,427,42949000,90,122,90,0,0,101,11,12.22,90,122
گنجين,صندوق س. گنجينه يكم آويد-د,13,26662,414910564,15549,15564,15556,7,0.05,15562,13,0.08,15556,15564
قتربت,قند تربت حيدريه,13,59192,1050066080,17230,17740,17740,510,2.96,17280,50,0.29,17740,17740
بذر,صندوق س بذر اميد آفرين-سهام,13,5785,662528050,113760,114450,114460,700,0.62,114530,770,0.68,114450,116000
زعف0110پ05,زعفران0110نگين زرين(پ),13,5351,2158310970,401031,401000,405000,3969,0.99,403347,2316,0.58,401000,405000
سلار,شركت سيمان لارستان,12,16148,663682800,42350,41100,41100,-1250,-2.95,42250,-100,-0.24,41100,41100
اخزا901,اسنادخزانه-م1بودجه99-010621,12,8500,8002115000,940770,940770,949900,9130,0.97,941430,660,0.07,940770,949900
صايند,صندوق س. گنجينه آينده روشن-د,12,205520,2077025770,10100,10105,10110,10,0.1,10106,6,0.06,10100,10111
طخود4013,اختيارف خودرو-2400-1401/04/08,12,415,57735000,143,118,140,-3,-2.1,139,-4,-2.8,118,150
سپرمي,پرميت‌,12,6650,178220000,26550,26800,26800,250,0.94,26800,250,0.94,26800,26800
اخزا0012,اسنادخزانه-م1بودجه00-030821,12,439,263383400,600500,599010,599530,-970,-0.16,599960,-540,-0.09,599010,603000
ثهام,صندوق س ثروت هامرز-سهام,11,29110,345009740,11790,11860,11890,100,0.85,11850,60,0.51,11830,11890
اخزا817,اسنادخزانه-م17بودجه98-010512,11,167400,161195030000,961250,961280,965900,4650,0.48,962930,1680,0.17,961280,965900
اخزا902,اسنادخزانه-م2بودجه99-011019,11,2400,2116762000,881100,881500,884000,2900,0.33,881980,880,0.1,881500,884000
اخزا0062,اسنادخزانه-م6بودجه00-030723,11,473,288212830,609800,609000,609390,-410,-0.07,609330,-470,-0.08,609000,609390
اهرم2,صندوق س سهامي كاريزما- اهرمي,11,35200000,35200000,13470,1,1,-13469,-99.99,1,-13469,-99.99,1,1
اخزا911,اسنادخزانه-م11بودجه99-020906,11,100300,74592496000,740500,741970,748990,8490,1.15,743690,3190,0.43,741970,748990
اخزا908,اسنادخزانه-م8بودجه99-020606,10,111100,86606732000,778470,779500,787960,9490,1.22,779540,1070,0.14,779500,787980
پاداش2,صندوق س. ارزش پاداش-د,10,100000000,100000000,10197,1,1,-10196,-99.99,1,-10196,-99.99,1,1
اخزا914,اسنادخزانه-م14بودجه99-021025,10,4200,3045381000,719520,719990,749990,30470,4.23,725090,5570,0.77,719450,749990
ضترا8067,اختيارخ شتران-5270-1401/08/08,10,116,111354000,1000,960,960,-40,-4,960,-40,-4,959,960
ضجار7050,اختيارخ وتجارت-1980-1401/07/20,9,149,75160000,416,515,460,44,10.58,504,88,21.15,460,545
پادا,صندوق س.پاداش سرمايه پارس-س,9,37197,4459253000,118777,119000,120500,1723,1.45,119882,1105,0.93,119000,121000
اخزا820,اسنادخزانه-م20بودجه98-020806,9,40800,30645595000,749900,750990,764990,15090,2.01,751120,1220,0.16,750990,764990
كميناح,ح . شيشه سازي مينا,9,47714,473322880,6785,9920,9920,3135,46.2,9920,3135,46.2,9920,9920
ثاژن,سخت آژند,9,28763,126384622,4483,4394,4394,-89,-1.99,4481,-2,-0.04,4394,4394
ضفلا3013,اختيارخ فولاد-12000-1401/03/18,9,49,21164000,500,500,450,-50,-10,432,-68,-13.6,410,500
ثبات2,صندوق س. ثبات ويستا -د,9,39000000,39000000,11601,1,1,-11600,-99.99,1,-11600,-99.99,1,1
پشاهن,توليدي پلاستيك‌ شاهين,9,50000,2762500000,53650,55250,55250,1600,2.98,55250,1600,2.98,55250,55250
ضشنا8017,اختيارخ شپنا-7350-1401/08/29,8,160,63663000,493,620,501,8,1.62,398,-95,-19.27,78,620
ضستا7000,اختيارخ شستا-700-1401/07/17,8,102,40770000,397,400,400,3,0.76,400,3,0.76,385,400
ضخود5007,اختيارخ خودرو-2800-1401/05/12,8,750,37000000,50,50,50,0,0,49,-1,-2,49,50
شكف,كف,8,4848,232461600,47050,47950,47950,900,1.91,47950,900,1.91,47950,47950
اخزا918,اسنادخزانه-م18بودجه99-010323,8,10900,10800937000,988610,990000,990990,2380,0.24,990910,2300,0.23,990000,990990
غنيلي,مجتمع توليدي نيلي صنعت كرمان,8,400000,1904000000,5000,4760,4760,-240,-4.8,4760,-240,-4.8,4760,4760
ضملت3013,اختيارخ وبملت-4000-1401/03/18,8,280,15900000,53,45,73,20,37.74,57,4,7.55,45,73
اخزا815,اسنادخزانه-م15بودجه98-010406,8,1400,1376258000,980570,981500,987400,6830,0.7,983040,2470,0.25,981210,987400
كرونا2,تامين مالي جمعي صرفا اهداي سود,7,2249,22490000,10000,10000,10000,0,0,10000,0,0,10000,10000
اخزا9102,اسنادخزانه-م10بودجه99-020807,7,391,292978180,750910,749990,749010,-1900,-0.25,749300,-1610,-0.21,749010,751000
شتولي,تولي‌پرس‌,7,3304,58282560,17300,17640,17640,340,1.97,17640,340,1.97,17640,17640
ضخود5002,اختيارخ خودرو-1900-1401/05/12,6,228,111417000,508,499,475,-33,-6.5,489,-19,-3.74,475,501
تاراز,صندوق س آواي تاراز زاگرس-سهام,6,19500,233855000,12040,11950,12170,130,1.08,11990,-50,-0.42,11950,12170
سيناد,صندوق س.سپهرسودمند سينا-د,6,135000,1350824000,10004,10006,10007,3,0.03,10006,2,0.02,10006,10007
اوج,صندوق س.اوج دماوند-س,6,110000,1227120000,11153,11148,11160,7,0.06,11156,3,0.03,11148,11160
فغدير4,آهن و فولاد غدير ايرانيان,6,2070480138,38452957122936,1000,18572,18572,17572,1757.2,18572,17572,1757.2,18572,18572
اخزا9022,اسنادخزانه-م2بودجه99-011019,6,200,175884490,881100,879900,879310,-1790,-0.2,879420,-1680,-0.19,879310,879900
فسديد,لوله‌وتجهيزات‌ سديد - ورشكسته,6,5901,290624250,48800,49250,49250,450,0.92,48850,50,0.1,49250,49250
ضخود5003,اختيارخ خودرو-2000-1401/05/12,6,110,42210000,391,321,390,-1,-0.26,384,-7,-1.79,321,390
ضخود5004,اختيارخ خودرو-2200-1401/05/12,6,300,79000000,254,270,270,16,6.3,263,9,3.54,260,270
ضپلا4008,اختيارخ پالايش-100000-01/04/29,5,450,7450000,1891,1800,1600,-291,-15.39,1656,-235,-12.43,1500,1800
طسپا3015,اختيارف خساپا-2000-1401/03/25,5,105,5250000,51,50,50,-1,-1.96,50,-1,-1.96,50,50
اخزا0092,اسناد خزانه-م9بودجه00-031101,5,262,150804640,576150,575150,576260,110,0.02,575590,-560,-0.1,575150,576260
اخزا0032,اسنادخزانه-م3بودجه00-030418,5,134,86399660,645480,645000,645000,-480,-0.07,644770,-710,-0.11,644260,645000
سخند,صندوق س.سپهرخبرگان نفت-د,5,2050,20668550,10084,10081,10081,-3,-0.03,10082,-2,-0.02,10081,10086
اراد65,مرابحه عام دولتي65-ش.خ0210,5,104000,98800000000,985000,950000,950000,-35000,-3.55,950000,-35000,-3.55,950000,950000
ضپلا4007,اختيارخ پالايش-90000-01/04/29,5,500,12250000,2500,2250,2500,0,0,2450,-50,-2,2250,2500
گنجينه2,صندوق س. گنجينه داريوش-د,5,17500000,17500000,10101,1,1,-10100,-99.99,1,-10100,-99.99,1,1
افران2,صندوق س افرا نماد پايدار-ثابت,5,27000000,27000000,16403,1,1,-16402,-99.99,1,-16402,-99.99,1,1
اخزا818,اسنادخزانه-م18بودجه98-010614,5,1100,1041028000,947000,947000,948890,1890,0.2,946390,-610,-0.06,944900,948890
اخزا0072,اسنادخزانه-م7بودجه00-030912,5,189,112022650,593260,592630,592550,-710,-0.12,592710,-550,-0.09,592550,592850
ضستر3009,اختيارخ خگستر-5000-1401/03/22,5,104,1948000,20,17,20,0,0,19,-1,-5,17,20
اراد94,مرابحه عام دولت94-ش.خ030816,5,40400,39551600000,952650,979000,979000,26350,2.77,979000,26350,2.77,979000,979000
نبورس,نهادهاي مالي بورس اوراق بهادار,5,746911,6901457640,8720,9240,9240,520,5.96,8790,70,0.8,9240,9240
زعف0110پ21,زعفران0110نگين ملل(پ),4,2930,1175005000,401000,401000,407000,6000,1.5,401026,26,0.01,401000,407000
اراد31,مرابحه عام دولت3-ش.خ 0208,4,3100,2978500000,970000,985000,945000,-25000,-2.58,960810,-9190,-0.95,945000,990000
زعف0110پ16,زعفران0110نگين بيرجند(پ),4,76,31090920,409998,409000,409173,-825,-0.2,409091,-907,-0.22,409000,409173
ضترا8068,اختيارخ شتران-5770-1401/08/08,4,90,71980000,1,799,800,799,79900,800,799,79900,799,800
زعف0110پ09,زعفران0110نگين نوين(پ),4,1400,563500000,409919,402500,402500,-7419,-1.81,402500,-7419,-1.81,402500,402500
ضملت3012,اختيارخ وبملت-3500-1401/03/18,4,92,36630000,380,381,465,85,22.37,398,18,4.74,381,465
طفلا3013,اختيارف فولاد-12000-1401/03/18,4,15,3750000,200,250,250,50,25,250,50,25,250,250
تملي801,تسهيلات مسكن ب. ملي-فروردين98,4,82,38317020,491431,466860,468010,-23421,-4.77,467281,-24150,-4.91,466860,468010
ضشنا8012,اختيارخ شپنا-4850-1401/08/29,4,77,142730000,1801,1850,1990,189,10.49,1854,53,2.94,1850,1990
اخزا814,اسنادخزانه-م14بودجه98-010318,4,700,694403000,991500,991500,993000,1500,0.15,992000,500,0.05,991500,993000
اخزا9032,اسنادخزانه-م3بودجه99-011110,4,77,67157130,871990,870650,870600,-1390,-0.16,872170,180,0.02,870600,875020
پتروما,صندوق س.بخشي پتروشيمي دماوند-ب,4,11583,124859717,10786,10780,10777,-9,-0.08,10780,-6,-0.06,10777,10780
ضسپا8050,اختيارخ خساپا-1800-1401/08/25,3,120,58700000,509,480,490,-19,-3.73,489,-20,-3.93,480,490
اخزا9012,اسنادخزانه-م1بودجه99-010621,3,101,94624260,940770,935000,939010,-1760,-0.19,936870,-3900,-0.41,935000,940740
ضشنا8011,اختيارخ شپنا-4350-1401/08/29,3,8,18232000,1850,2279,2279,429,23.19,2279,429,23.19,2279,2279
اخزا9042,اسنادخزانه-م4بودجه99-011215,3,132,112533920,853890,852600,852500,-1390,-0.16,852530,-1360,-0.16,852500,852600
كگهر2,سنگ آهن گهرزمين,3,13966623,701431150000,49900,49900,50500,600,1.2,50222,322,0.65,49900,50500
اخزا905,اسنادخزانه-م5بودجه99-020218,3,400,337763000,826500,828000,849880,23380,2.83,844410,17910,2.17,828000,849880
شتهران,داروسازي تهران شيمي,3,3946,164745500,40950,41750,41750,800,1.95,41750,800,1.95,41750,41750
اراد87,مرابحه عام دولت87-ش.خ030304,3,4500,4273000000,950000,958000,958000,8000,0.84,949560,-440,-0.05,920000,958000
اخزا907,اسنادخزانه-م7بودجه99-020704,3,15900,12179980000,764850,766000,768900,4050,0.53,766040,1190,0.16,766000,768900
كهربا2,صندوق س.پشتوانه سكه طلا كهربا,3,1100000,1100000,12402,1,1,-12401,-99.99,1,-12401,-99.99,1,1
تملي703,تسهيلات مسكن ب. ملي-خرداد97,3,19,11695144,594487,618010,594487,0,0,615534,21047,3.54,594487,618010
اخزا0082,اسنادخزانه-م8بودجه00-030919,3,219,129144940,590530,589820,589810,-720,-0.12,589700,-830,-0.14,589520,589820
اخزا904,اسنادخزانه-م4بودجه99-011215,3,300,257420000,853890,855210,859990,6100,0.71,858070,4180,0.49,855210,859990
اخزا8152,اسنادخزانه-م15بودجه98-010406,3,27,26479090,980570,979090,981000,430,0.04,980710,140,0.01,979090,981000
وغدير2,سرمايه‌گذاري‌غدير(هلدينگ‌,3,47538960,705951997600,14620,15000,14810,190,1.3,14850,230,1.57,14810,15000
مشهد212,مشاركت ش مشهد212-3ماهه18%,2,100,97433550,983747,936671,985000,1253,0.13,974335,-9412,-0.96,963671,985000
ضملت3011,اختيارخ وبملت-3000-1401/03/18,2,32,31470000,920,900,989,69,7.5,983,63,6.85,900,989
ضفلا3012,اختيارخ فولاد-10000-1401/03/18,2,5,11500000,2315,2300,2300,-15,-0.65,2300,-15,-0.65,2300,2300
اخزا821,اسنادخزانه-م21بودجه98-020906,2,400,301943000,738840,739490,759980,21140,2.86,754860,16020,2.17,739490,759980
ضفلا7010,اختيارخ فولاد-3483-1401/07/24,2,32,166400000,5500,5200,5200,-300,-5.45,5200,-300,-5.45,5200,5200
متا0106,آتي متانول -1401/06/17,2,200,188700000,944000,943500,943500,-500,-0.05,943500,-500,-0.05,943500,943500
متا0105,آتي متانول -1401/05/17,2,200,187500000,938000,937500,937500,-500,-0.05,937500,-500,-0.05,937500,937500
نسب0106,آتي نفتاي سبك-1401/06/17,2,200,479500000,2398000,2397000,2398000,0,0,2397500,-500,-0.02,2397000,2398000
اراد76,مرابحه عام دولت76-ش.خ030406,2,2900,2723500000,932000,955000,932000,0,0,939140,7140,0.77,932000,955000
زعف0110پ10,زعفران0110نگين طلاي سرخ(پ),2,2500,1006250000,400208,402500,402500,2292,0.57,402500,2292,0.57,402500,402500
ضفلا7014,اختيارخ فولاد-5694-1401/07/24,2,40,79980000,2300,1999,2000,-300,-13.04,1999,-301,-13.09,1999,2000
اراد61,مرابحه عام دولت61-ش.خ0309,2,24500,24500000000,1000000,1000000,1000000,0,0,1000000,0,0,1000000,1000000
متا0104,آتي متانول -1401/04/17,2,200,188400000,943000,942000,942000,-1000,-0.11,942000,-1000,-0.11,942000,942000
ضكاريس300,اختيارخ كاريس-11000-14010331,2,12,53400000,4804,4450,4450,-354,-7.37,4450,-354,-7.37,4450,4450
كوثر4,بيمه كوثر,2,200025000,805700700000,4078,4028,4028,-50,-1.23,4028,-50,-1.23,4028,4028
اخزا8164,اسنادخزانه-م16بودجه98-010503,2,2325756,2245053429678,966440,968990,961611,-4829,-0.5,965300,-1140,-0.12,961611,968990
ضشنا8018,اختيارخ شپنا-8350-1401/08/29,2,21,6499000,301,300,499,198,65.78,309,8,2.66,300,499
ضكاريس600,اختيارخ كاريس-13000-14010606,2,200,760000000,1,3800,3800,3799,379900,3800,3799,379900,3800,3800
ضترا3011,اختيارخ شتران-3000-1401/03/08,2,8,19400000,2200,2550,2300,100,4.55,2425,225,10.23,2300,2550
هماي2,صندوق س هماي آگاه-ثابت,2,36552001,36552001,10018,1,1,-10017,-99.99,1,-10017,-99.99,1,1
اخزا906,اسنادخزانه-م6بودجه99-020321,2,200,162276000,810440,810760,812000,1560,0.19,811380,940,0.12,810760,812000
اخزا9092,اسنادخزانه-م9بودجه99-020316,2,101,82175600,813940,813940,811000,-2940,-0.36,813620,-320,-0.04,811000,813940
وساپا2,سرمايه‌گذاري‌ سايپا,2,81174088,400999994720,4830,4940,4940,110,2.28,4940,110,2.28,4940,4940
اخزا9142,اسنادخزانه-م14بودجه99-021025,2,77,55210450,719520,717010,717030,-2490,-0.35,717020,-2500,-0.35,717010,717030
اخزا816,اسنادخزانه-م16بودجه98-010503,2,200,193385000,966440,966920,966930,490,0.05,966920,480,0.05,966920,966930
كمند2,صندوق س. با درآمد ثابت كمند,2,105100000,105100000,10108,1,1,-10107,-99.99,1,-10107,-99.99,1,1
ضفلا7011,اختيارخ فولاد-4035-1401/07/24,2,12,51600000,1,4300,4300,4299,429900,4300,4299,429900,4300,4300
ضذوب8004,اختيارخ ذوب-2740-1401/08/04,2,50,25800000,500,540,500,0,0,516,16,3.2,500,540
ضستا7006,اختيارخ شستا-1300-1401/07/17,2,100,4000000,40,40,40,0,0,40,0,0,40,40
ضستر3004,اختيارخ خگستر-3250-1401/03/22,2,90,58100000,500,640,650,150,30,646,146,29.2,640,650
ضجار7049,اختيارخ وتجارت-1880-1401/07/20,2,200,100000000,480,500,500,20,4.17,500,20,4.17,500,500
ضستا7001,اختيارخ شستا-800-1401/07/17,2,14,4590000,310,335,325,15,4.84,328,18,5.81,325,335
ضفلا7013,اختيارخ فولاد-5141-1401/07/24,2,30,78000000,3160,2600,2600,-560,-17.72,2600,-560,-17.72,2600,2600
ولساپا2,ليزينگ رايان‌ سايپا,2,60000000,99000000000,1596,1650,1650,54,3.38,1650,54,3.38,1650,1650
خديزل2,بهمن  ديزل,2,40000000,423200000000,10580,10580,10580,0,0,10580,0,0,10580,10580
ضترا3012,اختيارخ شتران-3500-1401/03/08,2,2,3990000,1800,2000,1990,190,10.56,1995,195,10.83,1990,2000
ضشنا8015,اختيارخ شپنا-6350-1401/08/29,2,11,8740000,800,800,740,-60,-7.5,795,-5,-0.63,740,800
ضفلا7015,اختيارخ فولاد-6247-1401/07/24,2,30,59990000,1949,1999,2000,51,2.62,2000,51,2.62,1999,2000
ضملت3010,اختيارخ وبملت-2500-1401/03/18,2,60,85650000,1325,1400,1455,130,9.81,1427,102,7.7,1400,1455
سمتا021,سلف موازي استاندارد سمتا021,1,100,92962000,929188,929620,929620,432,0.05,929620,432,0.05,929620,929620
ضفلا7012,اختيارخ فولاد-4588-1401/07/24,1,10,35000000,4067,3500,3500,-567,-13.94,3500,-567,-13.94,3500,3500
ضترا3016,اختيارخ شتران-6000-1401/03/08,1,40,2400000,7,60,60,53,757.14,60,53,757.14,60,60
هفارس104,اختيارف ت فارس-6937-01/04/12,1,10000,10000,1,1,1,0,0,1,0,0,1,1
زعف0110پ08,زعفران0110نگين روستا(پ),1,15,6037500,401000,402500,402500,1500,0.37,402500,1500,0.37,402500,402500
نسب0105,آتي نفتاي سبك-1401/05/17,1,200,479600000,2399000,2398000,2398000,-1000,-0.04,2398000,-1000,-0.04,2398000,2398000
اتكاي2,بيمه اتكايي ايرانيان,1,6000000,82800000000,13740,13800,13800,60,0.44,13800,60,0.44,13800,13800
حريل2,ريل پردازسير,1,22000000,61688000000,2804,2804,2804,0,0,2804,0,0,2804,2804
كارا2,صندوق س. كارا -د,1,7000000,7000000,11393,1,1,-11392,-99.99,1,-11392,-99.99,1,1
رايان106,مشاركت رايان سايپا-3ماهه16%,1,2,2000000,993886,1000000,1000000,6114,0.62,1000000,6114,0.62,1000000,1000000
ضذوب8003,اختيارخ ذوب-2540-1401/08/04,1,20,11000000,759,550,550,-209,-27.54,550,-209,-27.54,550,550
مشهد112,مشاركت ش مشهد112-3ماهه18%,1,50,48750000,945010,975000,975000,29990,3.17,975000,29990,3.17,975000,975000
ضسپا8053,اختيارخ خساپا-2200-1401/08/25,1,1,200000,140,200,200,60,42.86,200,60,42.86,200,200
ضذوب8002,اختيارخ ذوب-2340-1401/08/04,1,1,850000,732,850,850,118,16.12,850,118,16.12,850,850
ضخود4009,اختيارخ خودرو-1800-1401/04/08,1,35,17850000,507,510,510,3,0.59,510,3,0.59,510,510
سمتا022,سلف موازي استاندارد سمتا022,1,100,93174400,931310,931744,931744,434,0.05,931744,434,0.05,931744,931744
آرام2,صندوق س شاخصي آرام مفيد,1,100000,100000,11040,1,1,-11039,-99.99,1,-11039,-99.99,1,1
اخزا9112,اسنادخزانه-م11بودجه99-020906,1,8,5627840,740500,703480,703480,-37020,-5,703480,-37020,-5,703480,703480
اطلس2,صندوق س.توسعه اطلس مفيد-س,1,10000,10000,275535,1,1,-275534,-100,1,-275534,-100,1,1
سپيدما2,صندوق س. سپيد دماوند-د,1,5000000,5000000,12629,1,1,-12628,-99.99,1,-12628,-99.99,1,1
اراد874,مرابحه عام دولت87-ش.خ030304,1,154000,146677300000,950000,952450,952450,2450,0.26,952450,2450,0.26,952450,952450
رشد4,صندوق س.رشد پايدار آبان-د,1,2000000,20000000000,10000,10000,10000,0,0,10000,0,0,10000,10000
داوه4,داروسازي آوه سينا,1,1000000,7970000000,7900,7970,7970,70,0.89,7970,70,0.89,7970,7970
اخزا8142,اسنادخزانه-م14بودجه98-010318,1,50,49476000,991500,989520,989520,-1980,-0.2,989520,-1980,-0.2,989520,989520
فولاد2,فولاد مباركه اصفهان,1,16300000,199675000000,12260,12250,12250,-10,-0.08,12250,-10,-0.08,12250,12250
شپنا2,پالايش نفت اصفهان,1,5000000,33500000000,6470,6700,6700,230,3.55,6700,230,3.55,6700,6700
غيوان,كيوان,1,750,11730000,15490,15640,15640,150,0.97,15490,0,0,15640,15640
نسب0104,آتي نفتاي سبك-1401/04/17,1,200,479800000,2400000,2399000,2399000,-1000,-0.04,2399000,-1000,-0.04,2399000,2399000
ضخود3053,اختيارخ خودرو-1200-1401/03/04,1,10,10000000,1497,1000,1000,-497,-33.2,1000,-497,-33.2,1000,1000
اوصتا4,صندوق انديشه ورزان صباتامين -د,1,43981000,999995997000,22722,22737,22737,15,0.07,22737,15,0.07,22737,22737
شتران2,پالايش نفت تهران,1,10000000,55000000000,5390,5500,5500,110,2.04,5500,110,2.04,5500,5500
ثروتم2,صندوق س. ثروت آفرين پارسيان-س,1,400000,400000,96852,1,1,-96851,-100,1,-96851,-100,1,1
ضملت8052,اختيارخ وبملت-3081-1401/08/18,1,90,45000000,550,500,500,-50,-9.09,500,-50,-9.09,500,500
ضجار7051,اختيارخ وتجارت-2180-1401/07/20,1,10,3500000,301,350,350,49,16.28,350,49,16.28,350,350
ضملت3014,اختيارخ وبملت-4500-1401/03/18,1,1,1000,10,1,1,-9,-90,1,-9,-90,1,1
سميعا101,سلف موازي استاندارد سميعا101,1,100,131219500,1311674,1312195,1312195,521,0.04,1312195,521,0.04,1312195,1312195
سميعا102,سلف موازي استاندارد سميعا102,1,100,142520800,1424638,1425208,1425208,570,0.04,1425208,570,0.04,1425208,1425208
اخزا8212,اسنادخزانه-م21بودجه98-020906,1,60,44220000,738840,737000,737000,-1840,-0.25,737000,-1840,-0.25,737000,737000
اخزا8202,اسنادخزانه-م20بودجه98-020806,1,75,56242500,749900,749900,749900,0,0,749900,0,0,749900,749900
كمان,س.خ.كمان كاريزما 35% تاديه,1,85160,35466159400,415986,416465,416465,479,0.12,416465,479,0.12,416465,416465
افاد61,منفعت دولت6-ش.خاص140109,1,1100,1099978000,999990,999980,999980,-10,0,999980,-10,0,999980,999980
تملي708,تسهيلات مسكن ب. ملي-آبان97,1,11,7740238,740692,703658,703658,-37034,-5,703658,-37034,-5,703658,703658
سصوفي2,سيمان‌ صوفيان‌,1,3000000,55800000000,18910,18600,18600,-310,-1.64,18600,-310,-1.64,18600,18600
اراد99,مرابحه عام دولت99-ش.خ050723,1,20000,20000000000,1000000,1000000,1000000,0,0,1000000,0,0,1000000,1000000
صبا14044,اجاصبابدون ضامن بارتبه اعتباري,1,60000,60000000000,1000000,1000000,1000000,0,0,1000000,0,0,1000000,1000000
خمهر4,مهركام‌پارس‌,1,90000000,190080000000,2089,2112,2112,23,1.1,2112,23,1.1,2112,2112
ضهمن3002,اختيارخ خبهمن-1600-1401/03/11,1,25,5250000,345,210,210,-135,-39.13,210,-135,-39.13,210,210
سمتا011,سلف موازي استاندارد سمتا011,1,10,90229650,9019246,9022965,9022965,3719,0.04,9022965,3719,0.04,9022965,9022965
ضجار7045,اختيارخ وتجارت-1480-1401/07/20,1,100,82800000,900,828,828,-72,-8,828,-72,-8,828,828
ضخود3056,اختيارخ خودرو-1800-1401/03/04,1,100,44000000,406,440,440,34,8.37,440,34,8.37,440,440
ضخود5001,اختيارخ خودرو-1800-1401/05/12,1,4,2280000,590,570,570,-20,-3.39,570,-20,-3.39,570,570
طخود5005,اختيارف خودرو-2400-1401/05/12,1,1,200000,200,200,200,0,0,200,0,0,200,200
زير0103پ04,زيره سبز0103شركت مينوبذر(پ),1,11,14245000,1251468,1295000,1295000,43532,3.48,1295000,43532,3.48,1295000,1295000
طملي7013,اختيارف فملي-6800-1401/07/10,1,2,1000000,1,500,500,499,49900,500,499,49900,500,500
گواهي ظرفيت,گواهي ظرفيت نقدي,1,3000000,122307000000,38828,40769,40769,1941,5,39049,221,0.57,40769,40769
کم ه 11,کم باري هفته 11,1,8900,5829500,308500,655,655,-307845,-99.79,655,-307845,-99.79,655,655
ضبدر3013,اختيارخ شبندر-7000-1401/03/29,1,4,10400000,1700,2600,2600,900,52.94,2600,900,52.94,2600,2600
ضترا8066,اختيارخ شتران-4770-1401/08/08,1,50,64500000,1220,1290,1290,70,5.74,1290,70,5.74,1290,1290
مي ه 11,ميان باري هفته 11,1,8900,5963000,324,670,670,346,106.79,670,346,106.79,670,670
صينا205,صكوك منفعت سينا دارو-3ماهه 19%,1,8,7920000,990000,990000,990000,0,0,990000,0,0,990000,990000
سمتا023,سلف موازي استاندارد سمتا023,1,100,93530300,934869,935303,935303,434,0.05,935303,434,0.05,935303,935303
ضسپا3014,اختيارخ خساپا-1800-1401/03/25,1,4,1476000,301,369,369,68,22.59,369,68,22.59,369,369
هامرز4,صندوق س اعتماد هامرز-ثابت,1,50120000,506863560000,10108,10113,10113,5,0.05,10113,5,0.05,10113,10113
اخزا9082,اسنادخزانه-م8بودجه99-020606,1,10,7879500,778470,787950,787950,9480,1.22,787950,9480,1.22,787950,787950
افران4,صندوق س افرا نماد پايدار-ثابت,1,3045000,49977585000,16403,16413,16413,10,0.06,16413,10,0.06,16413,16413
اراد314,مرابحه عام دولت3-ش.خ 0208,1,976900,976900000000,970000,1000000,1000000,30000,3.09,1000000,30000,3.09,1000000,1000000
کم ه 12,کم باري هفته 12,1,8900,5829500,500,655,655,155,31,655,155,31,655,655
اخزا9052,اسنادخزانه-م5بودجه99-020218,1,25,20625000,826500,825000,825000,-1500,-0.18,825000,-1500,-0.18,825000,825000
آريان2,سرمايه گذاري پارس آريان,1,24857399,174498940980,7090,7020,7020,-70,-0.99,7020,-70,-0.99,7020,7020
ولتجار4,واسپاري تجار ايرانيان,1,3071420,8575404640,2788,2792,2792,4,0.14,2792,4,0.14,2792,2792
سمتا024,سلف موازي متانول بوشهر 024,1,100,91235200,911928,912352,912352,424,0.05,912352,424,0.05,912352,912352
سمتا025,سلف موازي متانول بوشهر 025,1,100,103747500,1036993,1037475,1037475,482,0.05,1037475,482,0.05,1037475,1037475
اراد59,مرابحه عام دولتي5-ش.خ 0309,1,100,101700000,1000000,1017000,1017000,17000,1.7,1017000,17000,1.7,1017000,1017000
سنفت021,سلف موازي نفت.س صادر اروند 021,1,100,212072300,2119737,2120723,2120723,986,0.05,2120723,986,0.05,2120723,2120723
مشير304,مشاركت ش شيراز304-3ماهه18%,1,1000,964000000,968000,964000,964000,-4000,-0.41,964000,-4000,-0.41,964000,964000
ضجار7052,اختيارخ وتجارت-2380-1401/07/20,1,10,2500000,270,250,250,-20,-7.41,250,-20,-7.41,250,250
اراد964,مرابحه عام دولت96-ش.خ030414,1,2280151,2103142877870,945000,922370,922370,-22630,-2.39,922370,-22630,-2.39,922370,922370
صشستا3112,صكوك اجاره شستا311-بدون ضامن,1,500000,500000000000,1000000,1000000,1000000,0,0,1000000,0,0,1000000,1000000
